ml,fold,groundtruth,predicted,TP,FP,dif,fileName
1_sabl,fold_1,2,0,0,0,-2,20230512_153003_jpg.rf.3e11918b7e073ed9642c3d889f82a10b.jpg
1_sabl,fold_1,3,2,2,0,-1,20230512_152344_jpg.rf.9cdeba0a7faf9c91db6a1bec355cd79f.jpg
1_sabl,fold_1,8,1,1,0,-7,20230512_150202_jpg.rf.2d354a6afba7660a4bdb4422aacb0bf1.jpg
1_sabl,fold_1,2,1,1,0,-1,20230512_151842_jpg.rf.0400a2b89be930a6aee77dd6416cc317.jpg
1_sabl,fold_1,1,0,0,0,-1,20230512_153001_jpg.rf.9e1933e066ac83bf9fbd01b8def6158d.jpg
1_sabl,fold_1,6,3,3,0,-3,IMG_4052_JPG.rf.a484ba8b08f647c9d706f26a2c1bdd88.jpg
1_sabl,fold_1,1,0,0,0,-1,IMG_3933_JPG.rf.b0d6e8cf999e8234386ed5bb6107f61a.jpg
1_sabl,fold_1,23,0,0,0,-23,20230512_153423_jpg.rf.199d17397bc75e4b3c997992a9469adb.jpg
1_sabl,fold_1,1,0,0,0,-1,230512_150115_jpg.rf.048aa47fa124320a4fa8a5c30506622b.jpg
1_sabl,fold_1,8,6,6,0,-2,20230512_152239_jpg.rf.5270f7fe5715e9e4db1967390d36c76d.jpg
1_sabl,fold_1,7,4,4,0,-3,IMG_20230512_152358_jpg.rf.14382fa8e1d185e8ecd9b6b625021b8f.jpg
1_sabl,fold_1,1,1,1,0,0,20230512_151657_jpg.rf.ae916e776287bd8044bda6da1e1dec7e.jpg
1_sabl,fold_1,2,0,0,0,-2,IMG_4202_JPG.rf.389eb0baa38b2b42b82e272dae53dd7b.jpg
1_sabl,fold_1,10,0,0,0,-10,20230512_150031_jpg.rf.5b7cf141f46aecb85b2c9e4f6977aa4c.jpg
1_sabl,fold_1,4,0,0,0,-4,IMG_20230512_151251_jpg.rf.13115516a78a5324e008f7864789fbec.jpg
1_sabl,fold_1,17,0,0,0,-17,20230512_150005_jpg.rf.77d140d77f3f48953c783c2d50e6f910.jpg
1_sabl,fold_1,1,0,0,0,-1,20230512_150058_jpg.rf.daa9ab4c09a0e2a557b1e8bb54702ecb.jpg
1_sabl,fold_1,6,5,4,1,-1,20230512_152201_jpg.rf.3c9e01b2433736fc6ee290b90dd42684.jpg
1_sabl,fold_1,6,1,1,0,-5,IMG_20230512_151219_jpg.rf.6d76721a015ae20af4047ec2607a62e0.jpg
1_sabl,fold_1,19,3,2,1,-16,IMG_20230512_150136_jpg.rf.004497d9e0b84ae3cd5c8e7e5e9f30d7.jpg
1_sabl,fold_1,32,5,4,1,-27,0008_jpg.rf.94e89ad01289e8cfda380621151bf1bb.jpg
1_sabl,fold_1,1,2,1,1,1,IMG_4027_JPG.rf.02fde7996d0a3e63cd8727ba35b98fbd.jpg
1_sabl,fold_1,7,4,4,0,-3,IMG_4051_JPG.rf.1f19a2adfb075e1a7c5d3d9567879ae2.jpg
1_sabl,fold_1,3,1,1,0,-2,IMG_20230512_145126_jpg.rf.0493bac7dcca35f2a361df2325097b88.jpg
1_sabl,fold_1,4,1,1,0,-3,0004_jpg.rf.7a14cc5ff08b5ee1437266474bc51865.jpg
1_sabl,fold_1,1,1,1,0,0,20230512_151446_jpg.rf.801ee52ac482b80a6b7e2c7a7a896dc7.jpg
1_sabl,fold_1,1,0,0,0,-1,20230512_153217_jpg.rf.3d66bba80f697d614260fc56dd593486.jpg
1_sabl,fold_1,23,0,0,0,-23,20230512_150312_jpg.rf.2040a566a6e8aa7d77563942d16e3907.jpg
1_sabl,fold_1,4,0,0,0,-4,20230512_153409_jpg.rf.b9be0a0b5dc71b17d03a58db2af65fd3.jpg
1_sabl,fold_1,1,0,0,0,-1,20230512_145140_jpg.rf.3d71f74b4ed8a93a636f79ef1a9a7e9c.jpg
1_sabl,fold_1,7,3,3,0,-4,0002_jpg.rf.d16d3de92655da222f9470322637f0a1.jpg
1_sabl,fold_1,2,0,0,0,-2,IMG_20230512_153111_jpg.rf.71fdfa6f08329e5d2412e86bf6870b02.jpg
1_sabl,fold_1,3,2,1,1,-1,IMG_20230512_151306_jpg.rf.e4b348fae9b8d16d80a5be211e9e39a1.jpg
1_sabl,fold_1,7,0,0,0,-7,20230512_150132_jpg.rf.b204b63d3e3f8ef2920b32f1e0b6ab50.jpg
1_sabl,fold_1,3,0,0,0,-3,IMG_20230512_151314_jpg.rf.231b8a97bc932aa622a2b27c80ee878b.jpg
1_sabl,fold_1,1,1,1,0,0,20230512_145419_jpg.rf.cf9776dd6ff86988e3d4a8734ba6f15c.jpg
1_sabl,fold_1,1,0,0,0,-1,IMG_20230512_161355_jpg.rf.f1c1af37db10bfc139da92a922fa83a2.jpg
1_sabl,fold_1,1,1,1,0,0,IMG_20230512_151815_jpg.rf.fad6e45cfa5e7c506e9fbad254cef9e0.jpg
1_sabl,fold_1,6,2,0,2,-4,IMG_3922_JPG.rf.4fa3ab6d4b090dd6a9114495e5b5a468.jpg
1_sabl,fold_1,37,4,3,1,-33,IMG_20230512_150214_jpg.rf.0a3e70748a25dbc7ca5305e84da8d3cd.jpg
1_sabl,fold_1,5,4,4,0,-1,20230512_152251_jpg.rf.ebcf28d3c9a35107daa9beb28ae3475b.jpg
1_sabl,fold_1,2,0,0,0,-2,20230512_151110_jpg.rf.53961421a4e7bd7511e281309a72a2c9.jpg
1_sabl,fold_1,2,1,1,0,-1,20230512_151630_jpg.rf.ecc81d9067cb1ce5be1c14f9a6d71d9d.jpg
1_sabl,fold_1,11,0,0,0,-11,IMG_20230512_145044_jpg.rf.d79716a7705a23a496d5d4896dbcf506.jpg
1_sabl,fold_1,1,0,0,0,-1,20230512_145031_jpg.rf.0c829f489393188e9f1ecc0ff78d8324.jpg
1_sabl,fold_1,1,0,0,0,-1,20230512_151712_jpg.rf.c494c6b379e948f9f084efcd40c0619d.jpg
1_sabl,fold_1,13,10,8,2,-3,20230512_153109_jpg.rf.930610a4b0e78acb8ed778e44b9d5922.jpg
1_sabl,fold_1,4,1,1,0,-3,IMG_20230512_151205_jpg.rf.2bbe055a56edab8e820150d32613da40.jpg
1_sabl,fold_1,2,0,0,0,-2,20230512_150059-0-_jpg.rf.641cecd96312dfe886a8bf287b5916db.jpg
1_sabl,fold_1,2,1,1,0,-1,20230512_145234_jpg.rf.d7e55e93d9f98a6de3d20ef7221babc8.jpg
1_sabl,fold_1,4,2,2,0,-2,IMG_20230512_145359_jpg.rf.c0fb243e34926596f7a71595884ae8c5.jpg
1_sabl,fold_1,6,1,1,0,-5,20230512_145334_jpg.rf.0b72b785a7b59d3a4217025c7e5a2423.jpg
1_sabl,fold_1,10,7,7,0,-3,20230512_152402_jpg.rf.2af7283a541e5a9a5150707a47c4be20.jpg
1_sabl,fold_1,2,2,2,0,0,20230512_145352_jpg.rf.c846cb3c36e5363cfaa577a44b6913d8.jpg
1_sabl,fold_1,23,4,4,0,-19,20230512_150226_jpg.rf.f79017b16f1532730f31cb325d6ab86e.jpg
1_sabl,fold_1,1,1,0,1,0,20230512_153345-0-_jpg.rf.6e0b5b843ebfea1138cb759960e1bafc.jpg
1_sabl,fold_1,2,0,0,0,-2,0036_jpg.rf.95bf6e3cde891a0e422157eafa8da143.jpg
1_sabl,fold_1,1,1,0,1,0,20230512_150121_jpg.rf.b7f710edf2464cb4724d24c65bae04b4.jpg
1_sabl,fold_1,1,1,1,0,0,20230512_150720_jpg.rf.a18892cc876f35236d2a20ba37b6efd8.jpg
1_sabl,fold_1,13,5,5,0,-8,20230512_153007_jpg.rf.d3b0e4362c8dc7fde7b007165efdd07e.jpg
1_sabl,fold_1,1,0,0,0,-1,20230512_144958_jpg.rf.bd51a27225a9ddf5ef21b54512e10b9b.jpg
1_sabl,fold_1,2,1,1,0,-1,20230512_151201_jpg.rf.003d9f32250e51b928c51a05b230f55a.jpg
1_sabl,fold_1,5,0,0,0,-5,IMG_20230512_145247_597_jpg.rf.464f6c3eb3265be95f2f08e2d0bdd91a.jpg
1_sabl,fold_1,8,7,6,1,-1,20230512_152159_jpg.rf.f9d372b7fdee9c83d543f19d83accc75.jpg
1_sabl,fold_1,17,1,1,0,-16,IMG_20230512_150133_jpg.rf.e1213a79a5060e17585ebc484a3c63d6.jpg
1_sabl,fold_1,4,0,0,0,-4,20230512_145007_jpg.rf.b9641853c4144bc1d5622b022182ed4b.jpg
1_sabl,fold_1,1,1,1,0,0,IMG_20230512_145057_967_jpg.rf.680792c5520fea6605bcf774a290cd8f.jpg
1_sabl,fold_1,2,1,1,0,-1,20230512_151633_jpg.rf.a660ff615450152ab9fbed4d02eeb6d7.jpg
1_sabl,fold_1,8,6,6,0,-2,IMG_4090_JPG.rf.677923e65dcfcc46588eee4c2c2c9e46.jpg
1_sabl,fold_1,10,8,6,2,-2,20230512_152258_jpg.rf.2e43ef7a91920046b900730064da408d.jpg
1_sabl,fold_1,18,11,10,1,-7,20230512_152402_jpg.rf.5f60c1b7e4703f63b61c50a74049302f.jpg
1_sabl,fold_1,4,0,0,0,-4,20230512_151121_jpg.rf.d9f5fd5a912436d588c2e8a3681b8643.jpg
1_sabl,fold_1,15,7,7,0,-8,20230512_152310_jpg.rf.22fd13a135de99870e2b9f19a9dbd566.jpg
1_sabl,fold_1,15,7,7,0,-8,IMG_4206_JPG.rf.86dc764134fcaa91fd5246c96808ba7a.jpg
1_sabl,fold_1,1,1,1,0,0,20230512_145233_jpg.rf.9e2d494cc8579c52d6794c0fb5af14b7.jpg
1_sabl,fold_1,1,1,1,0,0,IMG_4014_JPG.rf.67af8816872a56054c245e272bdd23db.jpg
1_sabl,fold_1,11,10,8,2,-1,IMG_20230512_151956_jpg.rf.accb7456b90404e99398a8475aa5f074.jpg
1_sabl,fold_1,5,4,4,0,-1,20230512_152221_jpg.rf.dfe82842e573d8a1a7ff0d4519256b1d.jpg
1_sabl,fold_1,35,1,1,0,-34,0512_150052_jpg.rf.6838fe76e0e5f7752c388cea428a676b.jpg
1_sabl,fold_1,3,1,0,1,-2,IMG_20230512_150949_jpg.rf.0a7b1aca0bc2e95e7b33b4409d5f03e1.jpg
1_sabl,fold_1,5,3,2,1,-2,20230512_145412_jpg.rf.9224a9f695664a7b936da6fb81af36c9.jpg
1_sabl,fold_1,10,7,7,0,-3,20230512_151907_jpg.rf.8b3da1939d33aa65bfb85cb4ba33d685.jpg
1_sabl,fold_1,1,1,1,0,0,20230512_151037_jpg.rf.57044d376bf29efab4142e6e059723d3.jpg
1_sabl,fold_1,1,0,0,0,-1,20230512_151510-0-_jpg.rf.8fdff95c003658062d05e4285948dcbb.jpg
1_sabl,fold_1,10,9,9,0,-1,20230512_151857_jpg.rf.d5917286f02e07a5305d7b858c6244ec.jpg
1_sabl,fold_1,2,1,1,0,-1,IMG_20230512_151822_jpg.rf.cd5ee7cbb4e275377fc3e1ca11bd6a01.jpg
1_sabl,fold_1,18,11,11,0,-7,20230512_152223_jpg.rf.7b4c9b6ebd76c6c1084f1453a97610d9.jpg
1_sabl,fold_1,2,2,2,0,0,0015_jpg.rf.a767e21c0a0684765afe242b8052602a.jpg
1_sabl,fold_1,2,1,1,0,-1,IMG_20230512_145027_jpg.rf.16a85daab3bfea64be4f44d4de24d8b4.jpg
1_sabl,fold_1,2,1,0,1,-1,IMG_20230512_145337_jpg.rf.04c6c7ecd50fc9cd76f28da038eea12a.jpg
1_sabl,fold_1,4,0,0,0,-4,20230512_145119_jpg.rf.f0411939c238246ea7d83cb97f4b291a.jpg
1_sabl,fold_1,1,1,1,0,0,20230512_151618_jpg.rf.9cfdd92f0dd263ec71adc25e0966b10d.jpg
1_sabl,fold_1,21,1,1,0,-20,20230512_150123_jpg.rf.ca38530fba79c2eea723776f3cb9701e.jpg
1_sabl,fold_1,8,7,7,0,-1,IMG_20230512_151954_jpg.rf.1f74638dd64a022c7ddbc6b607ebb63f.jpg
1_sabl,fold_1,2,0,0,0,-2,20230512_153358_jpg.rf.000b91eaf995cb7029bac19a97ae0eab.jpg
1_sabl,fold_1,3,0,0,0,-3,0030_jpg.rf.92e747a4b264c12a0f5bd7b7fff47c97.jpg
1_sabl,fold_1,2,1,1,0,-1,IMG_3838_JPG.rf.6259d7b6f664061333ba70518ffa409a.jpg
1_sabl,fold_1,47,8,0,8,-39,20230512_153205_jpg.rf.a397edfe98870b927aac7d426225215e.jpg
1_sabl,fold_1,3,0,0,0,-3,20230512_151421_jpg.rf.32f90f849ffd68e483c8af1c30cd3e88.jpg
1_sabl,fold_1,4,1,1,0,-3,20230512_150228_jpg.rf.bdef78abc0510427f86904d310db4ffe.jpg
1_sabl,fold_1,1,1,1,0,0,20230512_150729_jpg.rf.8d31acfa9500f54af8d12c1ddbddbd65.jpg
1_sabl,fold_1,1,0,0,0,-1,IMG_4221_JPG.rf.c34edb7d27501d2bebad754740f2c36d.jpg
1_sabl,fold_1,91,2,2,0,-89,20230512_153222_jpg.rf.02d4e5f1788464607b60d200b123696a.jpg
1_sabl,fold_1,15,13,10,3,-2,20230512_152343_jpg.rf.b78ec2e1eb5a82ab22cb447b29e60a37.jpg
1_sabl,fold_1,4,1,1,0,-3,20230512_145420_jpg.rf.63f8530ad3e9147d791de1d4a62e2845.jpg
1_sabl,fold_1,3,2,2,0,-1,IMG_20230512_145129_jpg.rf.7c57fcf634dd12adb9bd6bfb5ab72307.jpg
1_sabl,fold_1,3,3,2,1,0,IMG_20230512_152950_jpg.rf.7b0419faa0e6c3e396abcf1d3db70ba2.jpg
1_sabl,fold_1,7,4,3,1,-3,IMG_20230512_145458_jpg.rf.0869453997d27a12e193c3576f5be50f.jpg
1_sabl,fold_1,2,0,0,0,-2,20230512_150320_jpg.rf.f00816162e753a50c482ccbb2723a8bb.jpg
1_sabl,fold_1,2,0,0,0,-2,20230512_151501-0-_jpg.rf.ac937acab812f79dd846ec10e9eb794f.jpg
1_sabl,fold_1,4,4,4,0,0,IMG_20230512_151857_jpg.rf.f3b0a248067ce9c5df43e8eb1b7b8f48.jpg
1_sabl,fold_1,1,0,0,0,-1,20230512_151507_jpg.rf.83b7b0f7341f0c68f2169ab2e25d50af.jpg
1_sabl,fold_1,4,4,3,1,0,IMG_4098_JPG.rf.d05c322cd8fa2c89a0d093e8e91666a2.jpg
1_sabl,fold_1,5,0,0,0,-5,IMG_20230512_144938_jpg.rf.61fbc5c9c8be89bcb4b1529921428829.jpg
1_sabl,fold_1,9,5,5,0,-4,20230512_152348_jpg.rf.9a9f308e6e3d3ff1b666f67b5196d238.jpg
1_sabl,fold_1,2,0,0,0,-2,20230512_151131_jpg.rf.62d78c2e91ff2133e0623bbd8de03bda.jpg
1_sabl,fold_1,1,1,1,0,0,IMG_20230512_150905_jpg.rf.498fdb5cdf1e78cfffa9005586c25d1b.jpg
1_sabl,fold_1,1,0,0,0,-1,20230512_145033_jpg.rf.5a4b7044f38311bf91bd61b2107f6208.jpg
1_sabl,fold_1,2,0,0,0,-2,0002_jpg.rf.244244e268805e9279e2778f66f93c67.jpg
1_sabl,fold_1,9,5,5,0,-4,IMG_20230512_145357_jpg.rf.65481eda27afaba20ecf66958bd1a415.jpg
1_sabl,fold_1,40,2,2,0,-38,IMG_20230512_150251_jpg.rf.2318a91c9b0a0d0c74b337b923e9e074.jpg
1_sabl,fold_1,4,2,2,0,-2,IMG_20230512_145134_jpg.rf.084766d54cd58d09cacfc92914a1a5c7.jpg
1_sabl,fold_1,9,7,6,1,-2,IMG_20230512_152000_jpg.rf.af9cbaac286010743e1eabfda3ff16fd.jpg
1_sabl,fold_1,3,2,0,2,-1,20230512_145302_jpg.rf.52f6bff4360f5a174eb1a21d91490e2f.jpg
1_sabl,fold_1,4,1,1,0,-3,0013_jpg.rf.46c0cfad5d61b22f1717205aab02e682.jpg
1_sabl,fold_1,13,5,3,2,-8,20230512_152958_jpg.rf.43cafd5762e96ebdaf2638b5e2e5ede5.jpg
1_sabl,fold_1,1,0,0,0,-1,IMG_20230512_145002_jpg.rf.a16310bc3cbd1bce46d8e207260f6d2f.jpg
1_sabl,fold_1,20,1,1,0,-19,20230512_150157_jpg.rf.8b6ad4dda7ad6b93ac57bd92f16dcdcd.jpg
1_sabl,fold_1,6,1,1,0,-5,IMG_20230512_144908_684_jpg.rf.89a536225f1a283e12d5bb8970ee31cb.jpg
1_sabl,fold_1,2,0,0,0,-2,20230512_151455_jpg.rf.eb853c4caca8daef122f54e54ffa44ce.jpg
1_sabl,fold_1,3,1,1,0,-2,IMG_20230512_151214_jpg.rf.885e6d5e144fd3b97b6ab96da191a928.jpg
1_sabl,fold_1,2,2,2,0,0,20230512_151744_jpg.rf.b461e1fdf32cd5c1232cf11220a2bef4.jpg
1_sabl,fold_1,7,2,1,1,-5,IMG_3868_JPG.rf.1770b3eda4aaec864f7cf0d27d04888b.jpg
1_sabl,fold_1,7,5,5,0,-2,20230512_151845_jpg.rf.8dee8031c86ff6697d6d671e32b55f55.jpg
1_sabl,fold_1,17,0,0,0,-17,20230512_150009_jpg.rf.5eaca93499ee2328bb5b204bc086fa0e.jpg
1_sabl,fold_1,4,2,2,0,-2,IMG_4055_JPG.rf.a1d3f9eab20829bc4aab9b5d5b3db316.jpg
1_sabl,fold_1,3,1,1,0,-2,20230512_145429_jpg.rf.df99f30a99cc1af30b8fe3054ff8d8af.jpg
1_sabl,fold_1,3,2,2,0,-1,IMG_20230512_150829_549_jpg.rf.017095633151bc8caa1cad24d2d1f6bd.jpg
1_sabl,fold_1,10,2,2,0,-8,0230512_150206_jpg.rf.e404633a283ca64c43725aeb3181ac5b.jpg
1_sabl,fold_1,1,1,1,0,0,20230512_145044_jpg.rf.2dd273c7dcfa2783f4fc1f356c3e0fe1.jpg
1_sabl,fold_1,18,5,4,1,-13,IMG_20230512_153031_jpg.rf.5fce0e233ead5453574fecd0d970a691.jpg
1_sabl,fold_1,3,0,0,0,-3,IMG_4197_JPG.rf.f240386fc9d9d286399404892833ad93.jpg
1_sabl,fold_1,2,1,0,1,-1,MG_20230512_145132_jpg.rf.f7010b407a0b401d833ccbcf5807b8c7.jpg
1_sabl,fold_1,15,0,0,0,-15,20230512_151046_jpg.rf.8feca45b0b1694e2250d447c5e17a7e5.jpg
1_sabl,fold_1,21,1,1,0,-20,20230512_153045_jpg.rf.8ee689d2bb2062ede3d6c1a97a93cb0b.jpg
1_sabl,fold_1,2,1,0,1,-1,0024_jpg.rf.d7ace9e90a7a9b7f0bac8fa590936bec.jpg
1_sabl,fold_1,1,1,1,0,0,20230512_151452_jpg.rf.f764099c780fa1069a9d911e32493b58.jpg
1_sabl,fold_1,2,2,2,0,0,0040_jpg.rf.510a2eea8b97902d00189cee85d647f2.jpg
1_sabl,fold_1,14,4,3,1,-10,IMG_20230512_144941_jpg.rf.26b2e56c21b9d1f982031b1a6c82b0cf.jpg
1_sabl,fold_1,6,3,3,0,-3,0230512_145304_jpg.rf.923a0f42aba114205181e2b5316865df.jpg
1_sabl,fold_1,14,0,0,0,-14,20230512_153445_jpg.rf.a406add89c229073e8dc9da3e87a1125.jpg
1_sabl,fold_1,11,2,1,1,-9,IMG_20230512_144945_690_jpg.rf.8f6c97bc8ba7a4170c6509fdaf6dcb51.jpg
1_sabl,fold_1,3,0,0,0,-3,20230512_150255_jpg.rf.06d14e4c4625afe9d0a55233a17ba81c.jpg
1_sabl,fold_1,1,1,1,0,0,20230512_145220_jpg.rf.9fc82d7b84c8883df1efc1dd7d51252b.jpg
1_sabl,fold_1,8,2,1,1,-6,IMG_20230512_151110_jpg.rf.43411da66d27f6993f2c94b13a408a1c.jpg
1_sabl,fold_1,1,0,0,0,-1,IMG_20230512_151305_326_jpg.rf.11e52599cf79be602d4d4480bd5cddda.jpg
1_sabl,fold_1,2,0,0,0,-2,0230512_145048_jpg.rf.17eaa837f3d144d8a30470f44f61f75d.jpg
1_sabl,fold_2,11,0,0,0,-11,20230512_152307_jpg.rf.5ed444510318293300b04fc766ce4222.jpg
1_sabl,fold_2,1,0,0,0,-1,20230512_144953_jpg.rf.8283a702fcffd9d6223570436e1bf3fa.jpg
1_sabl,fold_2,6,0,0,0,-6,20230512_145403_jpg.rf.8df05cb3790b7b04d25d1e08e98dc443.jpg
1_sabl,fold_2,5,0,0,0,-5,20230512_145345_jpg.rf.04a7df632b86568b244790bc2612f409.jpg
1_sabl,fold_2,1,0,0,0,-1,IMG_20230512_151805_jpg.rf.394aa2e3fd7a17a935ec0df1f3258c2f.jpg
1_sabl,fold_2,1,0,0,0,-1,20230512_151500_jpg.rf.e32b98c8b02b5d583e07193899344442.jpg
1_sabl,fold_2,2,0,0,0,-2,0230512_145313_jpg.rf.776dc937578790f899ad676b7712df5d.jpg
1_sabl,fold_2,1,0,0,0,-1,20230512_145047_jpg.rf.95f8311e427ec6f1226783bcfa8aaeb0.jpg
1_sabl,fold_2,17,0,0,0,-17,IMG_20230512_152302_jpg.rf.e72dde5d8164d8312cbc60cf674ac1cc.jpg
1_sabl,fold_2,3,0,0,0,-3,20230512_145143_jpg.rf.e512219fc0a6a155cdc8d6e5375509c0.jpg
1_sabl,fold_2,17,0,0,0,-17,20230512_153128_jpg.rf.ea6f913ebe278f58559dcfc65c663e1e.jpg
1_sabl,fold_2,1,0,0,0,-1,20230512_151801_jpg.rf.2c3c8c1015e6fae6858f400374255844.jpg
1_sabl,fold_2,2,0,0,0,-2,IMG_20230512_150319_jpg.rf.3ae187984f18f173dbb37b3a87dc2edc.jpg
1_sabl,fold_2,2,0,0,0,-2,IMG_20230512_145035_jpg.rf.e406d6ea6e2142bf078dc5712097970d.jpg
1_sabl,fold_2,11,0,0,0,-11,20230512_151045_jpg.rf.a6671c33872e0aa76aa195da177cfb2d.jpg
1_sabl,fold_2,6,0,0,0,-6,20230512_153159_jpg.rf.d07176029cb6d818c3ec89f10bf105eb.jpg
1_sabl,fold_2,2,0,0,0,-2,20230512_145258_jpg.rf.36afe6d426851a363b2a6a7d0c059a06.jpg
1_sabl,fold_2,9,0,0,0,-9,0230512_145016_jpg.rf.c06fc10372ac7c1831d2d51452a8b3e8.jpg
1_sabl,fold_2,5,0,0,0,-5,20230512_151002_jpg.rf.948c61535288e6ba60980bb8fd2b67a6.jpg
1_sabl,fold_2,5,0,0,0,-5,IMG_20230512_150036_jpg.rf.6e167fde12f866a555cb292420cc966c.jpg
1_sabl,fold_2,21,0,0,0,-21,IMG_20230512_150108_jpg.rf.010507bacbd8da808ace5e119e09b182.jpg
1_sabl,fold_2,1,0,0,0,-1,IMG_20230512_151210_354_jpg.rf.8bd99e3d531a171119a6ce1f73298053.jpg
1_sabl,fold_2,16,0,0,0,-16,0058_jpg.rf.0a179a6a2aa1a22cf6d0c2490fc3cca2.jpg
1_sabl,fold_2,2,0,0,0,-2,20230512_150805_jpg.rf.c936fd2cb76b51c90f6b1886c1d67b07.jpg
1_sabl,fold_2,38,0,0,0,-38,0512_150128_jpg.rf.2af323c722a16ccc0c5aa34b5e501664.jpg
1_sabl,fold_2,7,0,0,0,-7,20230512_150107_jpg.rf.5e11723e84aa6da5755cf3c63cf34d7e.jpg
1_sabl,fold_2,5,0,0,0,-5,IMG_20230512_152210_460_jpg.rf.ab8278e1877e151e4ae555c6237762a4.jpg
1_sabl,fold_2,1,0,0,0,-1,IMG_20230512_161352_jpg.rf.55bade867ee284f39237788ac06b0acc.jpg
1_sabl,fold_2,1,0,0,0,-1,IMG_3833_JPG.rf.abe8bed2e2a60f385c89c035ed2e7754.jpg
1_sabl,fold_2,4,0,0,0,-4,20230512_145400_jpg.rf.487d472b7875668199199822410b27fa.jpg
1_sabl,fold_2,3,0,0,0,-3,0006_jpg.rf.4286dc69c06dcdbaf0df817343256a21.jpg
1_sabl,fold_2,4,0,0,0,-4,20230512_151752_jpg.rf.c6abd13d3824e552c45d2ae43cd156c3.jpg
1_sabl,fold_2,6,0,0,0,-6,20230512_145358_jpg.rf.42f74f37b3baefb9f8cb08628d322a69.jpg
1_sabl,fold_2,1,0,0,0,-1,0230512_145420_jpg.rf.e077901cc39df12e7031754a04b4216f.jpg
1_sabl,fold_2,2,0,0,0,-2,20230512_151441_jpg.rf.01b614d64de666a58fed8b8feea9004a.jpg
1_sabl,fold_2,12,0,0,0,-12,20230512_153315_jpg.rf.7906c060598957a1e622c50902191cc1.jpg
1_sabl,fold_2,4,0,0,0,-4,0025_jpg.rf.f5d46a7f5f498531cada47eed608a3e7.jpg
1_sabl,fold_2,6,0,0,0,-6,IMG_3832_JPG.rf.4a27d40741e9e24a57b4d4409e5bf699.jpg
1_sabl,fold_2,4,0,0,0,-4,IMG_20230512_145422_423_jpg.rf.a2f634b682eede423e27173c65e298dc.jpg
1_sabl,fold_2,3,0,0,0,-3,IMG_20230512_145034_jpg.rf.b7070d4f3b8615f07e606e417094950b.jpg
1_sabl,fold_2,6,0,0,0,-6,20230512_151810-0-_jpg.rf.5bab122233efd5d6e060c2de01ae9475.jpg
1_sabl,fold_2,1,0,0,0,-1,20230512_151649_jpg.rf.62f6a7ef7962197e1933352c3cf07e1d.jpg
1_sabl,fold_2,5,0,0,0,-5,20230512_151315_jpg.rf.7d9aa1fa6aeea9c557900122bb89076d.jpg
1_sabl,fold_2,1,0,0,0,-1,230512_150043_jpg.rf.997b92cbbb33f969daf86ff1c0a48495.jpg
1_sabl,fold_2,18,0,0,0,-18,IMG_4215_JPG.rf.f586481a5ed49d1952135b51b94a258f.jpg
1_sabl,fold_2,15,0,0,0,-15,IMG_20230512_152253_596_jpg.rf.e1455dadb47781b4e95ce4f0479c4643.jpg
1_sabl,fold_2,18,0,0,0,-18,IMG_20230512_150056_181_jpg.rf.337f1b254575b10ba95ca7a5b1e7e5aa.jpg
1_sabl,fold_2,13,0,0,0,-13,20230512_150029_jpg.rf.29ca99ad8a2b5956fdc7e21d1601c79f.jpg
1_sabl,fold_2,1,0,0,0,-1,20230512_145239_jpg.rf.0d14eff09fc5186a9eccb0c477759e6b.jpg
1_sabl,fold_2,20,0,0,0,-20,20230512_153255_jpg.rf.72d8abd35f45fdaa52da9b99aa3daf48.jpg
1_sabl,fold_2,24,0,0,0,-24,0106_jpg.rf.ea3d3d53b74e632d3112cfd4b25da4de.jpg
1_sabl,fold_2,2,0,0,0,-2,0230512_145006_jpg.rf.eb1d6247f79c4ed2e093c5fcaf73e407.jpg
1_sabl,fold_2,4,0,0,0,-4,IMG_20230512_145316_jpg.rf.250aaba6ef305223c5dec100c738233c.jpg
1_sabl,fold_2,11,0,0,0,-11,20230512_145205_jpg.rf.8be964bf86f6306b95645b3e8b4177aa.jpg
1_sabl,fold_2,2,0,0,0,-2,20230512_145125_jpg.rf.c0d2af11ce72a4bb0c259d23b2700862.jpg
1_sabl,fold_2,5,0,0,0,-5,20230512_151810_jpg.rf.b4a391d3bd61afb0cff6f47e49a1736e.jpg
1_sabl,fold_2,8,0,0,0,-8,IMG_20230512_151240_jpg.rf.21dc1955fc3611fdbde01fb2d3db23e3.jpg
1_sabl,fold_2,1,0,0,0,-1,IMG_20230512_151233_jpg.rf.75f4efffa9f2c8ddf8c60930c30caa50.jpg
1_sabl,fold_2,2,0,0,0,-2,20230512_145245_jpg.rf.23b906c05c2822f1a0f5a97d26511473.jpg
1_sabl,fold_2,5,0,0,0,-5,20230512_145335-0-_jpg.rf.e11b1b03b49524f5174370062e01b4f7.jpg
1_sabl,fold_2,25,0,0,0,-25,IMG_20230512_150137_686_jpg.rf.87a512bdf05b800f446ab29f4925d265.jpg
1_sabl,fold_2,2,0,0,0,-2,IMG_3837_JPG.rf.6f942021a4fd687376ae5b9b4d970b40.jpg
1_sabl,fold_2,17,0,0,0,-17,20230512_144951_jpg.rf.9ab67b54e372e2d5fcc0ba78e49718cf.jpg
1_sabl,fold_2,1,0,0,0,-1,20230512_153216_jpg.rf.eb0c9677e99c15c65103ae3a612d52d8.jpg
1_sabl,fold_2,16,0,0,0,-16,20230512_144957_jpg.rf.edf44bd7d8feadfc28a3389bd946b805.jpg
1_sabl,fold_2,3,0,0,0,-3,IMG_20230512_145032_jpg.rf.d9c71446c077191b543ca5691d58f022.jpg
1_sabl,fold_2,40,0,0,0,-40,20230512_150324_jpg.rf.3ff2950eb65ac5c31086e53bc4e56ed5.jpg
1_sabl,fold_2,1,0,0,0,-1,20230512_151651-0-_jpg.rf.b824f35100b3f7edb1d2a6095c5dfaa2.jpg
1_sabl,fold_2,23,0,0,0,-23,20230512_153141_jpg.rf.613e5b5025183f2520937d9596cdd56a.jpg
1_sabl,fold_2,1,0,0,0,-1,IMG_3846_JPG.rf.6ac47067db06f4b0377dc758d0af3e6e.jpg
1_sabl,fold_2,13,0,0,0,-13,IMG_20230512_145059_jpg.rf.ca7ed19e9dee72856eedaac64c143c22.jpg
1_sabl,fold_2,7,0,0,0,-7,20230512_150118_jpg.rf.995a1787a6672b3228e543351c485407.jpg
1_sabl,fold_2,29,0,0,0,-29,20230512_150102_jpg.rf.992c8db88e8e711f38b63308f2f2ceb0.jpg
1_sabl,fold_2,1,0,0,0,-1,IMG_20230512_153419_jpg.rf.9224e0b2559139217bdba3afdc04378c.jpg
1_sabl,fold_2,13,0,0,0,-13,20230512_153022_jpg.rf.863e7532bc45f9f8755c15b6a24dda83.jpg
1_sabl,fold_2,59,0,0,0,-59,20230512_153358_jpg.rf.97d1a8ba190dcaf1d26753099c80dac6.jpg
1_sabl,fold_2,3,0,0,0,-3,20230512_145406_jpg.rf.b6c696ca3ffd7789f8655f344c1ccd98.jpg
1_sabl,fold_2,3,0,0,0,-3,IMG_4387_JPG.rf.3205816644d251fe12961d17cfe8b818.jpg
1_sabl,fold_2,10,0,0,0,-10,20230512_150020_jpg.rf.6a0dfe027260521f3168f7985b48272f.jpg
1_sabl,fold_2,1,0,0,0,-1,0011_jpg.rf.ef78555de2ee0947227176b9c9b4319b.jpg
1_sabl,fold_2,10,0,0,0,-10,20230512_150229_jpg.rf.db8357bef31fe081f8e5059cfd0c9fb4.jpg
1_sabl,fold_2,2,0,0,0,-2,20230512_151743_jpg.rf.6203480990e7a828e8c8e3f743a0053b.jpg
1_sabl,fold_2,6,0,0,0,-6,20230512_145157_jpg.rf.459cfae5642460c5c30e67dd372cadcc.jpg
1_sabl,fold_2,2,0,0,0,-2,20230512_145122_jpg.rf.f302914da7ccad75fb2edfd9b9ec0efd.jpg
1_sabl,fold_2,13,0,0,0,-13,IMG_20230512_145118_jpg.rf.d1ef05f6a7704db2945116a966e5bd70.jpg
1_sabl,fold_2,6,0,0,0,-6,20230512_153037_jpg.rf.b93a210f722c0d5464f223e099ec3dce.jpg
1_sabl,fold_2,3,0,0,0,-3,20230512_150758_jpg.rf.8a907872529b09fec41c34fbc4a3c85b.jpg
1_sabl,fold_2,3,0,0,0,-3,20230512_145126_jpg.rf.76790ff28fba433b2868c3becc799204.jpg
1_sabl,fold_2,111,0,0,0,-111,0105_jpg.rf.21f79c1f08ac725f3eafce77e52091e8.jpg
1_sabl,fold_2,3,0,0,0,-3,20230512_145438_jpg.rf.c1caee1e341cc9a711b6cf640a2a8509.jpg
1_sabl,fold_2,4,0,0,0,-4,IMG_20230512_145346_jpg.rf.515d73a420cc0607f0a677c3ec22ea14.jpg
1_sabl,fold_2,4,0,0,0,-4,20230512_145144_jpg.rf.f15cd7a8e403d35924c9a9953ceb0ed2.jpg
1_sabl,fold_2,11,0,0,0,-11,20230512_150030_jpg.rf.6f76526d3409cadbfe960092b45d99ff.jpg
1_sabl,fold_2,14,0,0,0,-14,20230512_151050_jpg.rf.bb1678e3a1546f2d4b401bf96df99936.jpg
1_sabl,fold_2,1,0,0,0,-1,230512_150038_jpg.rf.9ebbdcccc679c75c9dceb5b2e686d104.jpg
1_sabl,fold_2,8,0,0,0,-8,20230512_151748_jpg.rf.fdcf266c293fa03554fecbec46885bcf.jpg
1_sabl,fold_2,4,0,0,0,-4,20230512_145131_jpg.rf.05acfd31fb743167b9795df743ef22b4.jpg
1_sabl,fold_2,5,0,0,0,-5,IMG_20230512_150030_jpg.rf.eb7e32ee807e4ad675ec4b1f485d1194.jpg
1_sabl,fold_2,3,0,0,0,-3,20230512_151026-copia-1-_jpg.rf.25048c6b13b3d64d8a468f548967f5d4.jpg
1_sabl,fold_2,1,0,0,0,-1,IMG_4042_JPG.rf.3b0722af6ff7f5abfc5b80296e0e51a4.jpg
1_sabl,fold_2,1,0,0,0,-1,0230512_145106_jpg.rf.f11d7922f45bb3e9056a0274e877bd6f.jpg
1_sabl,fold_2,4,0,0,0,-4,20230512_145152_jpg.rf.c078905785bf4f39e87ab4dbfeb67b79.jpg
1_sabl,fold_2,2,0,0,0,-2,IMG_20230512_151751_jpg.rf.86507ee6252cc7d41c2fa99c5f84bbc9.jpg
1_sabl,fold_2,8,0,0,0,-8,20230512_145155_jpg.rf.483609701afa99b05a432395c2a1dc59.jpg
1_sabl,fold_2,1,0,0,0,-1,20230512_151501_jpg.rf.16af334ffaad29022c4afa8eda4bbb5b.jpg
1_sabl,fold_2,4,0,0,0,-4,20230512_150208_jpg.rf.5e82906cb9373103e9e98ed6a4338a1e.jpg
1_sabl,fold_2,2,0,0,0,-2,20230512_151704_jpg.rf.fd83532c35f591e140a380aa12cd8530.jpg
1_sabl,fold_2,4,0,0,0,-4,0230512_145310_jpg.rf.58da36115ae6f33dda807758d87657c9.jpg
1_sabl,fold_2,8,0,0,0,-8,20230512_145134_jpg.rf.5d0f231790df81ba4a0051d2b6752135.jpg
1_sabl,fold_2,4,0,0,0,-4,20230512_150055_jpg.rf.4cc48b2b47552b6368afa5d3491ee008.jpg
1_sabl,fold_2,19,0,0,0,-19,IMG_20230512_150053_jpg.rf.0df30dcd2353d3b9fb7a7df012361881.jpg
1_sabl,fold_2,10,0,0,0,-10,20230512_152215_jpg.rf.a4d9425dfde22fcd54004debebaf80ce.jpg
1_sabl,fold_2,6,0,0,0,-6,20230512_145408_jpg.rf.3d8eeed18535cb95a6e8d1931052f34c.jpg
1_sabl,fold_2,8,0,0,0,-8,20230512_152941_jpg.rf.a2201e1690ef639f51bfe7ce95cec221.jpg
1_sabl,fold_2,3,0,0,0,-3,20230512_151306_jpg.rf.cfe45d7efb4a4c29beccc71f36871b48.jpg
1_sabl,fold_2,1,0,0,0,-1,IMG_20230512_151234_jpg.rf.b19f52712286d372282ee90e4f3a8c24.jpg
1_sabl,fold_2,6,0,0,0,-6,IMG_20230512_145136_jpg.rf.a268e723779ce1a1a30472767d3788c0.jpg
1_sabl,fold_2,4,0,0,0,-4,20230512_145405_jpg.rf.583b8e88a9d9542c857773d30f074199.jpg
1_sabl,fold_2,1,0,0,0,-1,20230512_151808_jpg.rf.88493c8cb7d1ddd67bcbdd48f290be76.jpg
1_sabl,fold_2,2,0,0,0,-2,IMG_20230512_151255_jpg.rf.085333bc247d4e08cfef9873bd98d250.jpg
1_sabl,fold_2,14,0,0,0,-14,20230512_145200_jpg.rf.a6508f9b4a5dc4d2e37a648f6f58cad7.jpg
1_sabl,fold_2,5,0,0,0,-5,IMG_20230512_150153_jpg.rf.21455b2b84261cf0a3ce6dd9147d31c2.jpg
1_sabl,fold_2,9,0,0,0,-9,0230512_145438_jpg.rf.8d0faa32dac3b0a8d27ae1876a0db052.jpg
1_sabl,fold_2,1,0,0,0,-1,20230512_145023_jpg.rf.b2955fd5ab715016af10f2efa47feb0c.jpg
1_sabl,fold_2,4,0,0,0,-4,IMG_3986_JPG.rf.5f1e1a04a780c294057b3aeb49ce1327.jpg
1_sabl,fold_2,2,0,0,0,-2,20230512_151639_jpg.rf.2e5a4b318c40ab84158ba5ef4ab1ae75.jpg
1_sabl,fold_2,2,0,0,0,-2,0010_jpg.rf.5d4cbd2e216fb4306b05f3a979d801a6.jpg
1_sabl,fold_2,61,0,0,0,-61,20230512_153154_jpg.rf.8e0789e24006a0265466d9bf9fdd2d5d.jpg
1_sabl,fold_2,3,0,0,0,-3,IMG_3866_JPG.rf.9976a97a1422b88843b54c8cfe8f8cef.jpg
1_sabl,fold_2,2,0,0,0,-2,20230512_145123_jpg.rf.7c684cfce69e0678a5f37aceb8e58703.jpg
1_sabl,fold_2,2,0,0,0,-2,20230512_151634_jpg.rf.4af8920897c95556710f5d66b8848580.jpg
1_sabl,fold_2,1,0,0,0,-1,20230512_151253_jpg.rf.b5e989a50a5c70e0f8911ebb246c4bd9.jpg
1_sabl,fold_2,6,0,0,0,-6,20230512_153108_jpg.rf.d3d27e961d217f62f45c29eec6d6c2ed.jpg
1_sabl,fold_2,31,0,0,0,-31,0512_150045_jpg.rf.097128a0f4dc3739d053c017dd7fd643.jpg
1_sabl,fold_2,2,0,0,0,-2,20230512_145217_jpg.rf.8b4c9e235361be21ec1ef0addc99dc7a.jpg
1_sabl,fold_2,13,0,0,0,-13,20230512_153057_jpg.rf.4d29da76e8c70adbe3707715c3333882.jpg
1_sabl,fold_2,1,0,0,0,-1,20230512_145040_jpg.rf.c652c89ab18a37e582fa39fe9f7abdc6.jpg
1_sabl,fold_2,10,0,0,0,-10,IMG_20230512_145100_jpg.rf.e7b035adf2c640d6a600846236b01b19.jpg
1_sabl,fold_2,1,0,0,0,-1,20230512_151458_jpg.rf.44033d4e267440e0172a403e2c9b2c2f.jpg
1_sabl,fold_2,1,0,0,0,-1,IMG_4039_JPG.rf.3f78f739ca76cba4136559eee15bdd94.jpg
1_sabl,fold_2,15,0,0,0,-15,IMG_20230512_150039_1_jpg.rf.ffd13d7440dc972309a1f58f33063648.jpg
1_sabl,fold_2,2,0,0,0,-2,0230512_145340_jpg.rf.beb3f9c554344398d6f6007f748edd63.jpg
1_sabl,fold_2,8,0,0,0,-8,IMG_4188_JPG.rf.2b1e9cc2bc82b3d05861cab7bdbfb235.jpg
1_sabl,fold_2,4,0,0,0,-4,IMG_20230512_145231_804_jpg.rf.35d239e095afd813f22e568b66281c10.jpg
1_sabl,fold_2,8,0,0,0,-8,20230512_152333_jpg.rf.901f79538b04a75cfd995edb99dba147.jpg
1_sabl,fold_2,1,0,0,0,-1,IMG_20230512_151122_744_jpg.rf.0203c58a683248c6ba3e7ca2baa5ee22.jpg
1_sabl,fold_2,9,0,0,0,-9,20230512_152403_jpg.rf.21f06ac205b62518bb4ac1c1d05a2bce.jpg
1_sabl,fold_2,21,0,0,0,-21,20230512_150012_jpg.rf.5bc4d2f31a26aab541fdbeb4a437985a.jpg
1_sabl,fold_2,8,0,0,0,-8,20230512_150920_jpg.rf.5224cc7eab4f53f93bdec2d81bba5f0e.jpg
1_sabl,fold_2,7,0,0,0,-7,20230512_145404_jpg.rf.91d448b69a976705a98b28002a84c842.jpg
1_sabl,fold_2,1,0,0,0,-1,0003_jpg.rf.bf7cde9cd5a6dc0cc2ee160ef4121efe.jpg
1_sabl,fold_2,7,0,0,0,-7,IMG_20230512_145054_jpg.rf.b241c4cdeabfff0793bff4970cd95da2.jpg
1_sabl,fold_2,1,0,0,0,-1,20230512_145032-0-_jpg.rf.dc8b664d3fb1425d1783c11f8bcb0068.jpg
1_sabl,fold_2,2,0,0,0,-2,20230512_145316-0-_jpg.rf.6c2d352bf056f852f59df415c04c3b73.jpg
1_sabl,fold_2,6,0,0,0,-6,IMG_4037_JPG.rf.c2e2f236825c2dff84efbeb902eeb29d.jpg
1_sabl,fold_2,2,0,0,0,-2,IMG_3916_JPG.rf.250aee83d82e083052118d5322edb81e.jpg
1_sabl,fold_2,3,0,0,0,-3,20230512_150045_jpg.rf.56868f65f25cf730ad8340c6a67caa9b.jpg
1_sabl,fold_3,3,1,0,1,-2,20230512_145409_jpg.rf.d09685c8c603cbe9e1a20305c3a191ef.jpg
1_sabl,fold_3,6,3,3,0,-3,20230512_150944_jpg.rf.eaecb1ecef20585ed9293d182792536f.jpg
1_sabl,fold_3,9,8,7,1,-1,IMG_20230512_152206_244_jpg.rf.39d59820f61b06056f549a4d3442ac7b.jpg
1_sabl,fold_3,5,5,3,2,0,20230512_151749_jpg.rf.05c1da9e8ad61457f7836f667088adf9.jpg
1_sabl,fold_3,5,4,4,0,-1,0004_jpg.rf.851243b8e41e3a1bd722c5b177c9bf93.jpg
1_sabl,fold_3,1,1,1,0,0,20230512_151806_jpg.rf.26383849e96ac2c96291e0c7409e44d2.jpg
1_sabl,fold_3,1,1,1,0,0,0012_jpg.rf.48d09ce5c069b09d1c9d6cf497ff9a97.jpg
1_sabl,fold_3,5,4,3,1,-1,20230512_151026_jpg.rf.d30352bb19624c98cae22d002974b61a.jpg
1_sabl,fold_3,9,6,5,1,-3,20230512_151855_jpg.rf.e3fa630bb03de4788e09724f320ec036.jpg
1_sabl,fold_3,2,0,0,0,-2,20230512_145316_jpg.rf.496d4ed779e1450c242495fa46e36987.jpg
1_sabl,fold_3,4,2,2,0,-2,20230512_153116_jpg.rf.cdd42e1383bc6c130d47f65e21bcc4e6.jpg
1_sabl,fold_3,5,2,2,0,-3,20230512_145437_jpg.rf.0909c9ccb332356410c1a52743b7c7bf.jpg
1_sabl,fold_3,4,0,0,0,-4,20230512_153139_jpg.rf.c012da59f33e990f927df57e0a6a7f6c.jpg
1_sabl,fold_3,3,1,1,0,-2,0031_jpg.rf.895d9050f9dc5640677a308629b20ad8.jpg
1_sabl,fold_3,21,17,15,2,-4,IMG_20230512_152944_jpg.rf.cda9c2160b066ef7e220cf96a991f737.jpg
1_sabl,fold_3,8,8,6,2,0,IMG_4187_JPG.rf.f301f6508b0e93d82808ac4e2f80dab0.jpg
1_sabl,fold_3,1,0,0,0,-1,230512_150212_jpg.rf.3e63a63731d99962cf04897093c61c0e.jpg
1_sabl,fold_3,3,1,1,0,-2,20230512_150056_jpg.rf.c9ae963578e609418dc9e533e5a26adf.jpg
1_sabl,fold_3,7,4,4,0,-3,IMG_20230512_153337_765_jpg.rf.f1a04e6d77f25605da1438e3829fd581.jpg
1_sabl,fold_3,10,5,0,5,-5,0200_jpg.rf.72e8b4790e76291a0c9e6877dd61eef5.jpg
1_sabl,fold_3,4,1,1,0,-3,IMG_20230512_151438_jpg.rf.ff747d9ae06e7829a2e860bb43baf295.jpg
1_sabl,fold_3,1,1,1,0,0,IMG_20230512_145007_395_jpg.rf.b8b6b70654f786328e3fe2f85e949a6f.jpg
1_sabl,fold_3,1,0,0,0,-1,0014_jpg.rf.edb35667570fa3a23afcb19d179ea59d.jpg
1_sabl,fold_3,2,1,0,1,-1,20230512_151640_jpg.rf.4b7574d0b6f05544e5a43a5be4589a6f.jpg
1_sabl,fold_3,1,1,1,0,0,20230512_151616_jpg.rf.73b54fe227f3ac8f3da41b5fba2b170a.jpg
1_sabl,fold_3,43,1,1,0,-42,IMG_20230512_150354_jpg.rf.1ed97bfbf8670ca6750d76619dac51ef.jpg
1_sabl,fold_3,1,0,0,0,-1,20230512_145009_jpg.rf.9f8f641e028bed4b2706301af0fb27ee.jpg
1_sabl,fold_3,3,3,2,1,0,20230512_152204_jpg.rf.b0b665cf50c6b54094f4fe1a4a01ecce.jpg
1_sabl,fold_3,4,3,3,0,-1,20230512_145348-0-_jpg.rf.a616aa6a3ced888f83d2044dbd9ec726.jpg
1_sabl,fold_3,9,7,4,3,-2,IMG_20230512_145301_jpg.rf.71b506460c51cef84cbbfdc651695e13.jpg
1_sabl,fold_3,9,3,2,1,-6,20230512_145156_jpg.rf.85e178453eba594f6ce65cebf40de3fb.jpg
1_sabl,fold_3,3,0,0,0,-3,20230512_150025_jpg.rf.0bef8a6273605277f912993bceb28c2c.jpg
1_sabl,fold_3,4,1,1,0,-3,20230512_145130_jpg.rf.51678843234545aa7f95a07feefbe048.jpg
1_sabl,fold_3,1,0,0,0,-1,0230512_145124_jpg.rf.24447141d50bf7957914c622cb19bbc6.jpg
1_sabl,fold_3,1,1,1,0,0,20230512_151656_jpg.rf.581bfb229dea559f67a2aa2ac578db62.jpg
1_sabl,fold_3,2,0,0,0,-2,IMG_20230512_145127_jpg.rf.d2db7f78af8d459d1ccab501da8c6fcd.jpg
1_sabl,fold_3,3,2,2,0,-1,IMG_20230512_145110_jpg.rf.d1d01bf0ca4a3344a6bf7d4b94e63c96.jpg
1_sabl,fold_3,2,2,1,1,0,230512_150052_jpg.rf.495fe344c6875f2116d1ef5a0bd92daf.jpg
1_sabl,fold_3,3,0,0,0,-3,IMG_3934_JPG.rf.1b359ac7d45ac33c7623f668cb9731d0.jpg
1_sabl,fold_3,8,1,0,1,-7,IMG_20230512_150231_jpg.rf.764af7adf374d2dee3739d99e3a0d56a.jpg
1_sabl,fold_3,7,4,4,0,-3,IMG_20230512_145110_246_jpg.rf.153877ddf43d3d76a37f64fb0aa5f617.jpg
1_sabl,fold_3,15,3,2,1,-12,20230512_150106_jpg.rf.3025eeb24b28ae43f2ad27872636bbbf.jpg
1_sabl,fold_3,1,1,1,0,0,20230512_151113_jpg.rf.b6cd4222d666bbace543a8c77d865f35.jpg
1_sabl,fold_3,2,2,2,0,0,20230512_151756_jpg.rf.6e05ac20e235330456b0b0d06c00138c.jpg
1_sabl,fold_3,1,1,1,0,0,20230512_151035_jpg.rf.103e19cb70bac5049a33c63e773d1a79.jpg
1_sabl,fold_3,6,2,2,0,-4,230512_145340_jpg.rf.9fdd58e2d10ba1375e278a07b95c337c.jpg
1_sabl,fold_3,12,3,0,3,-9,20230512_145203_jpg.rf.35ba545e195d0af402a018f91a322dab.jpg
1_sabl,fold_3,11,9,7,2,-2,IMG_20230512_153029_jpg.rf.80e951915c88eafeea885e5fb27b45e8.jpg
1_sabl,fold_3,2,0,0,0,-2,0230512_145130_jpg.rf.faddf96f4d26a63f9284354dd447afd4.jpg
1_sabl,fold_3,13,2,2,0,-11,20230512_145238_jpg.rf.b85535f8851b826fe2e42e26692f5635.jpg
1_sabl,fold_3,9,1,0,1,-8,20230512_153316_jpg.rf.24b77c461257ba1bd947e731de450708.jpg
1_sabl,fold_3,27,1,1,0,-26,20230512_150125_jpg.rf.d10c3232f4247c5514953cf92c7083c5.jpg
1_sabl,fold_3,3,1,1,0,-2,20230512_151438_jpg.rf.9d2b9be770df6ec4ba79d984fe00b8b4.jpg
1_sabl,fold_3,50,6,5,1,-44,0512_150210_jpg.rf.a172e8c839e22e596b7db396b08d63d1.jpg
1_sabl,fold_3,17,6,5,1,-11,20230512_150321_jpg.rf.a5e551cbda2cf857d53bcbd4d60b92c5.jpg
1_sabl,fold_3,1,0,0,0,-1,20230512_151213_jpg.rf.419a445cd8b3392ce737e6b1c6cb0d88.jpg
1_sabl,fold_3,7,7,7,0,0,IMG_20230512_152958_116_jpg.rf.12bbdfc4e9ae5914029f9e97d0fcd224.jpg
1_sabl,fold_3,8,2,2,0,-6,0230512_145231_jpg.rf.f02c6f94b7286a6b59a1c8b2423f5ba8.jpg
1_sabl,fold_3,20,11,10,1,-9,20230512_152944_jpg.rf.3c5b2edc21ab50f9893441607f43f699.jpg
1_sabl,fold_3,10,6,6,0,-4,20230512_152328_jpg.rf.9afc7b5536cb56c41fedd9c22fd78fe4.jpg
1_sabl,fold_3,1,1,1,0,0,20230512_151448_jpg.rf.83cf709cf0b2547d212be3a377779599.jpg
1_sabl,fold_3,4,0,0,0,-4,20230512_145151_jpg.rf.1c7cdb8ed83d156aba9a1e8e94becd21.jpg
1_sabl,fold_3,2,1,1,0,-1,0230512_145009_jpg.rf.027a2f31eb1269ab45f13bf35444b96c.jpg
1_sabl,fold_3,24,9,9,0,-15,20230512_153310_jpg.rf.4207c4421e3464536cb4bd47453058d2.jpg
1_sabl,fold_3,1,0,0,0,-1,20230512_145103_jpg.rf.62604473c5e590c815e5d908b8d354a0.jpg
1_sabl,fold_3,2,1,1,0,-1,IMG_20230512_145351_839_jpg.rf.676aa37e025296713a6e39f90d91aa3b.jpg
1_sabl,fold_3,4,3,3,0,-1,20230512_152301-0-_jpg.rf.1afa46256fa26afe6cd36253d167878e.jpg
1_sabl,fold_3,5,4,3,1,-1,IMG_20230512_145310_230_jpg.rf.a3b7f15bfc867ece22ea5c289b0d4b74.jpg
1_sabl,fold_3,12,1,1,0,-11,20230512_150153_jpg.rf.330fb945dbe64ad88c012d6c611ab4e9.jpg
1_sabl,fold_3,9,10,8,2,1,20230512_152315_jpg.rf.e5aebd25c65f9475f8256b49c71ff68a.jpg
1_sabl,fold_3,1,0,0,0,-1,20230512_151304_jpg.rf.820f387501b1325203f72b034ae1ff0a.jpg
1_sabl,fold_3,5,1,0,1,-4,IMG_3842_JPG.rf.4a4a46be5bc0098c5e1314e61ddc11de.jpg
1_sabl,fold_3,1,1,1,0,0,20230512_145219_jpg.rf.0755ac5ed17a2444b92a33aaea06d7a3.jpg
1_sabl,fold_3,16,4,4,0,-12,20230512_150148_jpg.rf.0d501896a72c41b99bfcd956b0436fb3.jpg
1_sabl,fold_3,5,1,0,1,-4,IMG_20230512_145011_556_jpg.rf.00fbb204260504401d5042a1e1cd5b8d.jpg
1_sabl,fold_3,1,0,0,0,-1,IMG_20230512_145336_167_jpg.rf.b667487bd924e740ebac74f50e1e463d.jpg
1_sabl,fold_3,11,7,6,1,-4,20230512_150201_jpg.rf.c4784605e4e8290a39a5a8546b8daf34.jpg
1_sabl,fold_3,14,14,12,2,0,0056_jpg.rf.de05042e164d7742536e2b31f92d3670.jpg
1_sabl,fold_3,1,1,1,0,0,0034_jpg.rf.32acf93f344bd74d2605e49ed3db9e0e.jpg
1_sabl,fold_3,9,1,1,0,-8,0230512_150100_jpg.rf.bac5d1418079223e898fdae8b34c9b0d.jpg
1_sabl,fold_3,2,0,0,0,-2,IMG_3983_JPG.rf.9148c9d4463c4afaf34c762d4c53ead6.jpg
1_sabl,fold_3,13,3,1,2,-10,20230512_150105_jpg.rf.9bb4f73900fecf656a093f8eac337860.jpg
1_sabl,fold_3,4,0,0,0,-4,20230512_145124_jpg.rf.b61b648c127689b8eeb3a43495c3df3e.jpg
1_sabl,fold_3,16,12,12,0,-4,IMG_20230512_152416_jpg.rf.924528612413e225894a24fc2dec0a36.jpg
1_sabl,fold_3,1,2,1,1,1,20230512_152207_jpg.rf.61fece27ba33f3c6fc069a211008dab5.jpg
1_sabl,fold_3,23,2,2,0,-21,_20230512_150225_jpg.rf.9718d11f60b7e396ae6928ae7f14c90b.jpg
1_sabl,fold_3,19,7,6,1,-12,20230512_150239_jpg.rf.e13a84d4d7ec0f7e070c7ccb4fb737b3.jpg
1_sabl,fold_3,4,4,4,0,0,20230512_152346_jpg.rf.a8c2948d3e9aa465d912f3465556eb90.jpg
1_sabl,fold_3,6,3,3,0,-3,20230512_150818_jpg.rf.58c0f3208c48520ddc0588916be6397c.jpg
1_sabl,fold_3,1,1,1,0,0,IMG_20230512_150843_jpg.rf.3c9dacc8aa8ae98bcec98a6b950df819.jpg
1_sabl,fold_3,1,1,0,1,0,IMG_3839_JPG.rf.2b8f533bc337b2b41e4aa08d82c895f0.jpg
1_sabl,fold_3,13,0,0,0,-13,IMG_20230512_150401_jpg.rf.0f4c64f7dd592050ecd9a38797714f40.jpg
1_sabl,fold_3,4,1,0,1,-3,0008_jpg.rf.3fe730c41fdc7b3704f6885ae667338f.jpg
1_sabl,fold_3,7,4,4,0,-3,IMG_20230512_150236_jpg.rf.b127381341df0777f6b90c3d6193ab5f.jpg
1_sabl,fold_3,13,6,5,1,-7,20230512_153104_jpg.rf.e6b0a044d9369e49df9c83ed02c5f924.jpg
1_sabl,fold_3,1,1,1,0,0,20230512_151446_jpg.rf.e46015a969282d2959dba6262188eb21.jpg
1_sabl,fold_3,1,1,1,0,0,IMG_4046_JPG.rf.5365cbd02513c386b454d943407c56e0.jpg
1_sabl,fold_3,7,3,3,0,-4,IMG_20230512_150841_155_jpg.rf.8f074ff9aa19c6cf12ce37edaace8c77.jpg
1_sabl,fold_3,3,1,1,0,-2,20230512_145122-0-_jpg.rf.7f7266ca36660b1ab4d0a4f2a704a54e.jpg
1_sabl,fold_3,3,4,4,0,1,20230512_151620_jpg.rf.ced9071f82dc586dd5ac71f5fae00dc4.jpg
1_sabl,fold_3,1,1,1,0,0,20230512_151655_jpg.rf.1681dccfc685ad40e584cad62c4f6b8e.jpg
1_sabl,fold_3,8,2,2,0,-6,0230512_145235_jpg.rf.20bb212232c9b2421611218796835da2.jpg
1_sabl,fold_3,13,2,1,1,-11,20230512_151008_jpg.rf.0cd6367e8494296811c3d1a88e22360b.jpg
1_sabl,fold_3,12,12,12,0,0,IMG_20230512_152352_jpg.rf.2c7ab0d8791aacf1c20aa134ddf7f9ed.jpg
1_sabl,fold_3,2,2,1,1,0,IMG_20230512_151034_jpg.rf.d8d2ab03b8a59931929429b4bc8c7106.jpg
1_sabl,fold_3,12,2,1,1,-10,IMG_20230512_150124_jpg.rf.fef0579e7a6b4c283294de15512f524a.jpg
1_sabl,fold_3,7,1,0,1,-6,20230512_150027_jpg.rf.787439d34fc22269c3ab90e55ea595ed.jpg
1_sabl,fold_3,3,3,2,1,0,20230512_151627_jpg.rf.9dc28340fd04ffea8cf28dd5e51283d6.jpg
1_sabl,fold_3,4,2,2,0,-2,IMG_20230512_151218_jpg.rf.10b21ddd648ad67d1f264e8b99ead4d4.jpg
1_sabl,fold_3,37,6,6,0,-31,IMG_20230512_150249_jpg.rf.61bc4fbd0c49a88a29443f72cc742e3b.jpg
1_sabl,fold_3,6,1,0,1,-5,20230512_150023_jpg.rf.06c0ade806a1d3e688bc144ef13dbaf8.jpg
1_sabl,fold_3,8,2,2,0,-6,20230512_150210_jpg.rf.e4435f297c285583a73370f97d9cef80.jpg
1_sabl,fold_3,8,5,5,0,-3,IMG_4089_JPG.rf.7967cd5700ba2e9b62aa13ecaa3a28b1.jpg
1_sabl,fold_3,0,6,0,6,6,0031_jpg.rf.00b387ba75b602a79b19e9003038b8ea.jpg
1_sabl,fold_3,3,2,2,0,-1,IMG_4196_JPG.rf.66adce382a697aad33bcbc7ab8814677.jpg
1_sabl,fold_3,26,3,2,1,-23,0512_150111_jpg.rf.d4cf10c518eff125048b590e0a4605cb.jpg
1_sabl,fold_3,2,2,2,0,0,IMG_20230512_151827_jpg.rf.e428f11ebc690c01de13c493aaf89f10.jpg
1_sabl,fold_3,4,1,1,0,-3,0009_jpg.rf.14ae6cb384f301625cca9baa804d99e2.jpg
1_sabl,fold_3,6,2,2,0,-4,IMG_20230512_145423_jpg.rf.f32325604574f1dc3efee2c645d2272b.jpg
1_sabl,fold_3,8,0,0,0,-8,20230512_150140_jpg.rf.b2c7162d38d1696ac9436b4c5de3c5bd.jpg
1_sabl,fold_3,3,1,0,1,-2,20230512_145132_jpg.rf.b2c282982621d398e0a5b6f181a8e8c1.jpg
1_sabl,fold_3,18,14,14,0,-4,20230512_153054_jpg.rf.acae07a63d6f22a0dc7fca55cf6b2d89.jpg
1_sabl,fold_3,5,5,4,1,0,0005_jpg.rf.619937b06bbe7d217806b697a9eaf55e.jpg
1_sabl,fold_3,2,1,0,1,-1,230512_150120_jpg.rf.1f7889194211bdac4259fdcd65e2af46.jpg
1_sabl,fold_3,17,6,5,1,-11,IMG_20230512_150215_jpg.rf.9b54f4c34af6ee37c5ada817e2111c19.jpg
1_sabl,fold_3,3,2,0,2,-1,20230512_145242_jpg.rf.88c3024b1c64b0b6b0db5dddea0bbe0e.jpg
1_sabl,fold_3,17,7,5,2,-10,0230512_145032_jpg.rf.e9aeb44392fbee708cc4bb450582bc0f.jpg
1_sabl,fold_3,1,0,0,0,-1,0001_jpg.rf.a9b41d3e1ed49082f175c1d3de0b732e.jpg
1_sabl,fold_3,19,4,4,0,-15,IMG_20230512_150300_jpg.rf.4a9882ab0ad5a15acf150bad52ccf7d8.jpg
1_sabl,fold_3,26,1,1,0,-25,IMG_20230512_150103_353_jpg.rf.eaad90385ad647d1df922a626623f903.jpg
1_sabl,fold_3,7,0,0,0,-7,20230512_150022_jpg.rf.5a680d2814abd10e92a1f6ddf628a4b0.jpg
1_sabl,fold_3,2,1,1,0,-1,0015_jpg.rf.1f8e46b5b78af1818a40afacf5a7fe1f.jpg
1_sabl,fold_3,4,2,0,2,-2,IMG_20230512_144918_793_jpg.rf.fe7a52b8285a2a10f29948f41ac02b51.jpg
1_sabl,fold_3,3,1,1,0,-2,20230512_145233_jpg.rf.8a9f06089b7122f3b71b6b1b537d6310.jpg
1_sabl,fold_3,1,1,1,0,0,20230512_151802_jpg.rf.9a715b86b471f00ddc7bd3a521537317.jpg
1_sabl,fold_3,18,14,12,2,-4,20230512_153055_jpg.rf.0b63692f9c79fad5834fab15740f4292.jpg
1_sabl,fold_3,2,3,2,1,1,20230512_151739_jpg.rf.fecdc818de88f0d7b449820f099a729b.jpg
1_sabl,fold_3,4,0,0,0,-4,20230512_150313_jpg.rf.7d2a23518189f8dfc49022c0bb08346b.jpg
1_sabl,fold_3,6,4,4,0,-2,20230512_153401_jpg.rf.1ded42782d8fd0ae0793add50267e0f5.jpg
1_sabl,fold_3,3,2,2,0,-1,20230512_152321_jpg.rf.b0515ed603d5d83688c8ee2dfedeaa66.jpg
1_sabl,fold_3,1,0,0,0,-1,20230512_151233_jpg.rf.57d77820fe4dbc49f59fbae1adba2530.jpg
1_sabl,fold_3,8,7,6,1,-1,IMG_20230512_145010_jpg.rf.ba751af01c38c7678521f2c4ac49568d.jpg
1_sabl,fold_3,11,2,2,0,-9,20230512_150957_jpg.rf.2c85fc69db682fcfa08ad10362437bf3.jpg
1_sabl,fold_3,2,2,1,1,0,0026_jpg.rf.10b0037e1af1fddb19365505a0710c5e.jpg
1_sabl,fold_3,1,0,0,0,-1,0230512_145119_jpg.rf.a6362e13240d8879ce6e61258d8292ff.jpg
1_sabl,fold_3,12,5,4,1,-7,IMG_20230512_152237_316_jpg.rf.d5f18e3c135f2f386671e759efda8b69.jpg
1_sabl,fold_3,13,13,9,4,0,20230512_152314_jpg.rf.6c3a181a30741b0f98140ba02a523656.jpg
1_sabl,fold_3,21,5,3,2,-16,IMG_20230512_150127_jpg.rf.93acf533bedd75541341479d4df15bde.jpg
1_sabl,fold_3,10,8,8,0,-2,IMG_4194_JPG.rf.4cdca480fa2d46704cadc5840d0238b9.jpg
1_sabl,fold_3,2,2,2,0,0,20230512_145425_jpg.rf.8c9689378836a9437ec8ca49c37064b8.jpg
1_sabl,fold_3,9,0,0,0,-9,20230512_150034_jpg.rf.d8c7b9720feb16c5a52d002b7d3fdbec.jpg
1_sabl,fold_3,2,2,2,0,0,20230512_151800_jpg.rf.60975505aa8c8066f47f273831b23407.jpg
1_sabl,fold_3,15,15,15,0,0,IMG_20230512_152327_jpg.rf.9a4db2d219a086a344f3eb954ba715b9.jpg
1_sabl,fold_3,8,4,4,0,-4,20230512_153038_jpg.rf.263cbf9b4c15ef94a433b3b4d9c52ad6.jpg
1_sabl,fold_3,2,2,2,0,0,20230512_151740_jpg.rf.bfe7cb62c2579413cf5790e5fdbe33bc.jpg
1_sabl,fold_3,3,3,2,1,0,20230512_151622_jpg.rf.99d95c55959b0e321e3679e87f923922.jpg
1_sabl,fold_3,1,1,1,0,0,0007_jpg.rf.2f8d48ecd0ea275fbd9f39696545a7de.jpg
1_sabl,fold_4,8,4,4,0,-4,20230512_152304_jpg.rf.af417071e5055ff7a21c7e5c8a36b6b4.jpg
1_sabl,fold_4,2,0,0,0,-2,IMG_4032_JPG.rf.24900b5575b9992102af280f6bba47e6.jpg
1_sabl,fold_4,2,2,1,1,0,0230512_145348_jpg.rf.cdc212bd3fb2bf4f176382d869092c48.jpg
1_sabl,fold_4,3,2,2,0,-1,20230512_151623_jpg.rf.72bb569548154b9cacef8ad44ea34cbb.jpg
1_sabl,fold_4,16,3,1,2,-13,20230512_150033_jpg.rf.187d7f8b3b10fd4c55a59ca829ef7fc8.jpg
1_sabl,fold_4,5,4,4,0,-1,20230512_151847_jpg.rf.bd70f9e3dff9227488b4ca7adbf77b50.jpg
1_sabl,fold_4,17,9,8,1,-8,0230512_145037_jpg.rf.043bbe5a69ebdbfca0307a4e11b0ac63.jpg
1_sabl,fold_4,35,7,6,1,-28,20230512_150150_jpg.rf.7c6e4ba9b7c81892495bdb947e71e7bc.jpg
1_sabl,fold_4,12,12,11,1,0,20230512_151910_jpg.rf.83e74c185917f56390fb7c632f1ddbb8.jpg
1_sabl,fold_4,13,8,6,2,-5,IMG_20230512_153056_jpg.rf.ce869252548200602c656449cd5652e5.jpg
1_sabl,fold_4,6,6,6,0,0,20230512_152218_jpg.rf.93c255ace7ac5cb6c518b519f276c38a.jpg
1_sabl,fold_4,1,1,1,0,0,IMG_20230512_150858_jpg.rf.0c886d7a0228ac541d46c5461d00eaa9.jpg
1_sabl,fold_4,8,3,2,1,-5,IMG_20230512_153026_jpg.rf.8b55b13a2be603023efcf36910819c5c.jpg
1_sabl,fold_4,20,17,16,1,-3,IMG_20230512_162026_jpg.rf.5b2e0930b83dcdad9e4b2c7dc2220ad8.jpg
1_sabl,fold_4,3,0,0,0,-3,20230512_152203_jpg.rf.f37f9576053c5dda9448b82302e0a353.jpg
1_sabl,fold_4,7,5,5,0,-2,20230512_150912_jpg.rf.18152396c31db59c1819409ba319c0aa.jpg
1_sabl,fold_4,1,1,1,0,0,20230512_151104_jpg.rf.68db94fa29d48c9461b06ea1012225cb.jpg
1_sabl,fold_4,9,4,3,1,-5,IMG_4184_JPG.rf.c3ce659fb0267eb11d28871cd003f680.jpg
1_sabl,fold_4,8,7,6,1,-1,IMG_20230512_152244_576_jpg.rf.97d6ebe9005d26f9e1a4c40801745b3f.jpg
1_sabl,fold_4,6,2,1,1,-4,IMG_20230512_144951_654_jpg.rf.73864ab361d6a49bef8ae0582378dcd8.jpg
1_sabl,fold_4,4,3,3,0,-1,20230512_152245_jpg.rf.ad9c9eed13ca805362ff37a6409c22f1.jpg
1_sabl,fold_4,7,7,4,3,0,0230512_145259_jpg.rf.a81f0fe30e13f9985ea29fbb8c3ca4bb.jpg
1_sabl,fold_4,1,0,0,0,-1,20230512_151444_jpg.rf.d7d4a6ea41d6e0b978df16189a7ef0b7.jpg
1_sabl,fold_4,3,3,2,1,0,IMG_20230512_145249_jpg.rf.3fc3e8c98a6aad287c04adaf81f76d80.jpg
1_sabl,fold_4,13,12,10,2,-1,20230512_152301_jpg.rf.13169aad5cc03cf2c0524d6515d1d94b.jpg
1_sabl,fold_4,8,0,0,0,-8,20230512_150133_jpg.rf.959f58c55ea7f14e5d45aefc1a142e65.jpg
1_sabl,fold_4,5,1,1,0,-4,IMG_20230512_145102_470_jpg.rf.a4be99517dd9cf481f2fb0f577967e6e.jpg
1_sabl,fold_4,16,8,8,0,-8,IMG_3905_JPG.rf.442064c53f4baafe2a90c8d4533175cf.jpg
1_sabl,fold_4,3,3,3,0,0,20230512_151752-0-_jpg.rf.adde6111e2c01f49d300871eeeeaf43b.jpg
1_sabl,fold_4,15,11,11,0,-4,IMG_20230512_153244_jpg.rf.fd36ed68885d906d1bfe0772308714e1.jpg
1_sabl,fold_4,45,17,13,4,-28,IMG_20230512_150252_jpg.rf.91876ddbae7daf47c170e3510196d23c.jpg
1_sabl,fold_4,15,14,8,6,-1,0230512_144954_jpg.rf.9e07b2d4ee27051f0fa96e46105520b2.jpg
1_sabl,fold_4,9,3,2,1,-6,20230512_151010_jpg.rf.ff0a6fa0a1930269ecf709bdd00cc6b8.jpg
1_sabl,fold_4,1,0,0,0,-1,20230512_145011_jpg.rf.85e961b884fe88c3056ad6c5a04daafb.jpg
1_sabl,fold_4,1,1,1,0,0,20230512_151659_jpg.rf.d533f433ef4f94da44e6019d93e2f69d.jpg
1_sabl,fold_4,6,1,1,0,-5,20230512_144945_jpg.rf.49417903dca45c5adf0a0717d2a3dda5.jpg
1_sabl,fold_4,6,6,5,1,0,20230512_152305_jpg.rf.b263e7fe5ca0aa0ae073ef44c4d6ad63.jpg
1_sabl,fold_4,2,1,1,0,-1,20230512_152256_jpg.rf.414a0a8bdcc3eb0a766f8a87f6a30f22.jpg
1_sabl,fold_4,5,6,5,1,1,20230512_151844_jpg.rf.b9cd7c0869b5dcad46ed7aa755549a1d.jpg
1_sabl,fold_4,12,3,3,0,-9,20230512_145238-0-_jpg.rf.a0bc376d8aa6c21ae201e90cd541ddca.jpg
1_sabl,fold_4,11,10,10,0,-1,IMG_20230512_152349_jpg.rf.76f8813a71224f65490c6d1d4faea02e.jpg
1_sabl,fold_4,8,4,4,0,-4,20230512_145210_jpg.rf.6800be488a1a4beab14cab796974b7e7.jpg
1_sabl,fold_4,38,17,13,4,-21,IMG_20230512_150114_jpg.rf.d5fd8310f61f94bfde93cace46c477bb.jpg
1_sabl,fold_4,2,0,0,0,-2,IMG_20230512_151102_245_jpg.rf.2d98a1d78cce88aad42bfe628f8ebe8d.jpg
1_sabl,fold_4,13,10,8,2,-3,IMG_20230512_151332_jpg.rf.58fb5690cf39dcfb9f524a2ffc7cd6b2.jpg
1_sabl,fold_4,4,3,3,0,-1,20230512_145359_jpg.rf.538caafcbceeeab2a7c4cb9e58bb1e6a.jpg
1_sabl,fold_4,4,2,2,0,-2,0230512_145436_jpg.rf.68d4283942702699c181b1c4e2b81a95.jpg
1_sabl,fold_4,1,0,0,0,-1,0012_jpg.rf.5fee49c3e98f9b2a75823078d85768de.jpg
1_sabl,fold_4,7,2,2,0,-5,20230512_150040-0-_jpg.rf.c74af3340e71a4f4d5a1fc4d5da8ffe5.jpg
1_sabl,fold_4,8,4,4,0,-4,IMG_20230512_150239_jpg.rf.0eb9dc459dd6d692fc26252cf2107fd0.jpg
1_sabl,fold_4,1,0,0,0,-1,0230512_145052_jpg.rf.f17d7b98aa9a0360c0acc806b326b6a7.jpg
1_sabl,fold_4,13,10,10,0,-3,IMG_20230512_152453_jpg.rf.1723f10503a3e6db7fbceca5913e5ee1.jpg
1_sabl,fold_4,15,12,12,0,-3,0044_jpg.rf.a0660e380e16b315347f5e8999d870df.jpg
1_sabl,fold_4,1,1,1,0,0,20230512_145416_jpg.rf.85e0cfe06b91ae56be79ec72f5f2166f.jpg
1_sabl,fold_4,8,4,3,1,-4,20230512_145343_jpg.rf.e8b4ce21c1272def811c108b7b1604e1.jpg
1_sabl,fold_4,45,14,11,3,-31,0512_150205_jpg.rf.698866d107ebfcc4f94fd99f31b35b02.jpg
1_sabl,fold_4,2,4,2,2,2,IMG_20230512_151308_jpg.rf.9eafa4b376d2b0b24c2d76c7cefacf05.jpg
1_sabl,fold_4,53,12,10,2,-41,0512_150120_jpg.rf.1a423f81d04e2ea199fda4f8950d5ec2.jpg
1_sabl,fold_4,1,1,1,0,0,20230512_145323_jpg.rf.42fec2bfece6489ae531e4112d227ded.jpg
1_sabl,fold_4,2,3,2,1,1,IMG_20230512_151304_jpg.rf.bdf70f382af5e54ed70fa1fa32041649.jpg
1_sabl,fold_4,1,1,0,1,0,20230512_153306_jpg.rf.d458260a195df2ca8597a9690a8bc292.jpg
1_sabl,fold_4,10,8,8,0,-2,20230512_151858_jpg.rf.3e2b4dbf1ece4e9a00109cbeb8dc13dd.jpg
1_sabl,fold_4,6,4,4,0,-2,IMG_20230512_151212_jpg.rf.f922d49a1e43e214462b88c675a0f36c.jpg
1_sabl,fold_4,24,10,9,1,-14,20230512_153019_jpg.rf.6b11b011a1b75c2eb51c302864a6ea12.jpg
1_sabl,fold_4,16,11,10,1,-5,20230512_150111_jpg.rf.3f08c8521cd7c859a80b7ba2d1856e75.jpg
1_sabl,fold_4,1,1,1,0,0,20230512_151650_jpg.rf.18be50d732782b5b8fb5f6c6db59cc14.jpg
1_sabl,fold_4,4,0,0,0,-4,20230512_144940_jpg.rf.47a23c7f63536b38b08e8f2722741d17.jpg
1_sabl,fold_4,11,10,10,0,-1,0054_jpg.rf.5df028d18381f316e9ed0d97adbbfbc0.jpg
1_sabl,fold_4,5,2,1,1,-3,IMG_4217_JPG.rf.b26704f0c46f7b6c0d25d7f2aa4eac49.jpg
1_sabl,fold_4,4,3,3,0,-1,20230512_145352-0-_jpg.rf.bd97ac0cb6ee49b575c0ecff7f91e2a1.jpg
1_sabl,fold_4,1,1,1,0,0,IMG_3856_JPG.rf.4cd3bfac67d223cd7bd1b1efd3b24a09.jpg
1_sabl,fold_4,20,11,11,0,-9,IMG_20230512_152344_jpg.rf.fd23ba06eae998d14ce833db2c7d2195.jpg
1_sabl,fold_4,17,3,3,0,-14,IMG_20230512_150217_jpg.rf.59ee9b06cb5a58b718b0ff7c76a2573f.jpg
1_sabl,fold_4,1,1,1,0,0,20230512_151654-0-_jpg.rf.21ff99bb21484d784b641bc49d9310ea.jpg
1_sabl,fold_4,13,10,10,0,-3,IMG_20230512_151617_084_jpg.rf.864b3ce525fdd2abc7cc1f20bd6005c7.jpg
1_sabl,fold_4,5,5,5,0,0,230512_150030_jpg.rf.35a4005da91e89204ecd28ce53e7d8ee.jpg
1_sabl,fold_4,6,3,3,0,-3,20230512_150037_jpg.rf.a47f7ce797194722a66a03263aee18ea.jpg
1_sabl,fold_4,5,3,2,1,-2,IMG_20230512_150051_jpg.rf.66c8214813ef8f830b3612827d4de766.jpg
1_sabl,fold_4,14,5,5,0,-9,20230512_152949_jpg.rf.67f9765f971d32daf7623088e0781422.jpg
1_sabl,fold_4,2,1,1,0,-1,20230512_150046_jpg.rf.a3f3b22b2918be1f870eb4ccdaab79d1.jpg
1_sabl,fold_4,7,1,1,0,-6,IMG_20230512_150112_1_jpg.rf.bf75baa207583c375190da53145a7679.jpg
1_sabl,fold_4,15,7,6,1,-8,IMG_20230512_153023_jpg.rf.317d3bbb9dbd87e5a653c2851476e12f.jpg
1_sabl,fold_4,5,1,1,0,-4,IMG_3847_JPG.rf.7ed87b14fc0af6892da29e4861a20db2.jpg
1_sabl,fold_4,3,0,0,0,-3,0003_jpg.rf.808f042f9b4d2044e82ecf546085a2b3.jpg
1_sabl,fold_4,16,3,3,0,-13,20230512_151042_jpg.rf.668f39eb72d209648acafdc48e653b94.jpg
1_sabl,fold_4,7,4,4,0,-3,20230512_151549_jpg.rf.f43c366ab902f205b42b2d3ece3e5840.jpg
1_sabl,fold_4,6,6,6,0,0,20230512_145344_jpg.rf.3bb4caede9892124f0b05d554bde4f37.jpg
1_sabl,fold_4,1,0,0,0,-1,20230512_145106_jpg.rf.f8f6fb5e7680b51b521aeb38bd04b4d4.jpg
1_sabl,fold_4,4,1,1,0,-3,IMG_4056_JPG.rf.26cf10e8b88a0d85256d77231719fa6f.jpg
1_sabl,fold_4,25,3,3,0,-22,0512_150105_jpg.rf.bf34c202007f5f0e97f15dd34c8af9ec.jpg
1_sabl,fold_4,1,0,0,0,-1,20230512_145259_jpg.rf.4e068952a2cfa65232622575f2c5e59f.jpg
1_sabl,fold_4,8,2,0,2,-6,IMG_20230512_150233_jpg.rf.fda528f9aab7dbc67a541c09b3ad100a.jpg
1_sabl,fold_4,23,8,3,5,-15,IMG_20230512_150117_559_jpg.rf.acc98bc013000372fc9482efda238776.jpg
1_sabl,fold_4,20,8,5,3,-12,IMG_20230512_150227_jpg.rf.c50986ec06debff70d855a963ab1652a.jpg
1_sabl,fold_4,1,1,1,0,0,20230512_145254_jpg.rf.9747b881733bcadb9a2575a7adfaf75f.jpg
1_sabl,fold_4,7,3,3,0,-4,20230512_151550_jpg.rf.c44e1e4b7281907db5e481f675bb38ec.jpg
1_sabl,fold_4,9,8,7,1,-1,20230512_152300_jpg.rf.ca2bad1620eeb8a9708c24c8c2a6140e.jpg
1_sabl,fold_4,1,0,0,0,-1,20230512_151454_jpg.rf.2edeb7ad32e74ab446183c1ed2a6a8db.jpg
1_sabl,fold_4,2,4,3,1,2,20230512_151458_jpg.rf.e6aebc1a203d13c8d455292cbf8efbd5.jpg
1_sabl,fold_4,2,2,2,0,0,20230512_151804_jpg.rf.85f9cab4d985c7a3ab655e9e58f37592.jpg
1_sabl,fold_4,4,1,1,0,-3,20230512_150056-0-_jpg.rf.726ba341e3872665ea20101a9121709b.jpg
1_sabl,fold_4,1,1,1,0,0,20230512_151710-0-_jpg.rf.d1c6ce2dc1214885b420fa5cf5b548eb.jpg
1_sabl,fold_4,7,4,4,0,-3,0035_jpg.rf.88b59c904d75a54342b73641b3751f03.jpg
1_sabl,fold_4,3,2,2,0,-1,20230512_150207_jpg.rf.2636d37c60105f9dc29244105d586763.jpg
1_sabl,fold_4,11,2,2,0,-9,20230512_153529_jpg.rf.9da097c550c92828a111a560d7417f19.jpg
1_sabl,fold_4,2,0,0,0,-2,20230512_145142_jpg.rf.4c1baf7188f9de7e345b9d556ae04487.jpg
1_sabl,fold_4,1,0,0,0,-1,0021_jpg.rf.f361beb31a38d69ae7d5b1ba99586d9f.jpg
1_sabl,fold_4,1,1,0,1,0,IMG_20230512_145308_jpg.rf.60b7e140102953684517e9840c3f84fd.jpg
1_sabl,fold_4,1,0,0,0,-1,20230512_145115_jpg.rf.559191d80ad4506d081542afe21569dc.jpg
1_sabl,fold_4,8,9,8,1,1,20230512_151848-0-_jpg.rf.4c259cab53877565769f8e42eb6a0530.jpg
1_sabl,fold_4,2,2,2,0,0,IMG_20230512_153102_jpg.rf.358691eda0f0c7c79eb866b582696397.jpg
1_sabl,fold_4,3,1,0,1,-2,IMG_20230512_150935_625_jpg.rf.cff6166bfeadb181c727209a263dcaff.jpg
1_sabl,fold_4,3,3,1,2,0,IMG_3985_JPG.rf.5c7d7114a15a375a31c89b82a6710707.jpg
1_sabl,fold_4,2,1,1,0,-1,20230512_151632_jpg.rf.fb7428039c06580293185bb9fd642dff.jpg
1_sabl,fold_4,2,1,0,1,-1,IMG_20230512_151628_jpg.rf.0963b2196e508f701f2dc60946b1db1f.jpg
1_sabl,fold_4,1,1,1,0,0,0230512_145319_jpg.rf.7d5ab2070daeed5a15f73e243edac4bd.jpg
1_sabl,fold_4,5,2,2,0,-3,IMG_3914_JPG.rf.ca20ceecff09da300344c1920873e12b.jpg
1_sabl,fold_4,3,0,0,0,-3,IMG_4036_JPG.rf.c2b46ca616106cdb334a1b0aac2c914c.jpg
1_sabl,fold_4,2,0,0,0,-2,0230512_145122_jpg.rf.d772ceaa3f11800d1db3d3fc009b64fa.jpg
1_sabl,fold_4,22,13,11,2,-9,20230512_153049_jpg.rf.523c3f6b00af1f2e03d5832e7dd51cae.jpg
1_sabl,fold_4,3,2,1,1,-1,IMG_20230512_151832_jpg.rf.b82753ef867011bf9f3989f4130320b7.jpg
1_sabl,fold_4,1,1,1,0,0,20230512_151710_jpg.rf.e2a5628c7930faedb74febbd18a15ccd.jpg
1_sabl,fold_4,5,1,1,0,-4,IMG_4185_JPG.rf.6ef6b7a942afe064f7a7a9e4939729df.jpg
1_sabl,fold_4,0,9,0,9,9,20230512_151901_jpg.rf.b378a9d5c3045cf87dd1529a7b516a3a.jpg
1_sabl,fold_4,0,12,0,12,12,0512_150124_jpg.rf.7253b200930360a6b66d16035d62353c.jpg
1_sabl,fold_4,3,3,3,0,0,IMG_4195_JPG.rf.0d03c7bef40b40141ba8fa902afc3944.jpg
1_sabl,fold_4,4,0,0,0,-4,20230512_151029_jpg.rf.aa4b3114b5545da90c2fa92150f01f70.jpg
1_sabl,fold_4,20,0,0,0,-20,20230512_153247_jpg.rf.78c6c0964c07caf937b2079e23dcd922.jpg
1_sabl,fold_4,7,6,5,1,-1,IMG_20230512_153040_jpg.rf.3179cdcfc75730df90bea9e4cbaf0f49.jpg
1_sabl,fold_4,10,7,5,2,-3,IMG_20230512_145141_jpg.rf.c065d756b2e91f8933ac0a39ecf7c61c.jpg
1_sabl,fold_4,3,3,2,1,0,IMG_20230512_145333_jpg.rf.4bf3129c20f06bdb19d22b037e743535.jpg
1_sabl,fold_4,3,1,1,0,-2,20230512_151621_jpg.rf.1cbfdf5023fe1c36f7e1875304467d87.jpg
1_sabl,fold_4,4,2,2,0,-2,IMG_20230512_145030_jpg.rf.a2c5e550d29709fcbbe253d3a17faa45.jpg
1_sabl,fold_4,5,4,4,0,-1,20230512_152223_jpg.rf.f6e3e9cd94a0f7908edd48a70c791781.jpg
1_sabl,fold_4,17,8,8,0,-9,IMG_20230512_152350_jpg.rf.4fb06c58b682b06360ed9fa33472ca3f.jpg
1_sabl,fold_4,16,6,6,0,-10,20230512_150149_jpg.rf.5f8b1bb241d961acb2fc7ceb62fbcbe5.jpg
1_sabl,fold_4,7,7,6,1,0,20230512_152306_jpg.rf.20aa1ef8f2026e47d56210676e93fca7.jpg
1_sabl,fold_4,21,8,6,2,-13,20230512_144930_jpg.rf.f3caeeb846d5d4f624e9885bcb85d864.jpg
1_sabl,fold_4,14,7,6,1,-7,IMG_20230512_153017_077_jpg.rf.70df56b8159d336a40a3fab054edb7c4.jpg
1_sabl,fold_4,6,2,1,1,-4,IMG_20230512_144916_143_jpg.rf.00ee144f83892f61d5178b7edacdc535.jpg
1_sabl,fold_4,1,0,0,0,-1,0018_jpg.rf.ca81692f06f9a1e7e06b1042d8cbe236.jpg
1_sabl,fold_4,7,6,6,0,-1,20230512_152242_jpg.rf.4dee3224c614312f3bd59fc772965ff5.jpg
1_sabl,fold_4,9,3,1,2,-6,IMG_20230512_150043_1_jpg.rf.5e7eb6e74c9c826c0209bc26685279a3.jpg
1_sabl,fold_4,1,1,0,1,0,0230512_145013_jpg.rf.14bb403c31ebd5a9f4be760858d91e7c.jpg
1_sabl,fold_4,1,1,1,0,0,IMG_4044_JPG.rf.e22068c91df69c24b01d3bb4f484ccf9.jpg
1_sabl,fold_4,9,0,0,0,-9,IMG_20230512_150125_jpg.rf.bdb9638a94f4957f29777b278afdfb54.jpg
1_sabl,fold_4,17,1,0,1,-16,20230512_152946_jpg.rf.00fa418fbf2242a22bd020d8133a24ee.jpg
1_sabl,fold_4,19,6,4,2,-13,IMG_20230512_150131_jpg.rf.325767bc75099b22d288f353f1a8fbe2.jpg
1_sabl,fold_4,16,3,3,0,-13,20230512_151041_jpg.rf.0b792381ac6bb324435dd5a7b43616cf.jpg
1_sabl,fold_4,2,1,1,0,-1,20230512_151443_jpg.rf.7d2dfd53f11811d0c3a7fe9e184ef15f.jpg
1_sabl,fold_4,13,9,9,0,-4,20230512_153243_jpg.rf.a8672f75e3195db775772b68bce054bf.jpg
1_sabl,fold_4,7,4,2,2,-3,IMG_3912_JPG.rf.6558238f753c37ffb70dd8d3bcee5e9f.jpg
1_sabl,fold_4,13,2,2,0,-11,IMG_20230512_151318_682_jpg.rf.cdeb9703323a496f0e9620a04f4ec09d.jpg
1_sabl,fold_4,1,0,0,0,-1,0038_jpg.rf.d0b487b5b7af9ce9d50c875d519b9707.jpg
1_sabl,fold_4,13,4,4,0,-9,20230512_150015_jpg.rf.5089b7d402f3ce99da9541171299577e.jpg
1_sabl,fold_4,13,4,3,1,-9,20230512_153332_jpg.rf.f6c943fc1dfba3d62a21eb08ecf60b8c.jpg
1_sabl,fold_4,7,5,5,0,-2,20230512_152247_jpg.rf.df7d569b56aaba2e6bf5fc59ec8f414c.jpg
1_sabl,fold_5,23,1,0,1,-22,IMG_20230512_150248_jpg.rf.11fd0431dfaace4800d3f2d4912bd780.jpg
1_sabl,fold_5,9,0,0,0,-9,20230512_150203_jpg.rf.d7cdb618f9cc06830ca3fad4137b7cac.jpg
1_sabl,fold_5,13,0,0,0,-13,IMG_20230512_145048_jpg.rf.2f0c31d1a5ff8b461878196ebf8c11df.jpg
1_sabl,fold_5,3,1,1,0,-2,20230512_145350-0-_jpg.rf.ccf3d3aca429fe2887c17c60d55a358a.jpg
1_sabl,fold_5,14,3,3,0,-11,IMG_20230512_153052_jpg.rf.8577be081284ea5d1672c21d4fd9f288.jpg
1_sabl,fold_5,2,2,2,0,0,20230512_151628_jpg.rf.fdfad9f330381519b41b6c69eeae4609.jpg
1_sabl,fold_5,4,0,0,0,-4,20230512_150906_jpg.rf.b4718b9b84d49303d6b0fb5e035fe49b.jpg
1_sabl,fold_5,2,1,1,0,-1,IMG_20230512_151744_jpg.rf.1d579e4bc8e6391207029a3d59c821a9.jpg
1_sabl,fold_5,2,0,0,0,-2,0013_jpg.rf.55b646371565f20bce0f6ce403646502.jpg
1_sabl,fold_5,16,2,1,1,-14,20230512_145021_jpg.rf.57a18381e0e233f1d4d97199a9263ed4.jpg
1_sabl,fold_5,4,3,3,0,-1,20230512_152325_jpg.rf.b754896fe384db191f35564d52272327.jpg
1_sabl,fold_5,3,0,0,0,-3,IMG_20230512_151247_jpg.rf.33589b240751a2f02c7a7c51bafafe59.jpg
1_sabl,fold_5,3,4,3,1,1,20230512_151624_jpg.rf.339fa34d1377a1b59daa0460f8896c47.jpg
1_sabl,fold_5,7,1,0,1,-6,IMG_20230512_145013_jpg.rf.23ebd19f18a23ba18f9bde6b91f93cbd.jpg
1_sabl,fold_5,5,0,0,0,-5,20230512_153327_jpg.rf.07e6f7dfffed230d78bc971f5cdb9b9f.jpg
1_sabl,fold_5,1,1,1,0,0,20230512_151652_jpg.rf.42dfca221b4b4fbaf828e370670fd031.jpg
1_sabl,fold_5,13,0,0,0,-13,20230512_151021-copia-1-_jpg.rf.abdeaa1b054ea3b58658807cca9089ae.jpg
1_sabl,fold_5,2,2,2,0,0,IMG_20230512_151820_jpg.rf.2fe30b8ed1d8e20bac353cf3379cdcce.jpg
1_sabl,fold_5,9,0,0,0,-9,IMG_20230512_151055_jpg.rf.4509eabdb200535ad64add0b786d59a4.jpg
1_sabl,fold_5,3,0,0,0,-3,20230512_150026_jpg.rf.33fe35571137ce16bd8c3bd383b8db8f.jpg
1_sabl,fold_5,4,0,0,0,-4,0005_jpg.rf.024cc60176c5f8a007eca0cbdacb4691.jpg
1_sabl,fold_5,17,1,0,1,-16,20230512_151040_jpg.rf.87640fb95b74f117e81bcca0c41f76af.jpg
1_sabl,fold_5,11,3,3,0,-8,20230512_152314_jpg.rf.0becd9c30d5157c4b2a582e3fa4b759a.jpg
1_sabl,fold_5,11,7,6,1,-4,20230512_151853_jpg.rf.b5af18c1578fd0fbb73f9427792d45c0.jpg
1_sabl,fold_5,1,0,0,0,-1,20230512_150249_jpg.rf.78e9f249c2e4a31b39a078b7266ac51a.jpg
1_sabl,fold_5,22,0,0,0,-22,20230512_150104_jpg.rf.291e8ff0d311863c8ac10188b0cb1b28.jpg
1_sabl,fold_5,3,1,1,0,-2,20230512_145232_jpg.rf.f26463ccf279cd604dca1dded979fa14.jpg
1_sabl,fold_5,10,0,0,0,-10,20230512_153454_jpg.rf.a2384c87b34aeaa97bbbbd20e8b1d56b.jpg
1_sabl,fold_5,1,0,0,0,-1,20230512_151017_jpg.rf.c588fa9199c6dffdb1179f7f483c865f.jpg
1_sabl,fold_5,17,0,0,0,-17,20230512_150146_jpg.rf.e84fc4cf33f8326d64d02b7ed8cafce4.jpg
1_sabl,fold_5,6,0,0,0,-6,IMG_3850_JPG.rf.7f7105ed07be37f94ee73db7da91b99e.jpg
1_sabl,fold_5,1,0,0,0,-1,20230512_145114_jpg.rf.38c9c923c79af5172bfb7315ee2859bb.jpg
1_sabl,fold_5,1,0,0,0,-1,20230512_152332_jpg.rf.4836b4b24c985755468de47d12fd4fa5.jpg
1_sabl,fold_5,6,0,0,0,-6,20230512_151136_jpg.rf.a8aef98dbb4c86bffec8ae4287c1dc6e.jpg
1_sabl,fold_5,5,4,3,1,-1,IMG_20230512_152359_jpg.rf.a5ab36a1dd0fd3e5088b4ed61c7990eb.jpg
1_sabl,fold_5,17,0,0,0,-17,IMG_4208_JPG.rf.8f59289e526ec56a405f244ebaa1a95a.jpg
1_sabl,fold_5,1,0,0,0,-1,20230512_151208_jpg.rf.0f6b66ca4ada91b2974b5945e2b92069.jpg
1_sabl,fold_5,3,2,2,0,-1,20230512_151839_jpg.rf.7e5100e585fd816285691f17e14cfcdb.jpg
1_sabl,fold_5,4,0,0,0,-4,IMG_3919_JPG.rf.9a5b0afd3da0db473f842046c5113690.jpg
1_sabl,fold_5,8,0,0,0,-8,20230512_145241_jpg.rf.455691f27dd7da4e6c25ba615f3f2620.jpg
1_sabl,fold_5,2,2,2,0,0,0230512_145355_jpg.rf.c17e94a0f80c4c06f2a620a85826ebcc.jpg
1_sabl,fold_5,1,0,0,0,-1,20230512_151504_jpg.rf.c79fb008568aeb31342688eb80ad9a49.jpg
1_sabl,fold_5,2,0,0,0,-2,0029_jpg.rf.e9d3f2a53d6d73564cd418ea60fbbd61.jpg
1_sabl,fold_5,2,0,0,0,-2,20230512_151133_jpg.rf.a96da38b573a4da364c3f36aaf0c460d.jpg
1_sabl,fold_5,2,3,2,1,1,IMG_20230512_151814_jpg.rf.d8d7b03e58abeca643b8f9e71acfd81a.jpg
1_sabl,fold_5,1,0,0,0,-1,20230512_151010_jpg.rf.a46c76d923129f16810ff21ca0937475.jpg
1_sabl,fold_5,2,0,0,0,-2,0032_jpg.rf.ac745db746452e37d39279a2c8ecd454.jpg
1_sabl,fold_5,8,0,0,0,-8,20230512_151510_jpg.rf.b27f217e8ec95c059fa149f7f8f03d2b.jpg
1_sabl,fold_5,3,0,0,0,-3,IMG_20230512_151228_jpg.rf.1e509a8a9a3464432051f5ec53cc611c.jpg
1_sabl,fold_5,15,10,10,0,-5,0045_jpg.rf.b8baabd840c67f80f92a3844015afe9b.jpg
1_sabl,fold_5,13,0,0,0,-13,20230512_151047_jpg.rf.3fb94f0bd6175b2f1306a1aac0027216.jpg
1_sabl,fold_5,12,0,0,0,-12,IMG_20230512_150922_jpg.rf.e1a7736e96dfcd7e2b06e2f5c94a3cc1.jpg
1_sabl,fold_5,1,0,0,0,-1,0010_jpg.rf.d1d93d099773f36e90b527f8611d128c.jpg
1_sabl,fold_5,68,7,2,5,-61,IMG_20230512_153133_jpg.rf.b54f10d107857a0eb7fbb7943b030152.jpg
1_sabl,fold_5,1,0,0,0,-1,IMG_20230512_151445_jpg.rf.853f3efcb5076d2d7bac2e663f2804bd.jpg
1_sabl,fold_5,1,0,0,0,-1,IMG_20230512_151214_161_jpg.rf.057ee941cfb105e5fd41f7e4342f657a.jpg
1_sabl,fold_5,1,0,0,0,-1,230512_150310_jpg.rf.25af60211cc7ea70d0a37dae89d778ae.jpg
1_sabl,fold_5,11,9,7,2,-2,IMG_20230512_151958_jpg.rf.c0c5a182cd6f5f4319120803cadd4e15.jpg
1_sabl,fold_5,7,1,0,1,-6,230512_150020_jpg.rf.3321ea3a69f605601bbe1180e33c4372.jpg
1_sabl,fold_5,2,3,2,1,1,20230512_151705_jpg.rf.5d4aace27e10d6b9f9dcd14c2eb80876.jpg
1_sabl,fold_5,10,0,0,0,-10,IMG_20230512_151057_jpg.rf.34b51a9edb1d08b21feec0712493ad44.jpg
1_sabl,fold_5,4,0,0,0,-4,20230512_151746_jpg.rf.28bbdba7c34f11ae2fa3b6c62e25edcc.jpg
1_sabl,fold_5,12,0,0,0,-12,20230512_145147_jpg.rf.8cbc9f87bfc771396f02c8e27231d7ee.jpg
1_sabl,fold_5,5,3,3,0,-2,IMG_20230512_152233_631_jpg.rf.5a6ed894f5cd8513bac1f0dfbdeb7bf3.jpg
1_sabl,fold_5,1,1,1,0,0,20230512_145424_jpg.rf.fdacfd117c87835a809a784e9019c683.jpg
1_sabl,fold_5,1,0,0,0,-1,20230512_145347_jpg.rf.d1edf1d3992c10216d75faac6523aed9.jpg
1_sabl,fold_5,7,0,0,0,-7,IMG_20230512_145116_jpg.rf.89714791069678114dd234188f4e153e.jpg
1_sabl,fold_5,5,4,3,1,-1,20230512_152308_jpg.rf.f4e8f4ca110dded8e5b00937a84760be.jpg
1_sabl,fold_5,11,0,0,0,-11,IMG_4212_JPG.rf.93840a5a997c2230b8ec5404df51506e.jpg
1_sabl,fold_5,22,1,0,1,-21,20230512_150120_jpg.rf.e2c884c6c431ae355dbe5eae448fe9fe.jpg
1_sabl,fold_5,1,0,0,0,-1,0035_jpg.rf.8f80b9113851faa3ce22f7a4237e063b.jpg
1_sabl,fold_5,1,0,0,0,-1,IMG_4020_JPG.rf.bc2697c76c5828734e1ac848245c5a5b.jpg
1_sabl,fold_5,6,1,1,0,-5,IMG_20230512_151224_jpg.rf.f07ca2ca5270e16cfa2d0b808d60cc7f.jpg
1_sabl,fold_5,14,1,1,0,-13,20230512_152357_jpg.rf.6852fe96763037ed9985128c109b3ce2.jpg
1_sabl,fold_5,21,0,0,0,-21,IMG_20230512_150344_jpg.rf.21eb7b1441ddc9b2740cc4367709590f.jpg
1_sabl,fold_5,2,1,1,0,-1,20230512_145054_jpg.rf.3d4529e01dd37f4f80ba26154a898555.jpg
1_sabl,fold_5,7,5,4,1,-2,20230512_152258_jpg.rf.7636714c888f4e6cbf70120b64064d40.jpg
1_sabl,fold_5,2,2,2,0,0,20230512_151841_jpg.rf.9dd3a6bca715d1085cb1da5cae6efd0f.jpg
1_sabl,fold_5,19,0,0,0,-19,20230512_150051_jpg.rf.c03c04498642818f22eb4115246bdb27.jpg
1_sabl,fold_5,2,2,2,0,0,20230512_151635_jpg.rf.ee2ff8efc5aaa53fea09028b60c05e75.jpg
1_sabl,fold_5,24,1,0,1,-23,IMG_20230512_150107_368_jpg.rf.841def69669689958248c77fd74c6ef5.jpg
1_sabl,fold_5,1,1,1,0,0,20230512_151647_jpg.rf.367411ded71931545e2f1f2799cebf0b.jpg
1_sabl,fold_5,2,0,0,0,-2,20230512_151223_jpg.rf.6a7ba0efceb9c41d056eee7ad9219353.jpg
1_sabl,fold_5,4,1,1,0,-3,20230512_145213_jpg.rf.166b2f375e79324c95dc48c23bef06fa.jpg
1_sabl,fold_5,2,1,0,1,-1,IMG_3844_JPG.rf.8a9213642776490b8b621595f6183af2.jpg
1_sabl,fold_5,14,0,0,0,-14,20230512_145202_jpg.rf.fc0b0601e248df8d80e9bb9ba998d0e7.jpg
1_sabl,fold_5,26,0,0,0,-26,0512_150040_jpg.rf.f8c148cb1d657923d62ef9d7c2a4e8c4.jpg
1_sabl,fold_5,9,2,0,2,-7,20230512_153259_jpg.rf.893deba08433f5f85baa0becc85071b1.jpg
1_sabl,fold_5,1,1,1,0,0,IMG_20230512_150840_jpg.rf.3e9980cbe445c9f1025d481e7a7a5710.jpg
1_sabl,fold_5,17,0,0,0,-17,20230512_151049_jpg.rf.7faee580bbaad04f4aee5a6edf72e5b5.jpg
1_sabl,fold_5,43,1,1,0,-42,0512_150100_jpg.rf.9eaed3be83ecba8e3e4efbdc882c1fa5.jpg
1_sabl,fold_5,2,0,0,0,-2,230512_150026_jpg.rf.633ed1e3a24d8c7ecacc82788de5c3b8.jpg
1_sabl,fold_5,3,0,0,0,-3,IMG_20230512_153013_jpg.rf.93712b9e1c24432fd87372997521847c.jpg
1_sabl,fold_5,2,0,0,0,-2,0017_jpg.rf.c3653cc70e103964ca9e6a3e85f3f694.jpg
1_sabl,fold_5,5,0,0,0,-5,20230512_151508_jpg.rf.00e90b7105d608decd85f3e850e1f875.jpg
1_sabl,fold_5,8,0,0,0,-8,IMG_20230512_150939_jpg.rf.d5260c01e2cabb005d119333eda4e87d.jpg
1_sabl,fold_5,2,0,0,0,-2,IMG_4021_JPG.rf.7556e49a1eda27532dfb6cc32c974482.jpg
1_sabl,fold_5,5,3,3,0,-2,20230512_152302_jpg.rf.016780b8da4c66843b955300975f2747.jpg
1_sabl,fold_5,34,0,0,0,-34,IMG_20230512_150128_453_jpg.rf.081da15c5e562b5ce7f42ab95339a34a.jpg
1_sabl,fold_5,1,0,0,0,-1,0027_jpg.rf.041bc0af55a373703357342785fa3667.jpg
1_sabl,fold_5,1,0,0,0,-1,20230512_150050_jpg.rf.c95631863834d93e37ddc2fda8829ab4.jpg
1_sabl,fold_5,10,0,0,0,-10,IMG_20230512_153016_jpg.rf.c257848a0cea9445774e7172a68a0d16.jpg
1_sabl,fold_5,21,2,2,0,-19,20230512_152409_jpg.rf.5d8e7c06336544573f46c12fe04ef26b.jpg
1_sabl,fold_5,4,0,0,0,-4,IMG_20230512_151230_jpg.rf.77eaf1e461982f94562c61c5de9e3444.jpg
1_sabl,fold_5,3,0,0,0,-3,IMG_4192_JPG.rf.915fc04cdd59b40454fa22fea6dcf2f7.jpg
1_sabl,fold_5,1,0,0,0,-1,20230512_145226_jpg.rf.d01dc6c5e4859db13d337281014a74b1.jpg
1_sabl,fold_5,1,0,0,0,-1,20230512_151100_jpg.rf.8c5db2f9786fe5fedf170c30766e11a8.jpg
1_sabl,fold_5,11,6,6,0,-5,20230512_151912_jpg.rf.2dfbdab89b348f4eda01f5edbb8bf596.jpg
1_sabl,fold_5,8,3,3,0,-5,20230512_145439_jpg.rf.21c5c0c901e6a327a75c7f0dc4eafc1c.jpg
1_sabl,fold_5,1,0,0,0,-1,IMG_20230512_151206_373_jpg.rf.25070077bf672ae36c15ea6e22fdc049.jpg
1_sabl,fold_5,1,0,0,0,-1,20230512_145257_jpg.rf.f1c0c8bd862cb12f380ae5d7949e68a2.jpg
1_sabl,fold_5,5,0,0,0,-5,IMG_20230512_153021_jpg.rf.c74db55af384c855422ee71d8c0c24a2.jpg
1_sabl,fold_5,20,8,8,0,-12,IMG_20230512_152355_jpg.rf.1ee2ad035e7125aadb708f8b70abd231.jpg
1_sabl,fold_5,3,6,1,5,3,20230512_152249_jpg.rf.9209f7c7b47e7778a14dc41949d8882b.jpg
1_sabl,fold_5,1,1,0,1,0,20230512_151230_jpg.rf.ab81eae29bf9052e3dd989b36b3a00cd.jpg
1_sabl,fold_5,3,0,0,0,-3,IMG_3915_JPG.rf.83d4afabcacf1fe7976e4f01a8b55687.jpg
1_sabl,fold_5,2,0,0,0,-2,IMG_3913_JPG.rf.23307ea91d746d228b58a6db32ff0bca.jpg
1_sabl,fold_5,10,2,1,1,-8,IMG_20230512_145140_jpg.rf.a089bf5c311c725d73e925fe2d7d4c66.jpg
1_sabl,fold_5,10,8,8,0,-2,20230512_151859_jpg.rf.820ed98fb886601f4f15717490003a3e.jpg
1_sabl,fold_5,3,3,3,0,0,20230512_152225_jpg.rf.889528313caa94497bf581fc9b6ec204.jpg
1_sabl,fold_5,7,5,5,0,-2,20230512_145340_jpg.rf.962ef85b90f87307d46df866e8b6be07.jpg
1_sabl,fold_5,1,0,0,0,-1,IMG_4397_JPG.rf.ff87fb693a34984f9e818a3a3a1a79b3.jpg
1_sabl,fold_5,11,8,8,0,-3,20230512_151903_jpg.rf.e84304253d71e06ad8473e1be6aa7582.jpg
1_sabl,fold_5,16,0,0,0,-16,IMG_20230512_150056_jpg.rf.65358cd23942ee92bc5024b41d26500a.jpg
1_sabl,fold_5,29,1,0,1,-28,0512_150057_jpg.rf.c228357b2bf9bb499210e8c8c7afa45b.jpg
1_sabl,fold_5,2,0,0,0,-2,20230512_153435_jpg.rf.52f71510b3fa5d1e5d0f6e2468cab216.jpg
1_sabl,fold_5,16,0,0,0,-16,IMG_20230512_145123_jpg.rf.1bbba4202dcb5637d1840db017c11671.jpg
1_sabl,fold_5,1,0,0,0,-1,20230512_153421_jpg.rf.4cb37bb0380a93d519214becab03862c.jpg
1_sabl,fold_5,16,0,0,0,-16,20230512_144939_jpg.rf.32f704ff01b8b91ab11ac16462053c96.jpg
1_sabl,fold_5,1,0,0,0,-1,20230512_151453_jpg.rf.fc89aea08c4953e972d355bc593bd6ae.jpg
1_sabl,fold_5,1,0,0,0,-1,IMG_4019_JPG.rf.13ea285b754475b580f840ba9fc99608.jpg
1_sabl,fold_5,5,4,4,0,-1,20230512_152320_jpg.rf.373cf359be94c413709d04995faada1e.jpg
1_sabl,fold_5,1,0,0,0,-1,IMG_20230512_145029_jpg.rf.7bf65ac7d5d4f934ebfd179e7ad97968.jpg
1_sabl,fold_5,2,2,2,0,0,0049_jpg.rf.d9e63c2316d02b96968a7dd44061b337.jpg
1_sabl,fold_5,1,0,0,0,-1,230512_150124_jpg.rf.a1dce64e321706af2f260a6b933ae5d1.jpg
1_sabl,fold_5,1,0,0,0,-1,20230512_145108_jpg.rf.cfa16a281bcee146efbf5aac473021a3.jpg
1_sabl,fold_5,3,0,0,0,-3,20230512_145127_jpg.rf.2e6c583887c26feb5d54542c0b963ea1.jpg
1_sabl,fold_5,7,0,0,0,-7,IMG_20230512_151451_jpg.rf.2218d423d5bccf8392a803b3052b5d3b.jpg
1_sabl,fold_5,5,4,4,0,-1,0230512_145345_jpg.rf.349c9a4b5a46e8d3477462f4e4215cba.jpg
1_sabl,fold_5,11,8,8,0,-3,20230512_151908_jpg.rf.b315ad5e28b7bf0551708d4ea9d3dd39.jpg
1_sabl,fold_5,12,3,3,0,-9,20230512_152237_jpg.rf.808fe6741a783c4fa83bfabf79676eac.jpg
1_sabl,fold_5,1,0,0,0,-1,20230512_151806-0-_jpg.rf.ee8c0cb2ceb0752fb58a7e8380a489b8.jpg
1_sabl,fold_5,5,3,3,0,-2,20230512_152311_jpg.rf.5e824954dc303eba4a13e80481374d92.jpg
1_sabl,fold_5,5,0,0,0,-5,IMG_20230512_151619_jpg.rf.602d997ec01411a318e031faecec475a.jpg
1_sabl,fold_5,8,0,0,0,-8,20230512_150205_jpg.rf.af4ff5234c4e2039ba4aa43dfef61137.jpg
1_sabl,fold_5,1,1,1,0,0,20230512_151641_jpg.rf.9d3677c71aedef7846514f40d39cc285.jpg
1_sabl,fold_5,1,0,0,0,-1,IMG_4396_JPG.rf.a6ca21b5c9e64200051d628058fac8d3.jpg
1_sabl,fold_5,4,0,0,0,-4,IMG_20230512_151255_jpg.rf.7a344a314dbceac482eaa7344270d575.jpg
1_sabl,fold_5,3,0,0,0,-3,20230512_145413_jpg.rf.d92c86a64c63fad8780cddf8f9af65d7.jpg
1_sabl,fold_5,15,0,0,0,-15,IMG_20230512_153000_904_jpg.rf.0910e6a7b929687a7f2cb7d8110febe6.jpg
1_sabl,fold_5,3,2,2,0,-1,IMG_3864_JPG.rf.0b9655ea20ce691d9f9006c6ab150d3c.jpg
1_sabl,fold_5,10,1,0,1,-9,230512_145026_jpg.rf.f23932c58f897cb3d0594cc7af5c44f4.jpg
1_sabl,fold_5,6,1,0,1,-5,230512_150021_jpg.rf.9f8dde8cf7d3e52b983f2e1dee1f56d6.jpg
1_sabl,fold_5,21,5,5,0,-16,20230512_152319_jpg.rf.3d825a3794a8b316d78f9af2806a7c6c.jpg
1_sabl,fold_5,1,1,1,0,0,20230512_152353_jpg.rf.ed8431bc0af772a21f7e6f7b52b33d4e.jpg
1_sabl,fold_5,10,1,1,0,-9,20230512_151345_jpg.rf.4dd52a96ef715b94641151e55cadac59.jpg
1_sabl,fold_5,6,4,4,0,-2,20230512_145401_jpg.rf.44167fa74f8667ec2ab9d47632567ba8.jpg
1_sabl,fold_6,1,0,0,0,-1,IMG_3918_JPG.rf.73a732415980a079e2ee9f088f0b902b.jpg
1_sabl,fold_6,3,0,0,0,-3,20230512_150304_jpg.rf.42997b281c38f2d2e1caa252c8202466.jpg
1_sabl,fold_6,1,0,0,0,-1,20230512_145018_jpg.rf.6120633e9f3b01a0322386f7107b3216.jpg
1_sabl,fold_6,2,3,2,1,1,IMG_20230512_151746_jpg.rf.e11cc2bdd754b8c380d4b2f51b494333.jpg
1_sabl,fold_6,1,1,1,0,0,IMG_3859_JPG.rf.217ab58b1022e7dbdcc07a4a48bdf055.jpg
1_sabl,fold_6,3,2,2,0,-1,20230512_151142_jpg.rf.959c44ca45dfd6e8f7458240928724a4.jpg
1_sabl,fold_6,7,7,6,1,0,IMG_20230512_153034_jpg.rf.d2546314233e70df166dd444373fe566.jpg
1_sabl,fold_6,39,2,2,0,-37,20230512_150259_jpg.rf.640d17e1a5cec14371d2ef32c74c215b.jpg
1_sabl,fold_6,1,1,1,0,0,20230512_151613-0-_jpg.rf.d6f5456bcfe941a2766b34ca25d6e64c.jpg
1_sabl,fold_6,1,0,0,0,-1,20230512_151247_jpg.rf.559bbd96f04ed0b61011356b33038efb.jpg
1_sabl,fold_6,12,11,11,0,-1,20230512_151901-0-_jpg.rf.23717847adee37125505701d84f8b2c4.jpg
1_sabl,fold_6,2,1,1,0,-1,0230512_145403_jpg.rf.86e849309856a70f7343d14e0be80d1f.jpg
1_sabl,fold_6,18,8,7,1,-10,20230512_150212-0-_jpg.rf.42aaa169dabc6e224af1ad2603fa77d9.jpg
1_sabl,fold_6,1,1,1,0,0,IMG_20230512_150958_jpg.rf.806f513ed04cbf893c8a805d028e17a5.jpg
1_sabl,fold_6,6,2,1,1,-4,IMG_20230512_150849_517_jpg.rf.8292597aeb2edd9ad9a8634d1e6ce325.jpg
1_sabl,fold_6,5,6,5,1,1,20230512_153406_jpg.rf.5fd9ed7f498c063bbe363af58bf64afe.jpg
1_sabl,fold_6,1,1,1,0,0,20230512_145139_jpg.rf.1ccaa55656a3b72abb079fcaca9ebd91.jpg
1_sabl,fold_6,9,1,1,0,-8,20230512_145207_jpg.rf.d6520c0b52ca9d11cbdb08e7fcad7279.jpg
1_sabl,fold_6,1,1,1,0,0,20230512_151709_jpg.rf.67e1deefca206f50f10d35552ae2213f.jpg
1_sabl,fold_6,9,6,6,0,-3,20230512_152229_jpg.rf.f718118201e6c3b0a3b3d89958725c05.jpg
1_sabl,fold_6,18,5,5,0,-13,20230512_151030_jpg.rf.99cd8001fdf2562bbd43c3e28ec3bc18.jpg
1_sabl,fold_6,1,1,1,0,0,0016_jpg.rf.2a262f7303067736073549486906cc43.jpg
1_sabl,fold_6,1,1,1,0,0,20230512_151651_jpg.rf.d9eebb8d47a3a2ecc2b5ab5fce867c62.jpg
1_sabl,fold_6,3,3,3,0,0,IMG_20230512_151216_jpg.rf.212dba7457c89d85163142d3417d011a.jpg
1_sabl,fold_6,2,1,1,0,-1,20230512_151754_jpg.rf.54ba86e6a384ea604ca2e9b48b6baaf5.jpg
1_sabl,fold_6,7,5,3,2,-2,MG_20230512_145052_jpg.rf.e48facc3a59ffc87c5c20e1e858d782f.jpg
1_sabl,fold_6,1,0,0,0,-1,20230512_145105_jpg.rf.773b834198bf17c51531470842565757.jpg
1_sabl,fold_6,2,0,0,0,-2,20230512_150310_jpg.rf.1c8474c411cc1309fdcb6f4f05ad76e7.jpg
1_sabl,fold_6,11,5,4,1,-6,IMG_20230512_151242_jpg.rf.46afd180ee87359123f370468c16ecd9.jpg
1_sabl,fold_6,7,5,3,2,-2,IMG_20230512_150822_610_jpg.rf.202648ab81c8a246ef6e9d92f76fc793.jpg
1_sabl,fold_6,13,7,7,0,-6,0230512_150158_jpg.rf.87404c9e49a82e56c7dade7c3898effc.jpg
1_sabl,fold_6,3,2,1,1,-1,20230512_145214_jpg.rf.7dff106d138e1a8492bda9d8a939f1df.jpg
1_sabl,fold_6,12,4,4,0,-8,20230512_150028_jpg.rf.af876dc827626d5f87a6fe1e271ef879.jpg
1_sabl,fold_6,10,5,3,2,-5,20230512_150924_jpg.rf.e5426caf129241e7f71edfd6460ffb7b.jpg
1_sabl,fold_6,36,16,14,2,-20,IMG_20230512_150302_jpg.rf.9b111acf170d8c1671212ec46ca5f96b.jpg
1_sabl,fold_6,2,1,0,1,-1,IMG_3855_JPG.rf.3c07d7a3a717987d18e4881f741f0109.jpg
1_sabl,fold_6,42,15,8,7,-27,0002_jpg.rf.e28c19f2eeb804b4f3db5cb8a9b96722.jpg
1_sabl,fold_6,2,2,2,0,0,20230512_151519_jpg.rf.a798ec75f634d9c0b2099d74e6391b2f.jpg
1_sabl,fold_6,1,1,1,0,0,20230512_145231_jpg.rf.5067ec9a11eb10e94f1992fa7b9fdca9.jpg
1_sabl,fold_6,6,5,4,1,-1,20230512_151813_jpg.rf.8e04e5f09260558a80ad8ed222a6842d.jpg
1_sabl,fold_6,17,15,14,1,-2,0039_jpg.rf.24da2dcb61a34ae88e4e3ae85334ec49.jpg
1_sabl,fold_6,2,1,1,0,-1,IMG_4016_JPG.rf.57796edbcc20ef6bb7930ae2c9b790e7.jpg
1_sabl,fold_6,9,5,3,2,-4,0230512_150107_jpg.rf.255ebb7bf873cd1fb62870dd946c636b.jpg
1_sabl,fold_6,1,1,1,0,0,IMG_4045_JPG.rf.5fd568888c253fc15e61ef0e6a600736.jpg
1_sabl,fold_6,2,3,2,1,1,20230512_151706_jpg.rf.a1ec45640c8ceaf421bdd396abbff09a.jpg
1_sabl,fold_6,5,3,2,1,-2,IMG_20230512_150931_075_jpg.rf.e33516383d2c37617b8a3623da6f46df.jpg
1_sabl,fold_6,2,2,1,1,0,20230512_150045-0-_jpg.rf.e0a79a709ca27bbd1ddee5f8a4336ea8.jpg
1_sabl,fold_6,5,5,4,1,0,20230512_152227_jpg.rf.0537631b05bb432698dc401e82e41cdd.jpg
1_sabl,fold_6,6,3,3,0,-3,20230512_151547_jpg.rf.11083d91d633eac77747e3332d593385.jpg
1_sabl,fold_6,12,3,3,0,-9,20230512_151043_jpg.rf.3411f895e2985588186e8495e99b2a5d.jpg
1_sabl,fold_6,2,2,1,1,0,20230512_150754_jpg.rf.25cdffe09e3da5825e5287e9707d28b7.jpg
1_sabl,fold_6,2,1,1,0,-1,20230512_150054_jpg.rf.d397e2f4f89585ae423d36316b68e0d3.jpg
1_sabl,fold_6,1,1,1,0,0,20230512_151658_jpg.rf.64accf87df1b759e733862bd5826d73c.jpg
1_sabl,fold_6,9,4,4,0,-5,20230512_150251_jpg.rf.5e1c1bb0e6397c87b2959920705bf3e4.jpg
1_sabl,fold_6,1,1,0,1,0,20230512_145027_jpg.rf.ec568ee157ffdc70fa125022bd4e2226.jpg
1_sabl,fold_6,24,20,15,5,-4,IMG_3929_JPG.rf.a2180d03c20d1cfeece3cc8d116bef58.jpg
1_sabl,fold_6,6,4,4,0,-2,IMG_20230512_145356_jpg.rf.aade91e03425891ebb1e7913c596a6bb.jpg
1_sabl,fold_6,4,3,2,1,-1,20230512_151320_jpg.rf.000a402e9a61ca254ddb3eb836b8d52e.jpg
1_sabl,fold_6,1,2,0,2,1,20230512_150053_jpg.rf.088308ae98c13a53c0cd09a0c5d7873d.jpg
1_sabl,fold_6,2,2,2,0,0,IMG_4030_JPG.rf.d581bcd4c0908b4512a05d8d538db640.jpg
1_sabl,fold_6,2,0,0,0,-2,20230512_145101_jpg.rf.2e2ab39bfad17ac6cf7a40fbca0233b7.jpg
1_sabl,fold_6,11,3,3,0,-8,20230512_151319_jpg.rf.95cf4d71c19232b1c36b69b6329abdb6.jpg
1_sabl,fold_6,1,1,1,0,0,20230512_145222_jpg.rf.dc5b10230a198c45f4f849d8bea6cf45.jpg
1_sabl,fold_6,13,12,12,0,-1,0003_jpg.rf.a4014333632a8045d62b2480bccb288b.jpg
1_sabl,fold_6,21,13,7,6,-8,IMG_20230512_150346_jpg.rf.5eb42adbd89cd335587264e87d4a07ea.jpg
1_sabl,fold_6,2,2,1,1,0,20230512_151742_jpg.rf.734b217dddc054e2dbb00d9964713986.jpg
1_sabl,fold_6,1,1,0,1,0,20230512_145328_jpg.rf.dcfa7faebf8b77528401b336abf6eaad.jpg
1_sabl,fold_6,5,4,4,0,-1,20230512_145335_jpg.rf.896d2a48efad0e17923f2fec260761b0.jpg
1_sabl,fold_6,4,2,1,1,-2,IMG_4386_JPG.rf.642872f82064187dff74f15b1ff0a923.jpg
1_sabl,fold_6,2,0,0,0,-2,20230512_150049_jpg.rf.e1512981920c32d09de9c291359753fd.jpg
1_sabl,fold_6,2,1,0,1,-1,IMG_3848_JPG.rf.6bccac66dae879c76b4ff16dd5be0243.jpg
1_sabl,fold_6,4,1,1,0,-3,0230512_145343_jpg.rf.fcd20fb05b55e0279971dbad416be7a2.jpg
1_sabl,fold_6,5,2,2,0,-3,IMG_4092_JPG.rf.3e9ac49e2c6b51adac2c75ecdf6ebc5b.jpg
1_sabl,fold_6,5,4,1,3,-1,20230512_150110_jpg.rf.36e77e8ab39d8ce0cccdd59c9e84ceca.jpg
1_sabl,fold_6,2,2,2,0,0,IMG_20230512_150928_jpg.rf.713e71e29e1ae02d5cdba88b3134bae9.jpg
1_sabl,fold_6,3,0,0,0,-3,230512_150127_jpg.rf.85daac8693c9a5866ff2f7839d81d2e8.jpg
1_sabl,fold_6,2,2,2,0,0,20230512_145048_jpg.rf.6202c446935381c48cf520aa5c6640f6.jpg
1_sabl,fold_6,16,0,0,0,-16,IMG_3930_JPG.rf.7a6e996e69e203ed4aa5de3126a2d2ee.jpg
1_sabl,fold_6,10,10,9,1,0,20230512_152223_jpg.rf.9ee2de301ef5a2a10d57b30f309a7d84.jpg
1_sabl,fold_6,7,4,4,0,-3,IMG_4057_JPG.rf.62dc219aee41c1e1eeb47a2bd511e5f0.jpg
1_sabl,fold_6,29,5,5,0,-24,0512_150154_jpg.rf.6ab493c468717275a5b2b74420a88180.jpg
1_sabl,fold_6,13,7,7,0,-6,IMG_20230512_153036_jpg.rf.92b3c0599c74bfff25f17f2e97011b27.jpg
1_sabl,fold_6,4,1,0,1,-3,0230512_145357_jpg.rf.bb3b0c47d3344c5f0714c51d50f9eab8.jpg
1_sabl,fold_6,6,5,5,0,-1,20230512_145337_jpg.rf.eb0881ecd757c868e839b7663c8ec930.jpg
1_sabl,fold_6,1,0,0,0,-1,230512_150306_jpg.rf.57428899933c6b401506a61768585669.jpg
1_sabl,fold_6,3,2,2,0,-1,20230512_151543_jpg.rf.10d24602404882d9cc93169ca45912de.jpg
1_sabl,fold_6,101,10,9,1,-91,0108_jpg.rf.e585b32f135131ce6476b6962a9dbad4.jpg
1_sabl,fold_6,18,12,12,0,-6,20230512_152242_jpg.rf.db9cf140b85724a386050e2debe57fa2.jpg
1_sabl,fold_6,8,6,5,1,-2,20230512_145153_jpg.rf.31de3120042ffe1cc96af5b129c48c8d.jpg
1_sabl,fold_6,2,1,1,0,-1,20230512_151240_jpg.rf.d86e0b8b1457d5a8b4c4c2db8c1e9b84.jpg
1_sabl,fold_6,2,2,2,0,0,20230512_145338_jpg.rf.210a3a3cfad0b0ee89036fcc677c1076.jpg
1_sabl,fold_6,4,4,4,0,0,IMG_4094_JPG.rf.fc1f6e86b3b032266a05b3508e461113.jpg
1_sabl,fold_6,2,2,2,0,0,IMG_20230512_151944_jpg.rf.d5aeefc60fa0f36a43c0496ef0aef803.jpg
1_sabl,fold_6,3,3,3,0,0,20230512_145339_jpg.rf.bf7369afe55b64f770770e2bc84385eb.jpg
1_sabl,fold_6,18,13,11,2,-5,IMG_20230512_152305_jpg.rf.12f543505870e65321b9087ee0584124.jpg
1_sabl,fold_6,2,3,1,2,1,IMG_4025_JPG.rf.8d3de7ea571de848fc149e176c6897c3.jpg
1_sabl,fold_6,1,1,0,1,0,20230512_151505-0-_jpg.rf.55f9872a1224dfaeaf8fca6da2616e98.jpg
1_sabl,fold_6,20,2,2,0,-18,IMG_20230512_150212_422_jpg.rf.e76cd69c3a527a0ab898b69fef489876.jpg
1_sabl,fold_6,6,3,3,0,-3,20230512_150139_jpg.rf.84eb5a1f5ed3efe7d09bc7dd51a476e8.jpg
1_sabl,fold_6,2,0,0,0,-2,20230512_145013_jpg.rf.5b923d696845fee91efca209fb16b8b7.jpg
1_sabl,fold_6,2,0,0,0,-2,20230512_153004_jpg.rf.362642eaeb26a8549f4da1202eebd478.jpg
1_sabl,fold_6,15,1,0,1,-14,20230512_153313_jpg.rf.77943aee7a7bf04a3db49e3f4dc00814.jpg
1_sabl,fold_6,1,1,1,0,0,20230512_153355_jpg.rf.8223bc454d4e607609c33d5982f02df2.jpg
1_sabl,fold_6,11,4,4,0,-7,20230512_151544_jpg.rf.3baf349b8c061da5ae2bbe4333bd3506.jpg
1_sabl,fold_6,4,3,2,1,-1,IMG_20230512_151443_jpg.rf.72eb3bb7a6af81a16f5db60357cc4e37.jpg
1_sabl,fold_6,18,15,15,0,-3,IMG_20230512_152317_jpg.rf.7f9c7624fac8ec2441ebdd0d2ba16ec5.jpg
1_sabl,fold_6,3,2,2,0,-1,IMG_20230512_145132_jpg.rf.d215e294ca9ff5ec89558b9b78083b48.jpg
1_sabl,fold_6,2,2,2,0,0,0230512_145400_jpg.rf.2839dc03d44af92c89a92bc7b644ab85.jpg
1_sabl,fold_6,1,0,0,0,-1,20230512_150224_jpg.rf.f64a4cfe331fa0a225b85de2782b4b40.jpg
1_sabl,fold_6,1,1,1,0,0,IMG_20230512_151810_jpg.rf.82616c1ceb56e348dbbddc1a08161690.jpg
1_sabl,fold_6,1,1,1,0,0,20230512_145333_jpg.rf.afbd586b0c1d9f54c3d3ea178568eb9d.jpg
1_sabl,fold_6,5,3,2,1,-2,230512_150144_jpg.rf.17c847f6562b5ceb1d19a0239be452dc.jpg
1_sabl,fold_6,5,3,1,2,-2,20230512_153523_jpg.rf.94e20d7417dcd4856650e05b3a708e35.jpg
1_sabl,fold_6,17,11,11,0,-6,IMG_20230512_152414_jpg.rf.2a84950ae556ac2909c0e739dbdb963e.jpg
1_sabl,fold_6,7,6,6,0,-1,IMG_4101_JPG.rf.8c4f8e4e10187eb9df93264151a1ed8d.jpg
1_sabl,fold_6,4,1,0,1,-3,230512_145050_jpg.rf.c9c628742a57d86b1f31849454a8559b.jpg
1_sabl,fold_6,2,2,2,0,0,20230512_151702_jpg.rf.0456f0fe756386f89c4b23d655ea901b.jpg
1_sabl,fold_6,13,5,2,3,-8,20230512_150113_jpg.rf.3a5a13ac96bac5c0e6e2c49bc83c904b.jpg
1_sabl,fold_6,11,5,3,2,-6,20230512_151044_jpg.rf.bd2efab172db3bb0ca6ce2ff37f6a8ca.jpg
1_sabl,fold_6,3,2,2,0,-1,20230512_145339-0-_jpg.rf.fea54fcbceb00e71f078268b9b40d178.jpg
1_sabl,fold_6,1,0,0,0,-1,20230512_150234_jpg.rf.f07768807cd91c66efa0a831a47227f2.jpg
1_sabl,fold_6,1,1,1,0,0,20230512_152328_jpg.rf.2ee5fc7202b8e73c23dedf7899bfd23d.jpg
1_sabl,fold_6,1,1,1,0,0,20230512_150736_jpg.rf.86dffaa733e76af31361da63d1f9c5be.jpg
1_sabl,fold_6,1,1,1,0,0,IMG_20230512_151152_632_jpg.rf.e78de54f18056ed239e1e53f8b27b606.jpg
1_sabl,fold_6,1,0,0,0,-1,IMG_20230512_145000_jpg.rf.08a86ebaadb5647031d884039f76ad3d.jpg
1_sabl,fold_6,5,5,4,1,0,MG_20230512_145246_jpg.rf.c35a60cd9e1280159604c5915a9e199e.jpg
1_sabl,fold_6,1,2,1,1,1,20230512_151222_jpg.rf.77904cc81033fc2ad3a414b07b9c1b2e.jpg
1_sabl,fold_6,14,9,7,2,-5,IMG_20230512_145147_jpg.rf.8cac9a120dccf5b1ce92992c1c714c4d.jpg
1_sabl,fold_6,18,6,5,1,-12,0201_jpg.rf.517ca1ec56a693f7c628bd07b5acdfc2.jpg
1_sabl,fold_6,1,1,1,0,0,20230512_151615_jpg.rf.3d0f727d5e2b61ba73995558758dffb3.jpg
1_sabl,fold_6,6,5,5,0,-1,IMG_4097_JPG.rf.4f85a4c675f81cdca11f141abb8d7c2d.jpg
1_sabl,fold_6,2,3,2,1,1,20230512_151705-0-_jpg.rf.3ca3d09e046dc693a1fb88dca9ebaa3b.jpg
1_sabl,fold_6,2,0,0,0,-2,20230512_153408_jpg.rf.b5d7a9cb1b0260613799e2d57092c4ec.jpg
1_sabl,fold_6,1,0,0,0,-1,IMG_20230512_151127_629_jpg.rf.f41df076266191a6a8a7eca7b189e061.jpg
1_sabl,fold_6,1,1,1,0,0,0028_jpg.rf.2103488effe87e7c2da4cf07f6ed7f75.jpg
1_sabl,fold_6,4,3,3,0,-1,IMG_4054_JPG.rf.c3d803491fea4d419a745a606ab372e6.jpg
1_sabl,fold_6,6,5,4,1,-1,0061_jpg.rf.9c87cf09deaf73a61f5ac233c2bdb702.jpg
1_sabl,fold_6,1,1,0,1,0,20230512_145032_jpg.rf.a2eb942256aef666c2ddc91b6c22b7a5.jpg
1_sabl,fold_6,1,0,0,0,-1,20230512_145138_jpg.rf.04549600bf4eee12b13c6119d3c35a78.jpg
1_sabl,fold_6,3,2,1,1,-1,20230512_150019_jpg.rf.3831013b1b3289f609c139cb5b3ee2d0.jpg
1_sabl,fold_6,5,1,1,0,-4,IMG_20230512_151248_jpg.rf.fd83e7f5d0f84675cb06da482f588b3b.jpg
1_sabl,fold_6,1,1,1,0,0,20230512_150810_jpg.rf.ca47a1fafa212b60e926b93e5eb8674b.jpg
1_sabl,fold_6,5,3,2,1,-2,20230512_145436_jpg.rf.f86063716cf890f2f2412ed2bc009f84.jpg
1_sabl,fold_6,12,2,2,0,-10,20230512_150103_jpg.rf.7c63165e8e1129a671cb603fa47109d8.jpg
1_sabl,fold_6,1,0,0,0,-1,0019_jpg.rf.f929e8c0a480b1ec40d48ffa32427490.jpg
1_sabl,fold_6,15,3,3,0,-12,20230512_151327_jpg.rf.d5fc64b9888dff7235c7da7317d07fc0.jpg
1_sabl,fold_6,15,4,4,0,-11,20230512_145239_jpg.rf.36d4ca0350293c4011bd19f94bc7867d.jpg
1_sabl,fold_6,9,3,3,0,-6,IMG_20230512_151048_jpg.rf.c92aa7d50112ca96c1f3bdd418f74d1c.jpg
1_sabl,fold_6,1,0,0,0,-1,IMG_3917_JPG.rf.7696994544924bd6d81ad9d1ace3f843.jpg
1_sabl,fold_6,5,1,1,0,-4,20230512_150057_jpg.rf.8739eeb8744698e06d085991ee1483d5.jpg
1_sabl,fold_6,7,4,4,0,-3,IMG_20230512_151223_jpg.rf.af08f6dc665fcecd42728873d339f65f.jpg
1_sabl,fold_6,9,7,6,1,-2,IMG_20230512_145259_jpg.rf.655fa0eaa10935cb21a8b2452c556c92.jpg
1_sabl,fold_6,2,0,0,0,-2,IMG_20230512_145024_jpg.rf.48184e0191f6dc0deaabedad53f15496.jpg
1_sabl,fold_6,13,9,8,1,-4,IMG_20230512_152228_454_jpg.rf.41bea2902570b7445e0f1ec3abc4a012.jpg
1_sabl,fold_6,3,1,1,0,-2,230512_150042_jpg.rf.333656aaee32bab812e48513c9f469d1.jpg
1_sabl,fold_6,2,1,1,0,-1,20230512_145431_jpg.rf.026561e5d2d5a23868267be144014c1a.jpg
1_sabl,fold_6,2,2,1,1,0,IMG_4029_JPG.rf.5a655364af1d770d5e464fd022215d30.jpg
1_sabl,fold_7,12,10,10,0,-2,IMG_20230512_152242_316_jpg.rf.640eb728992e501ad35261a525ddcd6f.jpg
1_sabl,fold_7,21,7,7,0,-14,20230512_153312_jpg.rf.9bc8be12c2f1c3b853b5dd7ce2de2445.jpg
1_sabl,fold_7,1,1,1,0,0,IMG_4043_JPG.rf.3fd3ae2706b1bd88e07090f3f20fe829.jpg
1_sabl,fold_7,1,0,0,0,-1,20230512_145250_jpg.rf.effdab3112b728049f9a595e68cc1fbe.jpg
1_sabl,fold_7,2,0,0,0,-2,IMG_3845_JPG.rf.99db8c1cc5267eb444c95ebe84cd88ba.jpg
1_sabl,fold_7,2,2,2,0,0,20230512_151759-0-_jpg.rf.9397d17b6e9b50b8b3327c1f6e7e4e13.jpg
1_sabl,fold_7,23,13,11,2,-10,20230512_153047_jpg.rf.c2e7222d0e6d439a279014b9de708707.jpg
1_sabl,fold_7,1,0,0,0,-1,IMG_20230512_144936_jpg.rf.02a75ef0c1666837558e6b5e99086463.jpg
1_sabl,fold_7,4,3,2,1,-1,IMG_20230512_145250_052_jpg.rf.22501a15b7ee521908502f0562f1943b.jpg
1_sabl,fold_7,1,0,0,0,-1,IMG_20230512_151943_jpg.rf.245470432c5353d43170f1aa8d72aa47.jpg
1_sabl,fold_7,15,10,8,2,-5,20230512_152312_jpg.rf.27e0a448e297ab33c52fb903a0a61757.jpg
1_sabl,fold_7,22,2,0,2,-20,IMG_20230512_150103_jpg.rf.0a6f19ce6332956f8b29791a9f2bfd27.jpg
1_sabl,fold_7,18,0,0,0,-18,20230512_150003_jpg.rf.4bee1a84712696acd3c6434f86ac8310.jpg
1_sabl,fold_7,3,3,2,1,0,20230512_150158_jpg.rf.38b8f697e558e1ec0f9c87c946a7c86d.jpg
1_sabl,fold_7,3,1,1,0,-2,20230512_145319_jpg.rf.cd5fadb6c5fddffa67d73b8b37272f64.jpg
1_sabl,fold_7,30,0,0,0,-30,20230512_150004_jpg.rf.495dbb753fb5fd527e14101c52213803.jpg
1_sabl,fold_7,1,1,1,0,0,20230512_151613_jpg.rf.e0b45cee6190ca8866233157c4462548.jpg
1_sabl,fold_7,0,21,0,21,21,IMG_20230512_150254_jpg.rf.a5c0f01d411bde413dbb553e6557c16f.jpg
1_sabl,fold_7,2,1,0,1,-1,IMG_20230512_145306_094_jpg.rf.09cc5cc7fd6ffa704dffb84466385562.jpg
1_sabl,fold_7,16,7,6,1,-9,20230512_152241_jpg.rf.9b0739a668aaaecd1a1d3e7bf8b2688f.jpg
1_sabl,fold_7,1,1,1,0,0,20230512_145417_jpg.rf.db3be61a74c7e02c4d1054b72f46745b.jpg
1_sabl,fold_7,7,4,3,1,-3,20230512_151546_jpg.rf.650e7a29638d0dabdf27fcfefcab07cb.jpg
1_sabl,fold_7,3,4,3,1,1,20230512_152322_jpg.rf.53fd89be056ce49374a18ace4aa4f447.jpg
1_sabl,fold_7,2,1,0,1,-1,20230512_150824_jpg.rf.9590430380cde837c5b86f877c2bf080.jpg
1_sabl,fold_7,1,0,0,0,-1,20230512_151604_jpg.rf.39e93e2b60bed55a4fb26d60d17f81ce.jpg
1_sabl,fold_7,6,7,6,1,1,20230512_152250_jpg.rf.0c23d9c9105722daa1a62bbed8129065.jpg
1_sabl,fold_7,10,3,3,0,-7,20230512_153314_jpg.rf.fdc2e0650616a2e23fae79ddbc6b98bb.jpg
1_sabl,fold_7,1,2,1,1,1,20230512_151540_jpg.rf.6fc0f7a0e69e619bbef3fea84a825105.jpg
1_sabl,fold_7,9,1,1,0,-8,IMG_20230512_150115_jpg.rf.93d6ec31991ffdb896e9bf82280f1f99.jpg
1_sabl,fold_7,19,0,0,0,-19,20230512_150010_jpg.rf.620f860344c0524a1ea0d2095e555387.jpg
1_sabl,fold_7,1,0,0,0,-1,0230512_145318_jpg.rf.98f8a12ed2e48f7e62edcc542f5a7a3b.jpg
1_sabl,fold_7,9,2,1,1,-7,20230512_151513_jpg.rf.9ba62843997a0b42cb30d66d35cfe761.jpg
1_sabl,fold_7,2,3,2,1,1,20230512_145051_jpg.rf.603261488d01ac12c49ce95447252a07.jpg
1_sabl,fold_7,3,3,1,2,0,20230512_151745_jpg.rf.26e57cd112d09282bbedc612b9e3bddc.jpg
1_sabl,fold_7,29,14,8,6,-15,IMG_20230512_150104_jpg.rf.d5cb8950b8524a6e8b69b37121f816be.jpg
1_sabl,fold_7,11,9,9,0,-2,IMG_20230512_151854_jpg.rf.96120163430ff0d69f2a3b4c65cf13be.jpg
1_sabl,fold_7,1,1,0,1,0,20230512_151443_jpg.rf.02c0d1f9196b0a7db17357b113fa32ed.jpg
1_sabl,fold_7,4,3,3,0,-1,0059_jpg.rf.9ac56781472ffe9dda122b176baf1512.jpg
1_sabl,fold_7,8,5,4,1,-3,IMG_20230512_145441_jpg.rf.6b7c2d8bfc0ced9198b112d0d6ade7e2.jpg
1_sabl,fold_7,11,3,2,1,-8,20230512_145235_jpg.rf.7588a0153c1b25a775a82b15cb976f2d.jpg
1_sabl,fold_7,1,1,1,0,0,IMG_20230512_151147_269_jpg.rf.6170f9ba05705d7d45cbb1c21073f67c.jpg
1_sabl,fold_7,3,2,1,1,-1,20230512_150145_jpg.rf.8935abf1c95d41b2b953913a4d6f31f7.jpg
1_sabl,fold_7,14,11,10,1,-3,IMG_20230512_152216_096_jpg.rf.adf03897848531ce89d004439a8fa974.jpg
1_sabl,fold_7,13,2,2,0,-11,IMG_20230512_150128_jpg.rf.4b6044488f522150e791a223d8868723.jpg
1_sabl,fold_7,15,7,7,0,-8,20230512_151529_jpg.rf.13e844f081c4efeefda4af063187f6d3.jpg
1_sabl,fold_7,1,0,0,0,-1,20230512_151036_jpg.rf.f3b838a0faab4c3495dd44281c87539d.jpg
1_sabl,fold_7,1,1,1,0,0,IMG_20230512_150926_jpg.rf.592b75864e594302b259312be28a0792.jpg
1_sabl,fold_7,6,2,2,0,-4,IMG_20230512_150317_jpg.rf.ac25b1898213749cb0686c2bc3130301.jpg
1_sabl,fold_7,4,2,2,0,-2,0004_jpg.rf.cad1f4f7c2a5a911d6d1cdfa5f75d055.jpg
1_sabl,fold_7,6,0,0,0,-6,20230512_150135_jpg.rf.d4fd2dcfb498280a8309f6f9fbf3b816.jpg
1_sabl,fold_7,11,3,3,0,-8,IMG_20230512_151556_798_jpg.rf.64e451fae797a84c7394203ef45fb0a5.jpg
1_sabl,fold_7,13,8,6,2,-5,IMG_20230512_152158_858_jpg.rf.1a8b5fd8c9168917604cd153b5720b1d.jpg
1_sabl,fold_7,37,7,5,2,-30,0512_150144_jpg.rf.eb6f48f566e7b2e533d3c169bb9783b0.jpg
1_sabl,fold_7,1,1,1,0,0,20230512_151643_jpg.rf.cd8dd51a7f1332798879f4e5d7e928f6.jpg
1_sabl,fold_7,3,1,0,1,-2,20230512_150301_jpg.rf.9f5a1e2491eb0f23ad2976622defdd66.jpg
1_sabl,fold_7,1,1,1,0,0,20230512_145434_jpg.rf.c6e724cc40d69fabc8ce6dc7f102385b.jpg
1_sabl,fold_7,3,2,2,0,-1,0230512_145050_jpg.rf.2803b267b643801d5d6b63fa2d927f37.jpg
1_sabl,fold_7,1,0,0,0,-1,IMG_20230512_144948_jpg.rf.982c926a32fe1a245ffd566259fcb9bb.jpg
1_sabl,fold_7,6,2,2,0,-4,20230512_152308_jpg.rf.bfaaf2477f56005e5db4ac2d8a0dd0a7.jpg
1_sabl,fold_7,1,0,0,0,-1,20230512_144954_jpg.rf.b91c4aef38ae9c4f6e5c0bcc155cdbb9.jpg
1_sabl,fold_7,2,1,0,1,-1,20230512_145012_jpg.rf.7e7325fc33c5f9d9c92a4f4f8c48bd73.jpg
1_sabl,fold_7,3,2,2,0,-1,20230512_151626_jpg.rf.ce9aac74e8994e1b51e9f517df6a0830.jpg
1_sabl,fold_7,6,5,4,1,-1,IMG_20230512_145241_jpg.rf.298cf145f167e685da520bffba4d53a8.jpg
1_sabl,fold_7,4,3,2,1,-1,20230512_151307_jpg.rf.21fca3895ba4bf60b18eb9cd32d76ed9.jpg
1_sabl,fold_7,8,2,0,2,-6,20230512_150035_jpg.rf.590e7ece3e6e94d92163049b218f2085.jpg
1_sabl,fold_7,11,2,1,1,-9,20230512_144943_jpg.rf.6e882f14ce6985046782f1fb925495d2.jpg
1_sabl,fold_7,1,0,0,0,-1,20230512_151231_jpg.rf.4dc10049f8ecfe04ad41c2d1b1428792.jpg
1_sabl,fold_7,46,12,0,12,-34,20230512_153213_jpg.rf.9ee2b7f723899fca4419bd4e0c4eec72.jpg
1_sabl,fold_7,16,4,3,1,-12,IMG_20230512_153426_jpg.rf.13530953faa743fa6763be6d0ab583af.jpg
1_sabl,fold_7,2,0,0,0,-2,20230512_151459_jpg.rf.b5fc6223eb6e9549a2bed14367997348.jpg
1_sabl,fold_7,5,0,0,0,-5,IMG_20230512_145052_jpg.rf.1f1d0e8ea8a62acdeb924c64ae560628.jpg
1_sabl,fold_7,1,1,1,0,0,20230512_152330_jpg.rf.d9a6f6c4784e57ad912b6182a3fd0211.jpg
1_sabl,fold_7,1,1,1,0,0,0017_jpg.rf.324871efad4024d500a23b82191808a8.jpg
1_sabl,fold_7,1,1,1,0,0,IMG_20230512_150908_jpg.rf.753a3cfb7ff38bc8300418f88dbf331c.jpg
1_sabl,fold_7,2,3,2,1,1,20230512_151703_jpg.rf.2faae265964e4a8dd7c48f882318b9e2.jpg
1_sabl,fold_7,5,5,5,0,0,20230512_151812_jpg.rf.4e67fe81dff51295403e0c06c0621c2f.jpg
1_sabl,fold_7,1,1,0,1,0,20230512_153218_jpg.rf.64a3b9a40868420e3930fa153e76d395.jpg
1_sabl,fold_7,13,13,10,3,0,20230512_153010_jpg.rf.b8501fc8a709517e34e7cb69002aa015.jpg
1_sabl,fold_7,17,8,7,1,-9,0038_jpg.rf.3f55cd3c03a14d11b3849a2a910a3773.jpg
1_sabl,fold_7,1,0,0,0,-1,20230512_145247_jpg.rf.9d204b8a475593430db82a060e2456d1.jpg
1_sabl,fold_7,9,8,8,0,-1,20230512_151909_jpg.rf.aead0419a0a121c39fda16a03595ab78.jpg
1_sabl,fold_7,13,6,6,0,-7,20230512_153312-0-_jpg.rf.8f1668ec1eddb4c37aa8c4c6b04cdd81.jpg
1_sabl,fold_7,2,1,1,0,-1,0002_jpg.rf.11a670be82fdde02b205d9929f761ed7.jpg
1_sabl,fold_7,17,1,1,0,-16,20230512_150002_jpg.rf.264d90b8bb0bb75c8bbe433b3c221545.jpg
1_sabl,fold_7,12,7,7,0,-5,20230512_150200_jpg.rf.2582038eca240736fe94eb2ed6cae31e.jpg
1_sabl,fold_7,7,1,1,0,-6,20230512_150042_jpg.rf.613029bfbedc91e536387ccf8df16dd0.jpg
1_sabl,fold_7,2,1,1,0,-1,20230512_152249_jpg.rf.04c1bebce986183bedd854bb677da384.jpg
1_sabl,fold_7,2,2,2,0,0,20230512_151701_jpg.rf.819108571877bfd9f9063c78d807263f.jpg
1_sabl,fold_7,13,8,7,1,-5,IMG_20230512_145142_jpg.rf.fb2156626619cc38cf3127f70d63b5f0.jpg
1_sabl,fold_7,10,5,5,0,-5,20230512_145209_jpg.rf.2f0dfe951cb0a7165c942a2117e73f0d.jpg
1_sabl,fold_7,2,0,0,0,-2,20230512_145136_jpg.rf.852bd73d66d536a7a4ffbed448466961.jpg
1_sabl,fold_7,5,3,3,0,-2,IMG_20230512_151217_jpg.rf.04d3195207b1eb7346b1ba52c101a706.jpg
1_sabl,fold_7,8,0,0,0,-8,20230512_153130_jpg.rf.9b7bb97006640f6490a71f226200a2ca.jpg
1_sabl,fold_7,2,2,2,0,0,20230512_151638_jpg.rf.a0292d546f8d78bd93a8e0b8e16cdcad.jpg
1_sabl,fold_7,17,12,8,4,-5,20230512_150154_jpg.rf.89a63f38c3d9a5091806e13ec9a0b9d0.jpg
1_sabl,fold_7,8,6,6,0,-2,20230512_151851-0-_jpg.rf.fb46950ff8ddbfa6d4406784eb5e22b5.jpg
1_sabl,fold_7,33,1,1,0,-32,IMG_20230512_150352_jpg.rf.c1ca8bf250991c89b762984231b93a22.jpg
1_sabl,fold_7,9,5,4,1,-4,230512_150136_jpg.rf.1e2f1e90c67eb7b8f01703f120072671.jpg
1_sabl,fold_7,2,1,1,0,-1,0230512_145303_jpg.rf.48b2ec4c0dbde15f8f5f8b3bd2b59378.jpg
1_sabl,fold_7,1,0,0,0,-1,20230512_151014_jpg.rf.1daaabfd079316b6b36cd3f076521079.jpg
1_sabl,fold_7,7,0,0,0,-7,20230512_150115_jpg.rf.1e159ea5bb7c2543a1928c133ef9b549.jpg
1_sabl,fold_7,1,1,1,0,0,20230512_151753_jpg.rf.a14249ba89cecfaa73e632b588efdfd7.jpg
1_sabl,fold_7,2,3,2,1,1,20230512_151637_jpg.rf.a44f9c09520025824affd7d45589da18.jpg
1_sabl,fold_7,9,9,8,1,0,20230512_152217_jpg.rf.a958863ea2bb344fee3c8c7b29889838.jpg
1_sabl,fold_7,2,1,1,0,-1,MG_20230512_145032_jpg.rf.043a11012a2a8dcb1cee1fc40482b97d.jpg
1_sabl,fold_7,6,2,1,1,-4,IMG_3831_JPG.rf.5b9e206f11628659b685b91001a564e0.jpg
1_sabl,fold_7,10,4,2,2,-6,IMG_20230512_150826_018_jpg.rf.6cdf008f2fd91c8d5a59ecb707eb0a93.jpg
1_sabl,fold_7,8,8,7,1,0,IMG_4096_JPG.rf.8be1b70c0cb24617e853855e4e345ebe.jpg
1_sabl,fold_7,7,4,4,0,-3,0047_jpg.rf.f81c0ac4631d37256a41aa0d36e49744.jpg
1_sabl,fold_7,8,3,3,0,-5,IMG_20230512_151221_jpg.rf.1eaad9c5a6a8acb495445f202d82d696.jpg
1_sabl,fold_7,2,1,1,0,-1,230512_150056_jpg.rf.63fc419be91fa960c9fdd540582bc424.jpg
1_sabl,fold_7,1,0,0,0,-1,20230512_145435_jpg.rf.0381cab4fa18f72340c2377d16cc9660.jpg
1_sabl,fold_7,21,0,0,0,-21,IMG_20230512_153447_jpg.rf.f9b2e4987e37b091be6072cae946d663.jpg
1_sabl,fold_7,14,1,1,0,-13,20230512_150101_jpg.rf.cc96a2d607d78ec899d39fd65e3ffcef.jpg
1_sabl,fold_7,5,4,2,2,-1,0230512_145402_jpg.rf.b34ea25b1c9ac3f7cc8061e80027c857.jpg
1_sabl,fold_7,11,6,3,3,-5,IMG_20230512_145018_jpg.rf.d1613b46f617939d055c5b8c109e9fa3.jpg
1_sabl,fold_7,3,1,1,0,-2,IMG_20230512_145338_jpg.rf.079f726ce175cc710ca12b4c3caa612c.jpg
1_sabl,fold_7,6,5,3,2,-1,20230512_145402_jpg.rf.2adab9c4657dc31e00e7139d61d9500a.jpg
1_sabl,fold_7,11,10,10,0,-1,0046_jpg.rf.e1528b2cf27767ce9998ebd79d287f47.jpg
1_sabl,fold_7,1,0,0,0,-1,0023_jpg.rf.816619f3269b0637f700332186be4dc7.jpg
1_sabl,fold_7,5,3,3,0,-2,IMG_3994_JPG.rf.3f53434cd9176d3f8187cface46b0ee0.jpg
1_sabl,fold_7,6,3,3,0,-3,20230512_150209_jpg.rf.386fa5331924ef6713a22c58b720e320.jpg
1_sabl,fold_7,5,1,1,0,-4,230512_150029_jpg.rf.12bae245124889830af4fc74e9e52dc8.jpg
1_sabl,fold_7,4,4,4,0,0,20230512_152303_jpg.rf.51286f7b0969a38d9408ce913d70bf49.jpg
1_sabl,fold_7,5,4,4,0,-1,20230512_145222_jpg.rf.fd35bc6270e794e1ad0a42037bded3b6.jpg
1_sabl,fold_7,9,7,7,0,-2,20230512_151906_jpg.rf.898831e6903935bdc29051a4dc1aec5d.jpg
1_sabl,fold_7,40,1,1,0,-39,IMG_20230512_153257_jpg.rf.d9dc811045c5a29bd9426b22f724b734.jpg
1_sabl,fold_7,3,2,2,0,-1,20230512_151140_jpg.rf.7db6428b7e2bbbef7dd568e63b356863.jpg
1_sabl,fold_7,1,0,0,0,-1,IMG_20230512_153421_jpg.rf.6158f971c571c6c40a9f73c5154fea7e.jpg
1_sabl,fold_7,3,2,2,0,-1,IMG_3991_JPG.rf.956960577cc9ffaab083d7a4f4c5bd11.jpg
1_sabl,fold_7,10,2,2,0,-8,20230512_150040_jpg.rf.aa50ac3e2a5a2042940711140afd2b9a.jpg
1_sabl,fold_7,1,0,0,0,-1,20230512_151227_jpg.rf.27d11f08dc002dbce0c7ab80e18ba38a.jpg
1_sabl,fold_7,4,3,3,0,-1,IMG_20230512_151208_jpg.rf.be5e6b4532e99f11dd349cc77c5094ca.jpg
1_sabl,fold_7,1,1,1,0,0,IMG_20230512_150835_jpg.rf.5163b3bd6692963a73a0e71f347963cd.jpg
1_sabl,fold_7,1,2,1,1,1,20230512_153356_jpg.rf.4d48f88351e5397a697a75c05a09f970.jpg
1_sabl,fold_7,2,4,2,2,2,20230512_151054_jpg.rf.7c0b5c7091bc1f6a8f74bc553c645583.jpg
1_sabl,fold_7,8,4,4,0,-4,20230512_151856_jpg.rf.e796d63958aed52d331329de4229f784.jpg
1_sabl,fold_7,42,0,0,0,-42,20230512_150217_jpg.rf.43a34e583d3360fb03c78ebcf6334f2b.jpg
1_sabl,fold_7,1,0,0,0,-1,20230512_151616_jpg.rf.319cd6543513a0db4c94621f3c78c207.jpg
1_sabl,fold_7,1,0,0,0,-1,20230512_145235_jpg.rf.609ee666fef18c181192a729599f029f.jpg
1_sabl,fold_7,17,0,0,0,-17,IMG_20230512_150105_jpg.rf.570debb8303e1ced483c9d4a2731ffec.jpg
1_sabl,fold_7,15,11,10,1,-4,IMG_20230512_153006_493_jpg.rf.8cb0e9085e5e5a8d382f8e2647075293.jpg
1_sabl,fold_7,1,1,1,0,0,20230512_151335_jpg.rf.28b2031d23e55f8020b7aa20b9efc752.jpg
1_sabl,fold_7,1,0,0,0,-1,IMG_20230512_145233_jpg.rf.d273d9a04013a4fdb680069c5f2e4780.jpg
1_sabl,fold_7,1,2,1,1,1,IMG_3841_JPG.rf.adc4a928f5d56c89691b1d5525a2cb06.jpg
1_sabl,fold_7,23,3,0,3,-20,20230512_150127_jpg.rf.f6e969d7228c49f8b298a15c5ea0d88d.jpg
1_sabl,fold_7,8,1,0,1,-7,20230512_150319_jpg.rf.71d19e64b856b04c9ab111407595de18.jpg
1_sabl,fold_7,8,3,2,1,-5,20230512_151037_jpg.rf.85e4a64b3db494811f84775d729cc9e7.jpg
1_sabl,fold_7,1,0,0,0,-1,IMG_4393_JPG.rf.47566015c2485f15e5114808d8a0d4ed.jpg
1_sabl,fold_7,2,2,2,0,0,IMG_20230512_151816_jpg.rf.8fba275d23a787980bb56f34532a5efd.jpg
1_sabl,fold_7,6,5,5,0,-1,20230512_151851_jpg.rf.96579435ffaa9d451e63a406f34fab4e.jpg
1_sabl,fold_7,3,2,0,2,-1,IMG_4388_JPG.rf.1ddaadb8d3afe73ea7e33c9a29acec1e.jpg
1_sabl,fold_7,19,3,3,0,-16,IMG_20230512_150059_992_jpg.rf.b49a36b89c3ed0b8925e2ad7f1b905b9.jpg
1_sabl,fold_7,13,9,9,0,-4,230512_150153_jpg.rf.fb4c5b04651624464aee8747090f6cee.jpg
1_sabl,fold_7,9,2,1,1,-7,20230512_150329_jpg.rf.fd5367a6796a2fc3f0181a6e4c4b9513.jpg
1_sabl,fold_7,1,0,0,0,-1,230512_150122_jpg.rf.d2ef84171022dfe6b7f85166ab202b72.jpg
1_sabl,fold_7,6,3,3,0,-3,IMG_20230512_151041_jpg.rf.eda52b9119a16dac9d1d2632ea4d34bd.jpg
1_sabl,fold_8,26,0,0,0,-26,20230512_153257_jpg.rf.b0ed75a4fd63f8fa4923e04bdb1c38e2.jpg
1_sabl,fold_8,7,0,0,0,-7,20230512_152257_jpg.rf.25eef75e9cfc61b58dc03da8328d53ad.jpg
1_sabl,fold_8,9,0,0,0,-9,230512_150137_jpg.rf.a07a63205732aea6ea773793a5a4e25c.jpg
1_sabl,fold_8,2,0,0,0,-2,IMG_20230512_145254_jpg.rf.dfd1ca61f82842fe96ba39de8974f5d4.jpg
1_sabl,fold_8,13,0,0,0,-13,20230512_150244_jpg.rf.1ef934795ff31c5b43b6da861b2ac051.jpg
1_sabl,fold_8,4,0,0,0,-4,IMG_20230512_145320_405_jpg.rf.143f083c59c1dedbd9f3f7f157927edf.jpg
1_sabl,fold_8,1,0,0,0,-1,IMG_4050_JPG.rf.242fde50c6291117b6172ee1dc45f081.jpg
1_sabl,fold_8,1,0,0,0,-1,20230512_145043_jpg.rf.943869aa154c2400192f3cbbf372a136.jpg
1_sabl,fold_8,1,0,0,0,-1,20230512_145034_jpg.rf.1bf97c164c29fec5dca87d03670ab344.jpg
1_sabl,fold_8,2,0,0,0,-2,IMG_4034_JPG.rf.92867b137f89f18d7bfc2034cbb1597f.jpg
1_sabl,fold_8,11,0,0,0,-11,20230512_150131_jpg.rf.b7b4ef28a3d5833ddf815ebcf9a8b336.jpg
1_sabl,fold_8,1,0,0,0,-1,20230512_145223_jpg.rf.e86673dc1e563853935de252c1c2a11e.jpg
1_sabl,fold_8,2,0,0,0,-2,20230512_145313_jpg.rf.a52df235ea36832731aa90971489567a.jpg
1_sabl,fold_8,1,0,0,0,-1,20230512_151654_jpg.rf.1ff5a5051a16402ce45fe6ca565c9239.jpg
1_sabl,fold_8,2,0,0,0,-2,20230512_145135_jpg.rf.4d3af6f64064db39df70b1e3672a3f63.jpg
1_sabl,fold_8,1,0,0,0,-1,IMG_20230512_153408_091_jpg.rf.d4b7f029dd191b0e3fc52b4b39bf8116.jpg
1_sabl,fold_8,2,0,0,0,-2,20230512_151619_jpg.rf.c7fb218f315f99ea72e78a520cc5dc68.jpg
1_sabl,fold_8,65,0,0,0,-65,IMG_20230512_153155_jpg.rf.348475844dfbdea71bac7dbce8198f44.jpg
1_sabl,fold_8,26,0,0,0,-26,IMG_3928_JPG.rf.b59dd1a245d0a61096acf104642a588f.jpg
1_sabl,fold_8,1,0,0,0,-1,0230512_145026_jpg.rf.e1ea5177e0224a86904eddffb8258ab9.jpg
1_sabl,fold_8,3,0,0,0,-3,IMG_3865_JPG.rf.85489cc903cddfc5bd27ee6328f5235e.jpg
1_sabl,fold_8,17,0,0,0,-17,IMG_20230512_145019_771_jpg.rf.d4b15f5b7869ffc05f7387247c4f82ae.jpg
1_sabl,fold_8,3,0,0,0,-3,IMG_3909_JPG.rf.be7478f841f6abc72fcc654df3e13ada.jpg
1_sabl,fold_8,7,0,0,0,-7,20230512_151849_jpg.rf.52b8fefba379829baeca592f085340cd.jpg
1_sabl,fold_8,8,0,0,0,-8,IMG_20230512_151934_jpg.rf.543796bd925563f125516769b066b214.jpg
1_sabl,fold_8,2,0,0,0,-2,0008_jpg.rf.058dbc5491e7240170841cbeb7cfebca.jpg
1_sabl,fold_8,2,0,0,0,-2,20230512_151804-0-_jpg.rf.da37c80768423b2be325cf7dcf3b8efd.jpg
1_sabl,fold_8,4,0,0,0,-4,20230512_151138_jpg.rf.bd5d8d04a758d594acc2af15dc942b5f.jpg
1_sabl,fold_8,13,0,0,0,-13,20230512_152309_jpg.rf.e6272cf81ee3a89c98dea29c7ca87fde.jpg
1_sabl,fold_8,8,0,0,0,-8,20230512_150137_jpg.rf.c6db7854f50b446566afe69c0e3bae6f.jpg
1_sabl,fold_8,1,0,0,0,-1,IMG_3858_JPG.rf.10b8772deec081b08895efdc83efbfcc.jpg
1_sabl,fold_8,1,0,0,0,-1,20230512_151447_jpg.rf.8a684005457ea3cadf9943d40014e87f.jpg
1_sabl,fold_8,9,0,0,0,-9,IMG_20230512_144959_jpg.rf.8d9a872947615acdbff5cf0776139cb9.jpg
1_sabl,fold_8,17,0,0,0,-17,20230512_153021_jpg.rf.6b38fba9b80543e229dc93ffb5e19695.jpg
1_sabl,fold_8,11,0,0,0,-11,20230512_151051_jpg.rf.dcb4ee42b399c0d6007719e173f728b6.jpg
1_sabl,fold_8,10,0,0,0,-10,20230512_151854_jpg.rf.0809016c2e20da637cbac7d27e6fb6c0.jpg
1_sabl,fold_8,2,0,0,0,-2,20230512_145219_jpg.rf.f22be001a717798eb8a2168d0d3421ab.jpg
1_sabl,fold_8,5,0,0,0,-5,230512_150140_jpg.rf.7c74dbb84999f31492125730db986f40.jpg
1_sabl,fold_8,10,0,0,0,-10,20230512_151021_jpg.rf.de7c03d7cc7906d7c81bff3b479fd9e5.jpg
1_sabl,fold_8,11,0,0,0,-11,20230512_145237_jpg.rf.d8f058e0b402e3d1e808be861e667173.jpg
1_sabl,fold_8,152,0,0,0,-152,0100_jpg.rf.05cd5bba5e3a338b9bab8b49b2c62230.jpg
1_sabl,fold_8,2,0,0,0,-2,20230512_151516_jpg.rf.4075925f758530db09c215e48201f510.jpg
1_sabl,fold_8,4,0,0,0,-4,IMG_20230512_151322_jpg.rf.f87bdadf921aef8dde8daecc2efda877.jpg
1_sabl,fold_8,1,0,0,0,-1,20230512_151310_jpg.rf.49e186e145599c0c576f88f77a48645f.jpg
1_sabl,fold_8,2,0,0,0,-2,20230512_151840_jpg.rf.225d382469feb3893ab8adf440f0dcdd.jpg
1_sabl,fold_8,15,0,0,0,-15,IMG_20230512_150202_jpg.rf.605274560fcfde991ad3e82107d6fd8c.jpg
1_sabl,fold_8,28,0,0,0,-28,0512_150115_jpg.rf.572fa1a857240740ab2fd9c0bd962a84.jpg
1_sabl,fold_8,11,0,0,0,-11,IMG_20230512_150135_011_jpg.rf.7d2abfcfbd33399d0709cdb1f6848e09.jpg
1_sabl,fold_8,1,0,0,0,-1,20230512_145421_jpg.rf.3704320bbaa6e937ed0261aa404772f1.jpg
1_sabl,fold_8,14,0,0,0,-14,0042_jpg.rf.7ffcac34c8b8720199d793d39ebf099c.jpg
1_sabl,fold_8,34,0,0,0,-34,0512_150108_jpg.rf.2a2b0446e2345745280376767e5d1b27.jpg
1_sabl,fold_8,3,0,0,0,-3,IMG_20230512_152407_jpg.rf.987c14f960c413f0e6ece4c99d516916.jpg
1_sabl,fold_8,7,0,0,0,-7,20230512_150116_jpg.rf.4cdde848ca21f7424c94dada8a3603c8.jpg
1_sabl,fold_8,1,0,0,0,-1,20230512_151642_jpg.rf.8d7807db8a2c50e7601e595cb8e4d441.jpg
1_sabl,fold_8,1,0,0,0,-1,IMG_20230512_161346_jpg.rf.f2d66ae86a3dee44e0234f6002702110.jpg
1_sabl,fold_8,3,0,0,0,-3,20230512_151340_jpg.rf.1e7341de1b15f16ffc701c3b53542fe7.jpg
1_sabl,fold_8,5,0,0,0,-5,20230512_145411_jpg.rf.962646db69e6629f3a045dc737b54f0c.jpg
1_sabl,fold_8,12,0,0,0,-12,20230512_145240_jpg.rf.a5091d10c5393608b704fe2d2a846263.jpg
1_sabl,fold_8,12,0,0,0,-12,IMG_20230512_152002_jpg.rf.0e50ad947bcac786ec04e7adf1df3e90.jpg
1_sabl,fold_8,8,0,0,0,-8,IMG_4207_JPG.rf.330747e746ba1f08f12c25a697df8506.jpg
1_sabl,fold_8,24,0,0,0,-24,IMG_20230512_150022_jpg.rf.951e0e5b24bd9b0e9ad93c5f8e19127d.jpg
1_sabl,fold_8,1,0,0,0,-1,20230512_151445_jpg.rf.7d699391bb3084d81ea03299229ab140.jpg
1_sabl,fold_8,3,0,0,0,-3,IMG_20230512_145332_184_jpg.rf.332c2aa459e521d0576953fca1e0a03f.jpg
1_sabl,fold_8,3,0,0,0,-3,20230512_145052_jpg.rf.e4d9741a91ef6c0f9f053feb1ffe1df5.jpg
1_sabl,fold_8,12,0,0,0,-12,0032_jpg.rf.bbf27b122201c3fdb2fa22a360b64846.jpg
1_sabl,fold_8,4,0,0,0,-4,20230512_151300_jpg.rf.f994d9472b1ee1ddd3ac8ab3a3cc2a12.jpg
1_sabl,fold_8,7,0,0,0,-7,20230512_150036_jpg.rf.409641b85ef17642977736d9dc873ae4.jpg
1_sabl,fold_8,1,0,0,0,-1,IMG_20230512_144910_997_jpg.rf.93aca80524806445b3dfb1818fa4806a.jpg
1_sabl,fold_8,7,0,0,0,-7,IMG_20230512_152357_jpg.rf.77160d5f48db0fa53a72198288557af6.jpg
1_sabl,fold_8,7,0,0,0,-7,20230512_145341_jpg.rf.85ffc7a18e0ad722dbf476743313df02.jpg
1_sabl,fold_8,16,0,0,0,-16,IMG_20230512_151902_jpg.rf.86d659e2d2eb4651a989633ff7c3cb87.jpg
1_sabl,fold_8,17,0,0,0,-17,230512_150202_jpg.rf.ea33cf5fe5f6662c3682e389e8685dfb.jpg
1_sabl,fold_8,12,0,0,0,-12,0048_jpg.rf.ec48089b3f18d5818c04f71cecd05f38.jpg
1_sabl,fold_8,2,0,0,0,-2,IMG_4091_JPG.rf.a9405bd034e33eacf6b2883c9ed04e2e.jpg
1_sabl,fold_8,13,0,0,0,-13,IMG_20230512_150158_jpg.rf.c8fd099b0d72b4e29fc1807382e042b1.jpg
1_sabl,fold_8,2,0,0,0,-2,20230512_144932_jpg.rf.a725c2a7e9c0d34d34a6abd7d299f6df.jpg
1_sabl,fold_8,16,0,0,0,-16,20230512_151039_jpg.rf.bb11ca2d78a6f005bcb2f521dfcf0dce.jpg
1_sabl,fold_8,5,0,0,0,-5,20230512_152301_jpg.rf.3701d53ed7c06271583a063371e238d1.jpg
1_sabl,fold_8,7,0,0,0,-7,IMG_20230512_145108_jpg.rf.5b77832e2c70819f5a5de9e318768425.jpg
1_sabl,fold_8,3,0,0,0,-3,IMG_3849_JPG.rf.7ce1df74f4ca793d89d2042ccc5766ef.jpg
1_sabl,fold_8,10,0,0,0,-10,20230512_145206_jpg.rf.4cf9a1bcd726515460c68ec0b753f06a.jpg
1_sabl,fold_8,21,0,0,0,-21,IMG_20230512_150057_jpg.rf.1d901fec112c2705325b5b23647b5cfe.jpg
1_sabl,fold_8,5,0,0,0,-5,20230512_151846_jpg.rf.aaa6e44ba0c35df5988efcf5a4f2510c.jpg
1_sabl,fold_8,22,0,0,0,-22,IMG_20230512_153211_jpg.rf.8b8c95e482643af377a9a4d7a0182777.jpg
1_sabl,fold_8,3,0,0,0,-3,0230512_145440_jpg.rf.26be693a65087ccb13d4129f4c93b786.jpg
1_sabl,fold_8,9,0,0,0,-9,IMG_3931_JPG.rf.fcba871e1d94de33741779717c57137f.jpg
1_sabl,fold_8,1,0,0,0,-1,20230512_145025_jpg.rf.15940c55814fd494ff830db5a9061d30.jpg
1_sabl,fold_8,1,0,0,0,-1,IMG_20230512_145352_jpg.rf.1c96dea3488a61099952ab7250fce4b2.jpg
1_sabl,fold_8,3,0,0,0,-3,20230512_145231_jpg.rf.77f03cc3c54cff48c03e24558d36189b.jpg
1_sabl,fold_8,16,0,0,0,-16,IMG_20230512_151508_jpg.rf.c78520025916588a7657b75ae388cb8f.jpg
1_sabl,fold_8,12,0,0,0,-12,IMG_20230512_145022_866_jpg.rf.245d67f93e45a020eb21fdd8f4124767.jpg
1_sabl,fold_8,4,0,0,0,-4,20230512_145329_jpg.rf.0c0d42d6e893d6efcd4b3119ce990d0e.jpg
1_sabl,fold_8,2,0,0,0,-2,20230512_145433_jpg.rf.5924d4f1a47105e53efa0a08085450a7.jpg
1_sabl,fold_8,3,0,0,0,-3,IMG_20230512_152405_jpg.rf.ebe5f63b7b940c8d9a74c8fb5839d39b.jpg
1_sabl,fold_8,6,0,0,0,-6,20230512_150204_jpg.rf.87f7c1141bc54dad9c82b36c8beb1bb9.jpg
1_sabl,fold_8,1,0,0,0,-1,230512_150118_jpg.rf.ecc50b57dabc83b04e792a7ddde388f8.jpg
1_sabl,fold_8,2,0,0,0,-2,20230512_150052_jpg.rf.9bdf107fc37c37b05aa46914e8882f17.jpg
1_sabl,fold_8,5,0,0,0,-5,20230512_151135_jpg.rf.3b3e99725d0ae8b34747d0ed51687a4a.jpg
1_sabl,fold_8,2,0,0,0,-2,230512_145056_jpg.rf.cb3d61bce2d4e0686bc0310ab76413a2.jpg
1_sabl,fold_8,25,0,0,0,-25,IMG_20230512_150208_jpg.rf.14a0d0d16b6d32327bcec6959b738634.jpg
1_sabl,fold_8,30,0,0,0,-30,IMG_20230512_150210_524_jpg.rf.476d8805b0160b5143ad37609399dc72.jpg
1_sabl,fold_8,1,0,0,0,-1,20230512_151455_jpg.rf.ea02e305291eae5ae85ae54d0ebfe26d.jpg
1_sabl,fold_8,19,0,0,0,-19,IMG_20230512_150024_jpg.rf.5425ded2475701fa14408062843212ec.jpg
1_sabl,fold_8,10,0,0,0,-10,20230512_153132_jpg.rf.cac6aa1f1a0f028046df980276b5e4e6.jpg
1_sabl,fold_8,1,0,0,0,-1,MG_20230512_145316_jpg.rf.4d66c8eb78cdd81e04686ee0f7aa4fdf.jpg
1_sabl,fold_8,12,0,0,0,-12,20230512_152311_jpg.rf.7f2da0009f2fa07600b981c50d8d6ebf.jpg
1_sabl,fold_8,1,0,0,0,-1,20230512_145036_jpg.rf.1ecc4ae3f81e22aac59d8b3b9c1034cd.jpg
1_sabl,fold_8,1,0,0,0,-1,IMG_4390_JPG.rf.2018de24c221ce01e2c3239735a272af.jpg
1_sabl,fold_8,14,0,0,0,-14,IMG_20230512_145158_jpg.rf.6d28bd6cb232ef60feeaaa2d893d7326.jpg
1_sabl,fold_8,4,0,0,0,-4,IMG_20230512_150225_jpg.rf.5e6e4781174588e28c95f110bb49edf2.jpg
1_sabl,fold_8,17,0,0,0,-17,20230512_151035_jpg.rf.7593703cffcf4a6285b53ddb6e104d39.jpg
1_sabl,fold_8,5,0,0,0,-5,_20230512_150252_jpg.rf.c7786b04a48eca5fec5127b90d27efc6.jpg
1_sabl,fold_8,10,0,0,0,-10,IMG_20230512_161908_jpg.rf.c3138f9567f619fcdc8eb8c700bfcff8.jpg
1_sabl,fold_8,8,0,0,0,-8,20230512_150001_jpg.rf.74ea9697c92aedc234993b5551f7f1b4.jpg
1_sabl,fold_8,5,0,0,0,-5,IMG_20230512_151249_373_jpg.rf.f2dd29bba78783f6fbe29e66675bd321.jpg
1_sabl,fold_8,3,0,0,0,-3,IMG_20230512_151542_635_jpg.rf.1e2c1e872c81db1f473f8c586f3ce9d9.jpg
1_sabl,fold_8,3,0,0,0,-3,20230512_151619-0-_jpg.rf.5d6f8d7a8176754cc78ef08a707b7ea8.jpg
1_sabl,fold_8,8,0,0,0,-8,IMG_20230512_145253_jpg.rf.7d0a492e681439db3a20eb64e356d8ff.jpg
1_sabl,fold_8,2,0,0,0,-2,20230512_151636_jpg.rf.0e80ecb006eb88d60de9b99c0fac2245.jpg
1_sabl,fold_8,11,0,0,0,-11,IMG_3926_JPG.rf.769c3267365e5531dec34c648a73f597.jpg
1_sabl,fold_8,13,0,0,0,-13,IMG_20230512_145120_jpg.rf.3ecb5837a329b79ac20997cfe24d3124.jpg
1_sabl,fold_8,3,0,0,0,-3,230512_150054_jpg.rf.ec6dcd9709fc100d27b3f2f4937b7712.jpg
1_sabl,fold_8,7,0,0,0,-7,IMG_20230512_150945_jpg.rf.26027cad843e4a3c904d281bd5e443ab.jpg
1_sabl,fold_8,2,0,0,0,-2,20230512_151755_jpg.rf.f2aa85c403e0f77cda500046a0fd667f.jpg
1_sabl,fold_8,7,0,0,0,-7,20230512_152237_jpg.rf.dceb042d25e3e44ad022b7c4330f1dcf.jpg
1_sabl,fold_8,19,0,0,0,-19,20230512_153013_jpg.rf.ebf5724207d5fe9aba867759ed6ae350.jpg
1_sabl,fold_8,3,0,0,0,-3,230512_150143_jpg.rf.b686af9ba8be8219e2e0a152ff0123f1.jpg
1_sabl,fold_8,1,0,0,0,-1,IMG_20230512_151231_jpg.rf.f19d35ba554c9c3e62efe863fb1dd098.jpg
1_sabl,fold_8,1,0,0,0,-1,20230512_151451-0-_jpg.rf.352f3ab1f1271f1dc2c7503413d5072b.jpg
1_sabl,fold_8,13,0,0,0,-13,IMG_20230512_151640_056_jpg.rf.69bbb5903a2369e6d01c4fd2bef65e1f.jpg
1_sabl,fold_8,5,0,0,0,-5,230512_150033_jpg.rf.ceea84e0a6184331d2af5a24cba9a7d0.jpg
1_sabl,fold_8,11,0,0,0,-11,0053_jpg.rf.09112cd43c7e1f0da4351e79ab49af2f.jpg
1_sabl,fold_8,12,0,0,0,-12,IMG_20230512_151339_jpg.rf.13ce8b9b66953b0f57413fa693a3dc35.jpg
1_sabl,fold_8,2,0,0,0,-2,IMG_20230512_151240_565_jpg.rf.fdf2f78ec041a34d2611406b29953d18.jpg
1_sabl,fold_8,23,0,0,0,-23,IMG_20230512_150201_jpg.rf.81da174bcf14fd53b844cf7cae9f7a28.jpg
1_sabl,fold_8,27,0,0,0,-27,20230512_153207_jpg.rf.81b28e88b96ae01a62cb2b2cdc468e08.jpg
1_sabl,fold_8,3,0,0,0,-3,20230512_151625_jpg.rf.6d8f8d5fffad59d6ccff118606bdd771.jpg
1_sabl,fold_8,8,0,0,0,-8,IMG_20230512_145440_jpg.rf.4fae61f59dfa2249c388f714b68ca784.jpg
1_sabl,fold_8,2,0,0,0,-2,IMG_4191_JPG.rf.f40d8980877c6222a068ed1ef1102afa.jpg
1_sabl,fold_8,1,0,0,0,-1,20230512_153345_jpg.rf.7d2374802dfa67e187bded47020403c1.jpg
1_sabl,fold_8,1,0,0,0,-1,20230512_150733_jpg.rf.dfdc2eb0d94519616a7ec9cf127c8f8a.jpg
1_sabl,fold_8,1,0,0,0,-1,IMG_4028_JPG.rf.c7571b8910b4228b0179b0ffc703ee1e.jpg
1_sabl,fold_8,9,0,0,0,-9,0230512_150115_jpg.rf.50a5de1d8e046395fd6c82509eb7d363.jpg
1_sabl,fold_8,2,0,0,0,-2,20230512_145355_jpg.rf.67799c9783b1beeb42aebdae40eac27d.jpg
1_sabl,fold_8,9,0,0,0,-9,IMG_3989_JPG.rf.51b8252c5f0a8196d379e91fcc91ad06.jpg
1_sabl,fold_8,1,0,0,0,-1,20230512_145111_jpg.rf.ab829e89e439dc4aa65d413090f00b2d.jpg
1_sabl,fold_8,5,0,0,0,-5,20230512_152259_jpg.rf.fef7e558f14c303ecfa184eb656375ce.jpg
1_sabl,fold_8,1,0,0,0,-1,IMG_20230512_151033_jpg.rf.4872ff92d415a45e16c1f52f8b7ae6db.jpg
1_sabl,fold_8,32,0,0,0,-32,IMG_20230512_153350_jpg.rf.cc68f1c6759992fe198286f32b0171ec.jpg
1_sabl,fold_8,2,0,0,0,-2,20230512_151506_jpg.rf.2d22a2b23e3853093943da42a80fc17b.jpg
1_sabl,fold_8,1,0,0,0,-1,IMG_4015_JPG.rf.8f40d2d78e19693b5d38d76ffd50d286.jpg
1_sabl,fold_8,10,0,0,0,-10,20230512_152217_jpg.rf.a3962f3838250709a368b8f241c7bcad.jpg
1_sabl,fold_8,3,0,0,0,-3,230512_150048_jpg.rf.2a601f5dc5ab605aa2563bcbc35c41e1.jpg
1_sabl,fold_8,14,0,0,0,-14,IMG_20230512_152954_jpg.rf.6f297f29021342f064430fb1e8d22587.jpg
1_sabl,fold_8,2,0,0,0,-2,IMG_4053_JPG.rf.307ece37dd62cbaea82bfd7b14f0ee36.jpg
1_sabl,fold_8,17,0,0,0,-17,20230512_152942_jpg.rf.cc3d43f0d1f322fa8da500d78ce3a8be.jpg
1_sabl,fold_8,3,0,0,0,-3,IMG_20230512_151637_jpg.rf.e79b46fd14d5a0af0846c34d1a920413.jpg
1_sabl,fold_9,7,3,3,0,-4,20230512_152158_jpg.rf.02f9c3c00108d9da3f80f2943458d80a.jpg
1_sabl,fold_9,4,4,4,0,0,IMG_20230512_145312_784_jpg.rf.58023d0721ac49469db4e79c05fb5cba.jpg
1_sabl,fold_9,25,16,15,1,-9,20230512_150144_jpg.rf.ecf1f47bccdedeca682aab00e68f4fbf.jpg
1_sabl,fold_9,4,4,2,2,0,20230512_145408-0-_jpg.rf.7d30c64c68760c899eab7f27576adaec.jpg
1_sabl,fold_9,17,9,9,0,-8,IMG_20230512_153014_136_jpg.rf.ac9f2fc67a44db81aef730e99a1dba0a.jpg
1_sabl,fold_9,20,3,3,0,-17,20230512_153043_jpg.rf.5cddf43df464d99390a41596bf2ccdf2.jpg
1_sabl,fold_9,8,5,5,0,-3,20230512_153242_jpg.rf.5d53d7e395b76d25f2510396dec3f47a.jpg
1_sabl,fold_9,7,4,4,0,-3,20230512_151538_jpg.rf.d5df90d6db920f66f1d45e4cfa70a411.jpg
1_sabl,fold_9,5,4,4,0,-1,0050_jpg.rf.47c1ed097ad14e52c46f19b2b3e3f5a2.jpg
1_sabl,fold_9,3,5,1,4,2,20230512_150109_jpg.rf.4d2c542089703d638847cefe3c0e0669.jpg
1_sabl,fold_9,12,6,5,1,-6,IMG_20230512_151658_955_jpg.rf.6f77aded32a46d8083d7d4e54c112bb9.jpg
1_sabl,fold_9,5,5,4,1,0,IMG_20230512_145258_492_jpg.rf.3ae44ee592a82ee046166d1017a1f348.jpg
1_sabl,fold_9,3,3,3,0,0,IMG_20230512_152403_jpg.rf.708a0e8a856b9c4ca92a84e1450a3e60.jpg
1_sabl,fold_9,7,4,4,0,-3,20230512_151548_jpg.rf.de9bfd82e4ede57511bc911fc34f5695.jpg
1_sabl,fold_9,1,2,1,1,1,IMG_20230512_151202_728_jpg.rf.1d8a1071a58b84a0628884454a63ef8a.jpg
1_sabl,fold_9,11,9,8,1,-2,20230512_152251_jpg.rf.f4cd881ef463deae8c6458635e8849ac.jpg
1_sabl,fold_9,4,3,1,2,-1,IMG_3835_JPG.rf.e405f9fb7ccfe92ed96a553465aa1ec9.jpg
1_sabl,fold_9,18,12,9,3,-6,20230512_144934_jpg.rf.03898f9c31f25d3ec984bc32b412d5af.jpg
1_sabl,fold_9,4,2,2,0,-2,IMG_3867_JPG.rf.ec5d38e5d6681088aaa0d2786eb3bb2b.jpg
1_sabl,fold_9,13,6,6,0,-7,IMG_20230512_152345_469_jpg.rf.3dde8c68a98233421212da59bcbe366e.jpg
1_sabl,fold_9,19,12,11,1,-7,IMG_20230512_152322_jpg.rf.190afc8c001b1a757ff0cc847eea784d.jpg
1_sabl,fold_9,15,9,6,3,-6,0230512_145001_jpg.rf.da230b3dcac925c28f8c0273b5776c9a.jpg
1_sabl,fold_9,8,9,8,1,1,20230512_151900_jpg.rf.1250b5103b69822786ae601e0a5c5f68.jpg
1_sabl,fold_9,3,1,1,0,-2,IMG_20230512_145043_jpg.rf.3d90edfd5a365d1ec3876fca50ab884d.jpg
1_sabl,fold_9,2,1,1,0,-1,IMG_20230512_145345_250_jpg.rf.15fc60af583ce168515577f073866f5f.jpg
1_sabl,fold_9,14,7,7,0,-7,20230512_152217_jpg.rf.2fdd5053b538b85b1941d0bb5e4261ca.jpg
1_sabl,fold_9,5,0,0,0,-5,230512_150109_jpg.rf.fe44d8827f0b8ae246022ca47b5c4c2c.jpg
1_sabl,fold_9,9,9,7,2,0,20230512_152318_jpg.rf.15ef28475daedc6fc4e098af4a1459e5.jpg
1_sabl,fold_9,11,7,7,0,-4,IMG_20230512_151554_209_jpg.rf.f15eb1b2793910f53035e241375725c8.jpg
1_sabl,fold_9,1,0,0,0,-1,20230512_151039_jpg.rf.12dc8e8ab83bd9d6e1e941c7a0c05874.jpg
1_sabl,fold_9,1,1,1,0,0,IMG_3908_JPG.rf.04ee0448a5e502f1d8c821cea701a7e1.jpg
1_sabl,fold_9,2,1,1,0,-1,20230512_150227_jpg.rf.4d20daf17aea8771758821741496ecfd.jpg
1_sabl,fold_9,1,1,1,0,0,20230512_153412_jpg.rf.86821476b6a03cfd46882b168695fa0b.jpg
1_sabl,fold_9,11,1,1,0,-10,20230512_153437_jpg.rf.be3d60256eef37a332523d849f2754c6.jpg
1_sabl,fold_9,1,0,0,0,-1,20230512_150221_jpg.rf.16f1f40fdbd20de3345eed95661a9875.jpg
1_sabl,fold_9,6,4,4,0,-2,20230512_145324_jpg.rf.20601749525cadde15c78b46cd0fd934.jpg
1_sabl,fold_9,11,2,2,0,-9,IMG_20230512_151501_jpg.rf.050803adc8687422b6d0ca0c55649365.jpg
1_sabl,fold_9,8,5,4,1,-3,0041_jpg.rf.dc9ba1dc663668cabb27474922349a17.jpg
1_sabl,fold_9,8,8,6,2,0,20230512_145208_jpg.rf.b8ad2aec57651698bef6edfad1ced014.jpg
1_sabl,fold_9,1,1,1,0,0,20230512_151617_jpg.rf.f876cceb3568353e640a6506b3aa8b6a.jpg
1_sabl,fold_9,16,11,11,0,-5,0043_jpg.rf.af436235ce1f5e4c84b661d4b30ac97f.jpg
1_sabl,fold_9,6,6,5,1,0,IMG_4102_JPG.rf.988b30b26acf51017cd5b3ff16762a2b.jpg
1_sabl,fold_9,5,4,4,0,-1,IMG_20230512_145425_638_jpg.rf.661f8dc69f407743144410705f4450c9.jpg
1_sabl,fold_9,14,3,2,1,-11,20230512_151015_jpg.rf.3c8da9af03482ee1020db88de8cd53f5.jpg
1_sabl,fold_9,6,4,4,0,-2,20230512_151814_jpg.rf.63e5823ef6a38da9206064b1975681af.jpg
1_sabl,fold_9,6,5,4,1,-1,20230512_151556_jpg.rf.e585c8603435630ba81c916c0f5e3ad0.jpg
1_sabl,fold_9,7,6,4,2,-1,20230512_150112_jpg.rf.91cd81f1887a38818d08e2f659a19d98.jpg
1_sabl,fold_9,6,5,5,0,-1,20230512_144948_jpg.rf.f0802f30adda8942f990e793b5836607.jpg
1_sabl,fold_9,1,1,1,0,0,20230512_145029_jpg.rf.d7839e9fea72e8e69ba8fd36d0e4fb46.jpg
1_sabl,fold_9,18,12,11,1,-6,IMG_3904_JPG.rf.bd3a38163bc8779f0e934e0ae4ddadcf.jpg
1_sabl,fold_9,1,2,2,0,1,IMG_20230512_153207_221_jpg.rf.1f2a32c755bbb2f6a4de873cb32a38fd.jpg
1_sabl,fold_9,6,3,3,0,-3,IMG_20230512_150226_jpg.rf.0f75578652c746be4186e389de366a0e.jpg
1_sabl,fold_9,2,0,0,0,-2,IMG_3906_JPG.rf.489fadb71a83983d81ed44a70d0060f4.jpg
1_sabl,fold_9,7,3,3,0,-4,20230512_150041_jpg.rf.77c6bf2c7e0b5d7af7cc6bad355e9df1.jpg
1_sabl,fold_9,1,1,1,0,0,0230512_145030_jpg.rf.6c6efdb679aaba04919e4f2fbe75cc41.jpg
1_sabl,fold_9,5,0,0,0,-5,230512_150321_jpg.rf.623a3367577becef7953f663a60a519b.jpg
1_sabl,fold_9,5,1,1,0,-4,MG_20230512_145134_jpg.rf.23612ad15c705c682dff7447cb294722.jpg
1_sabl,fold_9,27,3,2,1,-24,20230512_153521_jpg.rf.91f440ee7bd1d39009cef4ad201c6fc3.jpg
1_sabl,fold_9,0,3,0,3,3,IMG_4213_JPG.rf.778fa8d9b6925e2bc9f653dd198513f2.jpg
1_sabl,fold_9,6,5,5,0,-1,20230512_152211_jpg.rf.f8ab5359b2be0312cf7788fc199a7cfb.jpg
1_sabl,fold_9,3,1,1,0,-2,20230512_151750_jpg.rf.d25aa4eadcd0f88bad307f1be9834da7.jpg
1_sabl,fold_9,14,11,8,3,-3,IMG_20230512_145200_jpg.rf.071fa9592bc47982ce5ace6be3fc1cac.jpg
1_sabl,fold_9,11,6,4,2,-5,20230512_150021_jpg.rf.e7014c35e8c40fcb7fa7884ea70952ae.jpg
1_sabl,fold_9,15,1,0,1,-14,IMG_20230512_150047_070_jpg.rf.473b1fece6373583075f5a81e7cd25b1.jpg
1_sabl,fold_9,12,11,11,0,-1,IMG_20230512_152350_jpg.rf.e5327c93655bbe8c35427b0ce8c7c897.jpg
1_sabl,fold_9,7,7,6,1,0,20230512_153033_jpg.rf.02462baf8941d1800bd6cd7071ac2700.jpg
1_sabl,fold_9,5,3,3,0,-2,20230512_145350_jpg.rf.1ea30b4048e0f19948f3a1c49f936262.jpg
1_sabl,fold_9,20,0,0,0,-20,20230512_153245_jpg.rf.9c9fb8ddd3ba260eca53499188a58fd5.jpg
1_sabl,fold_9,2,1,1,0,-1,20230512_151451_jpg.rf.0a8434d6a9efa22ee048c8273b62b68d.jpg
1_sabl,fold_9,5,4,3,1,-1,20230512_151436_jpg.rf.554d34d9ea0ee09cf2c15f0b2df8ebb2.jpg
1_sabl,fold_9,6,5,5,0,-1,IMG_3910_JPG.rf.33d9bdf28a4dfeab746c5a00ebede622.jpg
1_sabl,fold_9,1,1,1,0,0,20230512_145422_jpg.rf.855806965c417ddd5e1b836f01dc61f4.jpg
1_sabl,fold_9,18,13,13,0,-5,IMG_4182_JPG.rf.9c42af3692f7bbaef5a89c980112be66.jpg
1_sabl,fold_9,2,1,1,0,-1,20230512_151553_jpg.rf.eb27fb285f9f9e115b16ae58308b4a33.jpg
1_sabl,fold_9,1,1,1,0,0,IMG_20230512_151942_jpg.rf.44e3a3ca4b79e01e3532e938c985d467.jpg
1_sabl,fold_9,1,0,0,0,-1,20230512_145026_jpg.rf.dbca47de186a8c26308fd5d82af2ccef.jpg
1_sabl,fold_9,8,4,3,1,-4,IMG_20230512_151456_jpg.rf.85840748681315fe5ab4e0d0318d07ef.jpg
1_sabl,fold_9,5,3,3,0,-2,20230512_145129_jpg.rf.5f78acb483122a7da1a71444f23c5e85.jpg
1_sabl,fold_9,3,2,2,0,-1,IMG_4049_JPG.rf.69a02eacb4e8dea786daf7ac53eff115.jpg
1_sabl,fold_9,3,2,1,1,-1,20230512_151128_jpg.rf.a8a2c544627fbc40d82ac1408de83acf.jpg
1_sabl,fold_9,1,1,1,0,0,0022_jpg.rf.392b7e000cd5e1b178fd42a324c62fa9.jpg
1_sabl,fold_9,17,12,10,2,-5,IMG_4214_JPG.rf.342cb36b8889ed055af6630becc0a92b.jpg
1_sabl,fold_9,4,2,2,0,-2,IMG_3992_JPG.rf.7e1e103b7399a2f459d53d6a310a7ee0.jpg
1_sabl,fold_9,23,17,16,1,-6,IMG_20230512_152955_591_jpg.rf.0aef108570178c062fc410980092f3ee.jpg
1_sabl,fold_9,32,15,14,1,-17,IMG_20230512_150325_jpg.rf.9a0b14f916539972a32ed40c795a77e2.jpg
1_sabl,fold_9,2,1,1,0,-1,20230512_150043_jpg.rf.c937683d3c7cefe87855391dceb56509.jpg
1_sabl,fold_9,3,2,2,0,-1,IMG_4038_JPG.rf.53f27c280fb9536f67b0f3bce749cded.jpg
1_sabl,fold_9,1,0,0,0,-1,IMG_4218_JPG.rf.776b234254cad41083ae7a7013512ded.jpg
1_sabl,fold_9,3,3,2,1,0,20230512_152323_jpg.rf.f87e4ec47644402832bf9ed280233bd6.jpg
1_sabl,fold_9,5,3,2,1,-2,20230512_151434_jpg.rf.6e770d46c3e9773c996335b4220cab85.jpg
1_sabl,fold_9,10,2,2,0,-8,0230512_145012_jpg.rf.0f087c91d690727635837b56dc1725f3.jpg
1_sabl,fold_9,1,0,0,0,-1,20230512_151257_jpg.rf.0a6cd5b01b2f5eb142626849e1aa59dd.jpg
1_sabl,fold_9,5,3,3,0,-2,IMG_20230512_151930_jpg.rf.b1cb9853e8645a3ba38d93ab637f6627.jpg
1_sabl,fold_9,14,6,6,0,-8,20230512_151038-0-_jpg.rf.b58c6345da65332e25d3fdda064694ee.jpg
1_sabl,fold_9,1,1,1,0,0,20230512_145221_jpg.rf.29bff38b4873d27c522654186744b290.jpg
1_sabl,fold_9,15,9,8,1,-6,IMG_20230512_152316_jpg.rf.7f4d2253d0ea3147244a7a36b4392e3c.jpg
1_sabl,fold_9,1,1,1,0,0,20230512_145046_jpg.rf.43cb9d49dc86e3ae870df966e6b2b7b1.jpg
1_sabl,fold_9,6,3,3,0,-3,IMG_20230512_151246_jpg.rf.0cb0203d04b163b091b29c2f755a7f65.jpg
1_sabl,fold_9,8,7,7,0,-1,20230512_150900_jpg.rf.7c05ba2842680f1a240b6f0a28f08dad.jpg
1_sabl,fold_9,1,1,1,0,0,20230512_151614_jpg.rf.ceb493d7d9f840a198a0413f2b423ce2.jpg
1_sabl,fold_9,1,1,1,0,0,IMG_20230512_151807_jpg.rf.c8207f2bdebe5ee316d9b9a0529d1efe.jpg
1_sabl,fold_9,3,3,3,0,0,20230512_153403_jpg.rf.90c6c42ac826af51ce764bcff3b6923f.jpg
1_sabl,fold_9,4,0,0,0,-4,IMG_20230512_145038_jpg.rf.3da21846aa05a88c16affc46ab268cfc.jpg
1_sabl,fold_9,12,7,6,1,-5,IMG_20230512_151433_jpg.rf.d9b4366826ebd2bd7917e1cb46c50ed4.jpg
1_sabl,fold_9,4,4,4,0,0,20230512_145336_jpg.rf.28de2a53875dce1e728e5a0c0cb97aad.jpg
1_sabl,fold_9,2,1,1,0,-1,20230512_145253_jpg.rf.c6fbf385d5f1b3ae20b0ef540f9e84b5.jpg
1_sabl,fold_9,19,8,8,0,-11,20230512_153250_jpg.rf.b3c0a5af0f8dd45ec4fe90ed8e62c274.jpg
1_sabl,fold_9,2,2,2,0,0,20230512_151637-0-_jpg.rf.57d42a7eaecae72323f8868de4088574.jpg
1_sabl,fold_9,5,4,4,0,-1,IMG_3982_JPG.rf.084073c997ce2761c02b36ef237261da.jpg
1_sabl,fold_9,2,0,0,0,-2,20230512_145050_jpg.rf.ae125a7aa3a0b2c6f41bc879a36698ce.jpg
1_sabl,fold_9,10,10,9,1,0,20230512_151905-0-_jpg.rf.270832f78fc4546ac9758205aad2a837.jpg
1_sabl,fold_9,2,3,1,2,1,20230512_150048_jpg.rf.bdbae272f798a54cd79cfc08bd2da41e.jpg
1_sabl,fold_9,13,8,4,4,-5,20230512_145159_jpg.rf.a9f2125d1fdfa80946c0b272e36cb621.jpg
1_sabl,fold_9,2,2,2,0,0,20230512_151541_jpg.rf.1a96f83831f9956a1c5cd8cb7987ee61.jpg
1_sabl,fold_9,1,0,0,0,-1,20230512_151118_jpg.rf.2bf6dd63d6a65371da02c372efde8ba3.jpg
1_sabl,fold_9,2,1,1,0,-1,IMG_3862_JPG.rf.a37466cc240bba5feaeef8019ddd0e55.jpg
1_sabl,fold_9,4,2,1,1,-2,IMG_3843_JPG.rf.3b04ef87c1af95cd756b57595eb39e72.jpg
1_sabl,fold_9,16,8,7,1,-8,IMG_20230512_145144_jpg.rf.4c14218fadac19f6b4d5270f23587de8.jpg
1_sabl,fold_9,2,2,2,0,0,20230512_151759_jpg.rf.04ce83457ca436da1fc767b75f695b6b.jpg
1_sabl,fold_9,1,2,1,1,1,IMG_20230512_145257_jpg.rf.453736b6f9bd9250f595d3afd851de1f.jpg
1_sabl,fold_9,2,0,0,0,-2,230512_150129_jpg.rf.10e62e193f0a96333642eeae2d068d57.jpg
1_sabl,fold_9,1,2,1,1,1,IMG_3932_JPG.rf.42e9d2a10f9734e5a4bc91d0d9eb642c.jpg
1_sabl,fold_9,63,10,7,3,-53,0512_150200_jpg.rf.8539b7a73e953ce0ea7f67784fcb2b58.jpg
1_sabl,fold_9,6,4,2,2,-2,IMG_20230512_145254_217_jpg.rf.4e2eb97449efdb3bab4662c35a288482.jpg
1_sabl,fold_9,4,1,0,1,-3,20230512_150253_jpg.rf.a852fcb9c971bcf0f4b4b6c07b3a1e7e.jpg
1_sabl,fold_9,15,8,8,0,-7,IMG_20230512_151900_jpg.rf.fad29398cd9611cef06c98d97c2dc00c.jpg
1_sabl,fold_9,1,0,0,0,-1,IMG_3840_JPG.rf.263bceb78886d3833883706e095d5293.jpg
1_sabl,fold_9,5,5,4,1,0,IMG_20230512_150955_jpg.rf.2011788cab5844089b8e6b7902ac846b.jpg
1_sabl,fold_9,2,1,1,0,-1,20230512_151440_jpg.rf.386c9f0ed80e964393660a1d9c01d9ed.jpg
1_sabl,fold_9,4,4,4,0,0,20230512_152247_jpg.rf.bdbffc243ed1383af5410f7bac53699a.jpg
1_sabl,fold_9,19,10,10,0,-9,20230512_152211_jpg.rf.c54aefeead1c1b68600e1ae65c10b527.jpg
1_sabl,fold_9,4,2,2,0,-2,20230512_152232_jpg.rf.01102a74dddfc813f9188dc90bff647f.jpg
1_sabl,fold_9,3,0,0,0,-3,IMG_20230512_151701_jpg.rf.0d3314dfd579b4e13828bb386bfee49b.jpg
1_sabl,fold_9,10,8,8,0,-2,IMG_20230512_152339_jpg.rf.4d50232667e59a45a8f02b1dc00c36ea.jpg
1_sabl,fold_9,5,6,5,1,1,IMG_20230512_153347_022_jpg.rf.eca10caf5bcd60d00f0f197496dabd1c.jpg
1_sabl,fold_9,12,13,11,2,1,IMG_20230512_152353_jpg.rf.74eba0461c089d0aea3691aee4afbac9.jpg
1_sabl,fold_9,2,1,1,0,-1,20230512_150825_jpg.rf.04725a59554eac4f344acef56d3fb6fe.jpg
1_sabl,fold_9,5,3,3,0,-2,20230512_151056_jpg.rf.3214ae92a59425896458690934fb5d39.jpg
1_sabl,fold_9,1,0,0,0,-1,230512_150046_jpg.rf.a453bfc60f25c0a831415acaf760061b.jpg
1_sabl,fold_9,6,3,3,0,-3,IMG_20230512_145419_jpg.rf.605cea1a83f727c0d545999a0d6e6e84.jpg
1_sabl,fold_9,24,10,8,2,-14,0512_150049_jpg.rf.4c2d31120db48096f79c8d147d016509.jpg
1_sabl,fold_9,1,0,0,0,-1,0052_jpg.rf.11b9f0f1317ccd80a627cd52e3e7c819.jpg
1_sabl,fold_9,4,1,1,0,-3,230512_150113_jpg.rf.491cf8e16672678e5500d8eb3e1bc404.jpg
1_sabl,fold_9,11,6,6,0,-5,20230512_145204_jpg.rf.c52942b0bcdcd04cafca718031f2ab26.jpg
1_sabl,fold_9,2,1,1,0,-1,IMG_20230512_150931_jpg.rf.2ce16e755fe6e9b894d7d449fafbd463.jpg
1_sabl,fold_9,1,1,1,0,0,20230512_145348_jpg.rf.a9486de8293f423be4b7c903a6adf9d6.jpg
1_sabl,fold_9,1,1,1,0,0,20230512_151644_jpg.rf.3bb96898f1cf4f86f3720f45fe4a4ce1.jpg
1_sabl,fold_9,3,2,2,0,-1,IMG_4093_JPG.rf.ebedb6000fb84b714cc74fef511c31aa.jpg
1_sabl,fold_9,4,1,1,0,-3,20230512_145002_jpg.rf.97109db1b99cc660d69da24c9747f303.jpg
1_sabl,fold_9,2,1,1,0,-1,20230512_151640_jpg.rf.f22b10e3e5f15d07706b85eb0b969f91.jpg
1_sabl,fold_9,2,2,2,0,0,20230512_151631_jpg.rf.4e69595c48be79bb26b1487f3e19266e.jpg
1_sabl,fold_9,6,5,5,0,-1,20230512_153330_jpg.rf.462ae2c6301c8971d155ebb9a3378c36.jpg
1_sabl,fold_9,8,7,5,2,-1,IMG_4189_JPG.rf.ef51bea3fc4ec3eb14a9abaa4902f277.jpg
1_sabl,fold_9,21,14,12,2,-7,20230512_150126_jpg.rf.fa9718948fbb766a50fee0608d280d14.jpg
1_sabl,fold_9,37,23,23,0,-14,IMG_20230512_153238_678_jpg.rf.9b33a9187212479d779bf15d553e8efc.jpg
1_sabl,fold_9,2,0,0,0,-2,IMG_4219_JPG.rf.81654d924a576c094f3f57b813e83fa9.jpg
1_sabl,fold_9,6,5,4,1,-1,IMG_20230512_153107_jpg.rf.1ec84b2b739232a85f9ad467ee8a214f.jpg
1_sabl,fold_10,14,0,0,0,-14,IMG_20230512_150109_804_jpg.rf.e638755720658c18627b68883d0270d6.jpg
1_sabl,fold_10,13,10,10,0,-3,IMG_4205_JPG.rf.e6945a0f8c8342f636251e46e904f729.jpg
1_sabl,fold_10,1,0,0,0,-1,IMG_20230512_145046_815_jpg.rf.bccba2de087b0c29681bdd4ff7c199f1.jpg
1_sabl,fold_10,12,10,10,0,-2,20230512_153030_jpg.rf.447a01796d662b57a717346a6885bdc7.jpg
1_sabl,fold_10,29,12,11,1,-17,20230512_153308_jpg.rf.1f2393c128a7608a2a6b40892e5c576d.jpg
1_sabl,fold_10,21,3,3,0,-18,20230512_150151_jpg.rf.73a61752872f6ef725371184031d1666.jpg
1_sabl,fold_10,1,1,1,0,0,20230512_151711_jpg.rf.10c1db788e52a7dfc81744f4936a3ef0.jpg
1_sabl,fold_10,5,5,5,0,0,20230512_152341_jpg.rf.67a7bff5a653064d0fbb2dfa8b1f90ce.jpg
1_sabl,fold_10,1,1,1,0,0,20230512_150750_jpg.rf.e86dd1819063fd640c2ba43c41a741f8.jpg
1_sabl,fold_10,10,2,2,0,-8,IMG_20230512_145121_jpg.rf.690688dd9055bfc063e326aa4fef07f4.jpg
1_sabl,fold_10,3,4,3,1,1,20230512_152340_jpg.rf.cfcfb6148dee3cdf12d6d85f1d247895.jpg
1_sabl,fold_10,5,5,5,0,0,20230512_152235_jpg.rf.08f40afdb24635f6dcfbb88615a2f9f7.jpg
1_sabl,fold_10,9,6,6,0,-3,20230512_152302_jpg.rf.6925e24fe61ef38107dc845cce1a2d60.jpg
1_sabl,fold_10,1,2,1,1,1,IMG_20230512_151207_jpg.rf.ae49ac5f1949da487c30a4f4ba31817b.jpg
1_sabl,fold_10,16,2,2,0,-14,20230512_150011_jpg.rf.1da3e5f3e295949ab4854def4bdbd922.jpg
1_sabl,fold_10,3,1,1,0,-2,IMG_20230512_145025_jpg.rf.c0282883e0ec5ffed07135f0bda0ecfa.jpg
1_sabl,fold_10,4,4,4,0,0,20230512_151843_jpg.rf.b93560c5fdb00199587ea962c11d4103.jpg
1_sabl,fold_10,4,1,0,1,-3,20230512_145326_jpg.rf.e57a46b969b04ee9d16c309181d71fe7.jpg
1_sabl,fold_10,1,0,0,0,-1,20230512_153428_jpg.rf.ebef48003f439c4f546df0dab6aff50b.jpg
1_sabl,fold_10,23,7,5,2,-16,IMG_20230512_150120_jpg.rf.4b23fdc5feb46ad8a31de385747c52bc.jpg
1_sabl,fold_10,4,3,3,0,-1,IMG_3990_JPG.rf.7d3c75f1558f8f5fc9ac7eb6789e10dc.jpg
1_sabl,fold_10,8,6,5,1,-2,20230512_150819_jpg.rf.d1513f98969bc1b7ac4e870d3cdb41e6.jpg
1_sabl,fold_10,12,4,4,0,-8,20230512_151038_jpg.rf.6caba5860602aa931872edf19ec2b6c5.jpg
1_sabl,fold_10,1,0,0,0,-1,IMG_20230512_145146_354_jpg.rf.6de83b52b9e3abba9866d24be95f4c4d.jpg
1_sabl,fold_10,7,3,3,0,-4,IMG_4190_JPG.rf.7081f39db6690560b3a2bdd4cbc00d86.jpg
1_sabl,fold_10,3,2,2,0,-1,IMG_20230512_145252_021_jpg.rf.1779d92134a07ec7f57f4438113bb031.jpg
1_sabl,fold_10,12,2,2,0,-10,230512_150135_jpg.rf.cc24c1ff5e0e940d16df6a7b71d2eabd.jpg
1_sabl,fold_10,5,3,3,0,-2,IMG_20230512_151042_jpg.rf.15dee8949138ef80373228e81079c023.jpg
1_sabl,fold_10,6,4,3,1,-2,IMG_20230512_151950_jpg.rf.c8c0371384e1a2262fdd3d8a53e11fa3.jpg
1_sabl,fold_10,1,1,1,0,0,IMG_20230512_151703_jpg.rf.28a7fdeaae4d54d7cf2de4be9ed4df40.jpg
1_sabl,fold_10,11,2,2,0,-9,20230512_150147_jpg.rf.55aa66e580136cb844b6c51dff5d3fed.jpg
1_sabl,fold_10,37,5,5,0,-32,20230512_150235_jpg.rf.4361e97cfeccf708272ffe4ece69dbfd.jpg
1_sabl,fold_10,2,1,1,0,-1,IMG_20230512_144940_500_jpg.rf.75e33e87c9ad9b74dd1e4b3091ba269f.jpg
1_sabl,fold_10,5,2,2,0,-3,20230512_145410_jpg.rf.56000063a0c914b346f9cd7261abac1e.jpg
1_sabl,fold_10,1,1,1,0,0,IMG_4033_JPG.rf.d1e341639e4e7d193425664e20325a4c.jpg
1_sabl,fold_10,14,1,0,1,-13,IMG_20230512_150125_134_jpg.rf.88679af4628e0ef4675fe385a333d31c.jpg
1_sabl,fold_10,13,10,10,0,-3,20230512_151904_jpg.rf.7f72f44e41b8a58e5db1391fa2b35a42.jpg
1_sabl,fold_10,2,1,1,0,-1,20230512_151841-0-_jpg.rf.601490af90bd9514d0d590298e1f0255.jpg
1_sabl,fold_10,5,3,3,0,-2,20230512_145357_jpg.rf.90422bd2b26f6dd0bd566293b4b30bb5.jpg
1_sabl,fold_10,9,6,6,0,-3,IMG_20230512_151951_jpg.rf.31e79520ea845227f969872a61796113.jpg
1_sabl,fold_10,1,1,1,0,0,20230512_151646_jpg.rf.6320d2328bf6de098fff781bcffac0cb.jpg
1_sabl,fold_10,20,3,3,0,-17,IMG_3903_JPG.rf.7c248f88ef915e14444c5c43dc048c82.jpg
1_sabl,fold_10,3,2,2,0,-1,IMG_20230512_151830_jpg.rf.c0f3338eb7af1f0e178971c38c7dec04.jpg
1_sabl,fold_10,9,1,0,1,-8,IMG_20230512_144958_jpg.rf.0a6117e6c2ebbfabe543484d7a8056db.jpg
1_sabl,fold_10,4,4,4,0,0,IMG_4095_JPG.rf.58645f8fad94bdb38886e47695cfd8cd.jpg
1_sabl,fold_10,4,3,3,0,-1,20230512_152345_jpg.rf.2717f971fd14976a3492abb509e947cb.jpg
1_sabl,fold_10,2,1,1,0,-1,IMG_3920_JPG.rf.24878eeb02230840f60014978ff530d7.jpg
1_sabl,fold_10,9,2,2,0,-7,IMG_20230512_150046_jpg.rf.6e840be1f4fa3a56d132b04b6e288480.jpg
1_sabl,fold_10,9,3,3,0,-6,IMG_20230512_145258_jpg.rf.a062df356e44019699d3c53596d3540e.jpg
1_sabl,fold_10,1,1,1,0,0,IMG_20230512_161348_jpg.rf.aea1bf3794b2d077c45245810c001a1c.jpg
1_sabl,fold_10,8,5,4,1,-3,230512_150139_jpg.rf.2d8a8d2ed426f1cb21935b033da8b2f6.jpg
1_sabl,fold_10,14,10,10,0,-4,IMG_20230512_151610_001_jpg.rf.88fda6a270dac232937c53d6188fa5a9.jpg
1_sabl,fold_10,1,0,0,0,-1,230512_145108_jpg.rf.cf20720f57cffcf1f9fa31cecfe67fbf.jpg
1_sabl,fold_10,1,0,0,0,-1,IMG_3857_JPG.rf.c98e2825881d870a7242c7271763f36b.jpg
1_sabl,fold_10,4,0,0,0,-4,20230512_151024_jpg.rf.a0cfadc35d426648ee3656824927c11e.jpg
1_sabl,fold_10,1,1,1,0,0,0036_jpg.rf.6d90090548975dc2e489ef2ff1546863.jpg
1_sabl,fold_10,2,1,1,0,-1,20230512_152306_jpg.rf.a7141e38fe1a72a82a763e55d71fd0b5.jpg
1_sabl,fold_10,15,4,4,0,-11,20230512_150018_jpg.rf.3bc690cd3af7d48b107dc3a68930fc2f.jpg
1_sabl,fold_10,7,6,5,1,-1,IMG_20230512_151112_jpg.rf.6600a13c525e7d830908b03b8a0d3526.jpg
1_sabl,fold_10,14,13,13,0,-1,0057_jpg.rf.850f7a1e0cc045be1a9326878338232a.jpg
1_sabl,fold_10,7,7,7,0,0,0051_jpg.rf.e81d23e22a72795f3bbc83a62bd65cae.jpg
1_sabl,fold_10,4,4,4,0,0,0006_jpg.rf.ea818ccdacee9dd00131e372a19cf0d0.jpg
1_sabl,fold_10,22,5,5,0,-17,20230512_150013_jpg.rf.88f9a3a7e9a79d06352d99a9a40fcfb5.jpg
1_sabl,fold_10,1,1,1,0,0,IMG_20230512_151605_jpg.rf.cd36cb9aab7833e1d827ed72719f9742.jpg
1_sabl,fold_10,7,1,0,1,-6,20230512_150940_jpg.rf.a642f28b441714d9d9e22de0ad22f124.jpg
1_sabl,fold_10,24,5,5,0,-19,0512_150306_jpg.rf.b16cedf3571182816f46e3a952d5c39a.jpg
1_sabl,fold_10,3,2,2,0,-1,20230512_152308_jpg.rf.f4dc38f04cbc5fd664dec02e3ed16103.jpg
1_sabl,fold_10,2,2,2,0,0,IMG_20230512_151812_jpg.rf.86425b9d53f765e1b77d6eba211405fe.jpg
1_sabl,fold_10,12,7,7,0,-5,20230512_152316_jpg.rf.dd8d1d54a326eb9ed9a63bc5520eadad.jpg
1_sabl,fold_10,2,2,2,0,0,20230512_152213_jpg.rf.1125dc3c4a87888cb65b2d513aa9df85.jpg
1_sabl,fold_10,17,4,3,1,-13,IMG_20230512_150147_169_jpg.rf.df6bd6535b4bdd11e20a358e10a11c09.jpg
1_sabl,fold_10,10,8,8,0,-2,IMG_4100_JPG.rf.f55f9f2afb5f41daaa63474d6df30725.jpg
1_sabl,fold_10,23,13,12,1,-10,IMG_20230512_153004_jpg.rf.19c27a824e3c2f07149751bcaaa47c7f.jpg
1_sabl,fold_10,1,1,1,0,0,20230512_151648_jpg.rf.f5ddd2e522a504da5dc723bdc2dec390.jpg
1_sabl,fold_10,2,3,1,2,1,0005_jpg.rf.79044c26eeb52526a25a3f38e1aa840d.jpg
1_sabl,fold_10,4,0,0,0,-4,IMG_20230512_145001_113_jpg.rf.5ea2af9825ef6b6ebe2436d89dbe79ca.jpg
1_sabl,fold_10,1,0,0,0,-1,IMG_4183_JPG.rf.1c0ab4bee811c122c1ef5f9131477050.jpg
1_sabl,fold_10,2,1,0,1,-1,20230512_151124_jpg.rf.250cebbf32ee5a6ab788e62fd50ecf2c.jpg
1_sabl,fold_10,3,1,0,1,-2,IMG_4022_JPG.rf.e15de99fae6d1e74eb63284f3616a75f.jpg
1_sabl,fold_10,7,6,6,0,-1,20230512_152319_jpg.rf.abeccdd8fbdc8f18e24c3acdf6c07d48.jpg
1_sabl,fold_10,25,7,5,2,-18,IMG_3911_JPG.rf.1bb0ec60809450d49cc43c3d8a1265de.jpg
1_sabl,fold_10,6,8,5,3,2,20230512_151418_jpg.rf.90e438577c310e46b8a21f2ae0b85242.jpg
1_sabl,fold_10,9,6,5,1,-3,20230512_153311_jpg.rf.3ecbca1f6ffb06d59119f6627139da8a.jpg
1_sabl,fold_10,5,2,1,1,-3,20230512_150206_jpg.rf.8ae1878e1b65e9920f1a99af4f941d9c.jpg
1_sabl,fold_10,3,2,1,1,-1,IMG_4389_JPG.rf.d64ad350bc28019aa4851039e73dfdfa.jpg
1_sabl,fold_10,10,1,1,0,-9,0512_150317_jpg.rf.a70fbe5816d46c9fa83979febbeb753f.jpg
1_sabl,fold_10,7,4,4,0,-3,20230512_145440_jpg.rf.faac237167337f22dcbfb3879916747e.jpg
1_sabl,fold_10,14,5,4,1,-9,20230512_150138_jpg.rf.baad1e97bbf234f37489ac66f024a808.jpg
1_sabl,fold_10,12,2,2,0,-10,20230512_150159_jpg.rf.15a7a075343358e808fef60d09b7b8c3.jpg
1_sabl,fold_10,2,0,0,0,-2,IMG_20230512_151004_jpg.rf.fa632ed53260b0c0873743bd4155a490.jpg
1_sabl,fold_10,6,4,4,0,-2,IMG_20230512_151929_jpg.rf.8916d2cec0ed6feba243725d4795cee6.jpg
1_sabl,fold_10,6,2,2,0,-4,20230512_150108_jpg.rf.114d86f5dc5d95e4469bf960bc7c0a4f.jpg
1_sabl,fold_10,10,7,7,0,-3,0014_jpg.rf.69fba8cc80a5714926e6841f224baffc.jpg
1_sabl,fold_10,1,1,1,0,0,IMG_20230512_145359_479_jpg.rf.6b65f34991508137d8d33789257462e4.jpg
1_sabl,fold_10,5,3,2,1,-2,MG_20230512_145100_jpg.rf.2fac7875b124670b96ab0a3b253f2e29.jpg
1_sabl,fold_10,6,6,5,1,0,20230512_151747_jpg.rf.f2ca78e158d0f2965152169425291a5a.jpg
1_sabl,fold_10,9,1,1,0,-8,230512_150154_jpg.rf.6b065a843e8b776c3731c23f8a875399.jpg
1_sabl,fold_10,1,0,0,0,-1,20230512_145117_jpg.rf.1ad15540d0fbbd6bac016639ff1c07a3.jpg
1_sabl,fold_10,4,4,3,1,0,20230512_145248_jpg.rf.8a3953be78b4c9d70df1b12fd15d4939.jpg
1_sabl,fold_10,2,1,1,0,-1,IMG_3836_JPG.rf.434cd50ae74cfc4c9d1e3085a73a905b.jpg
1_sabl,fold_10,8,6,5,1,-2,20230512_150949_jpg.rf.81b6e460185cb992a26ccccb5e72b394.jpg
1_sabl,fold_10,11,10,10,0,-1,IMG_20230512_152452_jpg.rf.849169ae208c086f88f01686f87e3c82.jpg
1_sabl,fold_10,12,10,10,0,-2,IMG_aaaa_jpg.rf.6f8cea923b21b011dca38cdc115eaf80.jpg
1_sabl,fold_10,1,0,0,0,-1,IMG_20230512_145313_jpg.rf.3ae2ff3ddf2bb75af26203bf8cca362c.jpg
1_sabl,fold_10,14,8,8,0,-6,IMG_20230512_151605_536_jpg.rf.39cf087a8f42f961dca0c0caa4dfa17d.jpg
1_sabl,fold_10,8,5,5,0,-3,20230512_145342_jpg.rf.b956dcb9a2579c2e8f754353e1d00c75.jpg
1_sabl,fold_10,8,5,5,0,-3,IMG_4193_JPG.rf.ee7ebd7c653b26c381990c2e3f69556f.jpg
1_sabl,fold_10,5,2,2,0,-3,IMG_20230512_151457_jpg.rf.49e2e6a56131fab5a439e78b087a3b8a.jpg
1_sabl,fold_10,1,1,1,0,0,20230512_145224_jpg.rf.b8204cbb29051890879b714634f912b6.jpg
1_sabl,fold_10,11,9,8,1,-2,IMG_20230512_152257_409_jpg.rf.8463210402c73719c09f0b2210f7cfb4.jpg
1_sabl,fold_10,16,9,8,1,-7,20230512_152313_jpg.rf.cae2b30990ff4679b62bdf438fbd8044.jpg
1_sabl,fold_10,1,0,0,0,-1,0230512_145347_jpg.rf.58a6f73f43efb9705bb2978f49927337.jpg
1_sabl,fold_10,9,9,9,0,0,0034_jpg.rf.d4c6d4e1816e57648e3dbb1782385073.jpg
1_sabl,fold_10,2,0,0,0,-2,IMG_20230512_151611_jpg.rf.b44877740f7dd0dc052351bbded2044b.jpg
1_sabl,fold_10,17,1,1,0,-16,230512_150149_jpg.rf.b74d07f3292d3144d25facf3dde243dc.jpg
1_sabl,fold_10,59,14,1,13,-45,IMG_20230512_153218_jpg.rf.cac514c0d5c15fe1628359a5bfa2dacb.jpg
1_sabl,fold_10,6,3,1,2,-3,IMG_20230512_145054_075_jpg.rf.5e98b15c8a4633098064286c64be239e.jpg
1_sabl,fold_10,5,0,0,0,-5,IMG_20230512_151259_jpg.rf.7b57c2547bbd877ef1243a2ab325c2fa.jpg
1_sabl,fold_10,70,5,5,0,-65,20230512_153220_jpg.rf.660dfd8464712797760cfa3b49fef4e7.jpg
1_sabl,fold_10,9,2,2,0,-7,IMG_4186_JPG.rf.c6b51e615ccecf25291d4d3bd703172a.jpg
1_sabl,fold_10,4,0,0,0,-4,20230512_144950_jpg.rf.b105c1ba7257a4da1b17c9f42de1770a.jpg
1_sabl,fold_10,9,5,5,0,-4,IMG_20230512_145304_jpg.rf.7de02525de42506dbd7eda7365fd0065.jpg
1_sabl,fold_10,4,3,3,0,-1,20230512_145209_jpg.rf.c73d398c69a90599525e2c2a8cb51f2c.jpg
1_sabl,fold_10,3,3,3,0,0,20230512_151741_jpg.rf.989b1ddb73b99e41bd2bddfcf1c60e1d.jpg
1_sabl,fold_10,2,1,1,0,-1,20230512_152209_jpg.rf.c79a1a42b4846b485a9b00d575fb1626.jpg
1_sabl,fold_10,17,10,9,1,-7,20230512_152258_jpg.rf.485967412d3788c1a657a3be4d77671e.jpg
1_sabl,fold_10,2,2,2,0,0,IMG_20230512_151818_jpg.rf.593796b492f80d2ddd3e0449eec86414.jpg
1_sabl,fold_10,1,0,0,0,-1,20230512_145110_jpg.rf.02ac7002fe460313bbf3d2c9d99f8ba7.jpg
1_sabl,fold_10,4,2,2,0,-2,IMG_3907_JPG.rf.b1def63b2acf54c44c0c502aca5f4d44.jpg
1_sabl,fold_10,1,1,1,0,0,20230512_150722_jpg.rf.811e652f271c46d6a3e10299f1a6b7d9.jpg
1_sabl,fold_10,1,0,0,0,-1,20230512_145243_jpg.rf.6f06c25acca67180648bf428a474f0b3.jpg
1_sabl,fold_10,2,2,2,0,0,20230512_145053_jpg.rf.dd5c06f85a2f9673d635a3b60256df27.jpg
1_sabl,fold_10,1,1,1,0,0,IMG_20230512_151236_jpg.rf.697c89d65f7f53a2cf18544c923eb896.jpg
1_sabl,fold_10,1,1,1,0,0,0230512_145425_jpg.rf.f4fcff283a6f3d5ea4f0275a52a87728.jpg
1_sabl,fold_10,24,11,11,0,-13,0001_jpg.rf.0c630bace393ba8970fa7c3c8fd7c235.jpg
1_sabl,fold_10,8,7,7,0,-1,20230512_152317_jpg.rf.fddebbf7fe2a035df51e17bb0c14e2b4.jpg
1_sabl,fold_10,9,1,1,0,-8,IMG_4209_JPG.rf.093053ef31116bcee7646b801c678d5b.jpg
1_sabl,fold_10,23,5,5,0,-18,20230512_150122_jpg.rf.cb6d477ccda3127b4d473101af503eb3.jpg
1_sabl,fold_10,4,4,4,0,0,20230512_152326_jpg.rf.8ca5737543dbfcb717b333d32cc18f8b.jpg
1_sabl,fold_10,1,1,0,1,0,20230512_145056_jpg.rf.2bbf028730f3b9804aa416234c6db613.jpg
1_sabl,fold_10,6,6,6,0,0,0037_jpg.rf.e51421425c8718d498a1cc958bfeeb2b.jpg
1_sabl,fold_10,10,7,6,1,-3,IMG_20230512_153400_jpg.rf.5f42ce4759cb794127f4f23098e0ff58.jpg
1_sabl,fold_10,8,7,7,0,-1,20230512_151848_jpg.rf.2c6000bd3b3f3ae44c8e672b08aec3b5.jpg
1_sabl,fold_10,23,0,0,0,-23,IMG_20230512_153450_jpg.rf.af0e93ea32d0b17c0b616de937189066.jpg
1_sabl,fold_10,3,3,3,0,0,IMG_3921_JPG.rf.e8186af83ff3af27612213a05a7c5177.jpg
1_sabl,fold_10,10,6,6,0,-4,IMG_20230512_145056_jpg.rf.340c9781ae519c2a173e9014c5be4072.jpg
1_sabl,fold_10,5,0,0,0,-5,20230512_145001_jpg.rf.ac3499ee309bec2035194be16f5da378.jpg
1_sabl,fold_10,1,0,0,0,-1,20230512_145104_jpg.rf.a25f0f63e3b58e348bedb4aa97e67394.jpg
1_sabl,fold_10,38,3,2,1,-35,0512_150303_jpg.rf.54131a2e7501a146e0d64448ccb7d595.jpg
1_sabl,fold_10,1,0,0,0,-1,20230512_145308_jpg.rf.692ac823c338ea1cdf326339c51eb5b1.jpg
1_sabl,fold_10,7,5,5,0,-2,0060_jpg.rf.a0b1380ab0b6548c6335a9f12bb9f9f5.jpg
1_sabl,fold_10,1,1,1,0,0,IMG_20230512_150846_jpg.rf.f9a1c340f4f40ffecf79883a50c53a30.jpg
1_sabl,fold_10,11,10,10,0,-1,20230512_151902_jpg.rf.0d916693ef179e70195af9fd22402789.jpg
1_sabl,fold_10,13,2,0,2,-11,IMG_4211_JPG.rf.76ca0821ebf56f29d1009eb9ff45a384.jpg
1_sabl,fold_10,10,9,7,2,-1,IMG_20230512_153020_jpg.rf.e9080cc66a8631a1e9e4e610e61bc6a4.jpg
1_sabl,fold_10,14,9,8,1,-5,20230512_153059_jpg.rf.48d36662c46f21f6e2c61dbaa81b1253.jpg
1_sabl,fold_10,6,4,3,1,-2,IMG_20230512_145113_jpg.rf.0828a4e83c0458a5f8bc5967b29e1db1.jpg
1_sabl,fold_10,1,1,1,0,0,20230512_145418_jpg.rf.8af049af1c5b2eb413647f320a119a74.jpg
2_fovea,fold_1,2,0,0,0,-2,20230512_153003_jpg.rf.3e11918b7e073ed9642c3d889f82a10b.jpg
2_fovea,fold_1,3,1,1,0,-2,20230512_152344_jpg.rf.9cdeba0a7faf9c91db6a1bec355cd79f.jpg
2_fovea,fold_1,8,1,1,0,-7,20230512_150202_jpg.rf.2d354a6afba7660a4bdb4422aacb0bf1.jpg
2_fovea,fold_1,2,2,1,1,0,20230512_151842_jpg.rf.0400a2b89be930a6aee77dd6416cc317.jpg
2_fovea,fold_1,1,0,0,0,-1,20230512_153001_jpg.rf.9e1933e066ac83bf9fbd01b8def6158d.jpg
2_fovea,fold_1,6,3,3,0,-3,IMG_4052_JPG.rf.a484ba8b08f647c9d706f26a2c1bdd88.jpg
2_fovea,fold_1,1,0,0,0,-1,IMG_3933_JPG.rf.b0d6e8cf999e8234386ed5bb6107f61a.jpg
2_fovea,fold_1,23,1,1,0,-22,20230512_153423_jpg.rf.199d17397bc75e4b3c997992a9469adb.jpg
2_fovea,fold_1,1,0,0,0,-1,230512_150115_jpg.rf.048aa47fa124320a4fa8a5c30506622b.jpg
2_fovea,fold_1,8,6,6,0,-2,20230512_152239_jpg.rf.5270f7fe5715e9e4db1967390d36c76d.jpg
2_fovea,fold_1,7,3,3,0,-4,IMG_20230512_152358_jpg.rf.14382fa8e1d185e8ecd9b6b625021b8f.jpg
2_fovea,fold_1,1,1,1,0,0,20230512_151657_jpg.rf.ae916e776287bd8044bda6da1e1dec7e.jpg
2_fovea,fold_1,2,0,0,0,-2,IMG_4202_JPG.rf.389eb0baa38b2b42b82e272dae53dd7b.jpg
2_fovea,fold_1,10,0,0,0,-10,20230512_150031_jpg.rf.5b7cf141f46aecb85b2c9e4f6977aa4c.jpg
2_fovea,fold_1,4,0,0,0,-4,IMG_20230512_151251_jpg.rf.13115516a78a5324e008f7864789fbec.jpg
2_fovea,fold_1,17,0,0,0,-17,20230512_150005_jpg.rf.77d140d77f3f48953c783c2d50e6f910.jpg
2_fovea,fold_1,1,0,0,0,-1,20230512_150058_jpg.rf.daa9ab4c09a0e2a557b1e8bb54702ecb.jpg
2_fovea,fold_1,6,2,2,0,-4,20230512_152201_jpg.rf.3c9e01b2433736fc6ee290b90dd42684.jpg
2_fovea,fold_1,6,0,0,0,-6,IMG_20230512_151219_jpg.rf.6d76721a015ae20af4047ec2607a62e0.jpg
2_fovea,fold_1,19,3,3,0,-16,IMG_20230512_150136_jpg.rf.004497d9e0b84ae3cd5c8e7e5e9f30d7.jpg
2_fovea,fold_1,32,7,6,1,-25,0008_jpg.rf.94e89ad01289e8cfda380621151bf1bb.jpg
2_fovea,fold_1,1,1,0,1,0,IMG_4027_JPG.rf.02fde7996d0a3e63cd8727ba35b98fbd.jpg
2_fovea,fold_1,7,2,2,0,-5,IMG_4051_JPG.rf.1f19a2adfb075e1a7c5d3d9567879ae2.jpg
2_fovea,fold_1,3,1,1,0,-2,IMG_20230512_145126_jpg.rf.0493bac7dcca35f2a361df2325097b88.jpg
2_fovea,fold_1,4,0,0,0,-4,0004_jpg.rf.7a14cc5ff08b5ee1437266474bc51865.jpg
2_fovea,fold_1,1,0,0,0,-1,20230512_151446_jpg.rf.801ee52ac482b80a6b7e2c7a7a896dc7.jpg
2_fovea,fold_1,1,0,0,0,-1,20230512_153217_jpg.rf.3d66bba80f697d614260fc56dd593486.jpg
2_fovea,fold_1,23,2,0,2,-21,20230512_150312_jpg.rf.2040a566a6e8aa7d77563942d16e3907.jpg
2_fovea,fold_1,4,0,0,0,-4,20230512_153409_jpg.rf.b9be0a0b5dc71b17d03a58db2af65fd3.jpg
2_fovea,fold_1,1,0,0,0,-1,20230512_145140_jpg.rf.3d71f74b4ed8a93a636f79ef1a9a7e9c.jpg
2_fovea,fold_1,7,3,1,2,-4,0002_jpg.rf.d16d3de92655da222f9470322637f0a1.jpg
2_fovea,fold_1,2,0,0,0,-2,IMG_20230512_153111_jpg.rf.71fdfa6f08329e5d2412e86bf6870b02.jpg
2_fovea,fold_1,3,0,0,0,-3,IMG_20230512_151306_jpg.rf.e4b348fae9b8d16d80a5be211e9e39a1.jpg
2_fovea,fold_1,7,0,0,0,-7,20230512_150132_jpg.rf.b204b63d3e3f8ef2920b32f1e0b6ab50.jpg
2_fovea,fold_1,3,0,0,0,-3,IMG_20230512_151314_jpg.rf.231b8a97bc932aa622a2b27c80ee878b.jpg
2_fovea,fold_1,1,1,1,0,0,20230512_145419_jpg.rf.cf9776dd6ff86988e3d4a8734ba6f15c.jpg
2_fovea,fold_1,1,0,0,0,-1,IMG_20230512_161355_jpg.rf.f1c1af37db10bfc139da92a922fa83a2.jpg
2_fovea,fold_1,1,1,1,0,0,IMG_20230512_151815_jpg.rf.fad6e45cfa5e7c506e9fbad254cef9e0.jpg
2_fovea,fold_1,6,0,0,0,-6,IMG_3922_JPG.rf.4fa3ab6d4b090dd6a9114495e5b5a468.jpg
2_fovea,fold_1,37,8,6,2,-29,IMG_20230512_150214_jpg.rf.0a3e70748a25dbc7ca5305e84da8d3cd.jpg
2_fovea,fold_1,5,1,1,0,-4,20230512_152251_jpg.rf.ebcf28d3c9a35107daa9beb28ae3475b.jpg
2_fovea,fold_1,2,0,0,0,-2,20230512_151110_jpg.rf.53961421a4e7bd7511e281309a72a2c9.jpg
2_fovea,fold_1,2,1,1,0,-1,20230512_151630_jpg.rf.ecc81d9067cb1ce5be1c14f9a6d71d9d.jpg
2_fovea,fold_1,11,0,0,0,-11,IMG_20230512_145044_jpg.rf.d79716a7705a23a496d5d4896dbcf506.jpg
2_fovea,fold_1,1,0,0,0,-1,20230512_145031_jpg.rf.0c829f489393188e9f1ecc0ff78d8324.jpg
2_fovea,fold_1,1,0,0,0,-1,20230512_151712_jpg.rf.c494c6b379e948f9f084efcd40c0619d.jpg
2_fovea,fold_1,13,5,5,0,-8,20230512_153109_jpg.rf.930610a4b0e78acb8ed778e44b9d5922.jpg
2_fovea,fold_1,4,1,1,0,-3,IMG_20230512_151205_jpg.rf.2bbe055a56edab8e820150d32613da40.jpg
2_fovea,fold_1,2,0,0,0,-2,20230512_150059-0-_jpg.rf.641cecd96312dfe886a8bf287b5916db.jpg
2_fovea,fold_1,2,1,1,0,-1,20230512_145234_jpg.rf.d7e55e93d9f98a6de3d20ef7221babc8.jpg
2_fovea,fold_1,4,1,1,0,-3,IMG_20230512_145359_jpg.rf.c0fb243e34926596f7a71595884ae8c5.jpg
2_fovea,fold_1,6,2,1,1,-4,20230512_145334_jpg.rf.0b72b785a7b59d3a4217025c7e5a2423.jpg
2_fovea,fold_1,10,6,6,0,-4,20230512_152402_jpg.rf.2af7283a541e5a9a5150707a47c4be20.jpg
2_fovea,fold_1,2,1,1,0,-1,20230512_145352_jpg.rf.c846cb3c36e5363cfaa577a44b6913d8.jpg
2_fovea,fold_1,23,3,3,0,-20,20230512_150226_jpg.rf.f79017b16f1532730f31cb325d6ab86e.jpg
2_fovea,fold_1,1,0,0,0,-1,20230512_153345-0-_jpg.rf.6e0b5b843ebfea1138cb759960e1bafc.jpg
2_fovea,fold_1,2,0,0,0,-2,0036_jpg.rf.95bf6e3cde891a0e422157eafa8da143.jpg
2_fovea,fold_1,1,0,0,0,-1,20230512_150121_jpg.rf.b7f710edf2464cb4724d24c65bae04b4.jpg
2_fovea,fold_1,1,1,0,1,0,20230512_150720_jpg.rf.a18892cc876f35236d2a20ba37b6efd8.jpg
2_fovea,fold_1,13,3,2,1,-10,20230512_153007_jpg.rf.d3b0e4362c8dc7fde7b007165efdd07e.jpg
2_fovea,fold_1,1,1,0,1,0,20230512_144958_jpg.rf.bd51a27225a9ddf5ef21b54512e10b9b.jpg
2_fovea,fold_1,2,0,0,0,-2,20230512_151201_jpg.rf.003d9f32250e51b928c51a05b230f55a.jpg
2_fovea,fold_1,5,0,0,0,-5,IMG_20230512_145247_597_jpg.rf.464f6c3eb3265be95f2f08e2d0bdd91a.jpg
2_fovea,fold_1,8,3,3,0,-5,20230512_152159_jpg.rf.f9d372b7fdee9c83d543f19d83accc75.jpg
2_fovea,fold_1,17,2,2,0,-15,IMG_20230512_150133_jpg.rf.e1213a79a5060e17585ebc484a3c63d6.jpg
2_fovea,fold_1,4,0,0,0,-4,20230512_145007_jpg.rf.b9641853c4144bc1d5622b022182ed4b.jpg
2_fovea,fold_1,1,0,0,0,-1,IMG_20230512_145057_967_jpg.rf.680792c5520fea6605bcf774a290cd8f.jpg
2_fovea,fold_1,2,1,1,0,-1,20230512_151633_jpg.rf.a660ff615450152ab9fbed4d02eeb6d7.jpg
2_fovea,fold_1,8,3,3,0,-5,IMG_4090_JPG.rf.677923e65dcfcc46588eee4c2c2c9e46.jpg
2_fovea,fold_1,10,6,6,0,-4,20230512_152258_jpg.rf.2e43ef7a91920046b900730064da408d.jpg
2_fovea,fold_1,18,9,9,0,-9,20230512_152402_jpg.rf.5f60c1b7e4703f63b61c50a74049302f.jpg
2_fovea,fold_1,4,0,0,0,-4,20230512_151121_jpg.rf.d9f5fd5a912436d588c2e8a3681b8643.jpg
2_fovea,fold_1,15,7,7,0,-8,20230512_152310_jpg.rf.22fd13a135de99870e2b9f19a9dbd566.jpg
2_fovea,fold_1,15,5,5,0,-10,IMG_4206_JPG.rf.86dc764134fcaa91fd5246c96808ba7a.jpg
2_fovea,fold_1,1,0,0,0,-1,20230512_145233_jpg.rf.9e2d494cc8579c52d6794c0fb5af14b7.jpg
2_fovea,fold_1,1,0,0,0,-1,IMG_4014_JPG.rf.67af8816872a56054c245e272bdd23db.jpg
2_fovea,fold_1,11,9,9,0,-2,IMG_20230512_151956_jpg.rf.accb7456b90404e99398a8475aa5f074.jpg
2_fovea,fold_1,5,4,4,0,-1,20230512_152221_jpg.rf.dfe82842e573d8a1a7ff0d4519256b1d.jpg
2_fovea,fold_1,35,0,0,0,-35,0512_150052_jpg.rf.6838fe76e0e5f7752c388cea428a676b.jpg
2_fovea,fold_1,3,1,0,1,-2,IMG_20230512_150949_jpg.rf.0a7b1aca0bc2e95e7b33b4409d5f03e1.jpg
2_fovea,fold_1,5,3,2,1,-2,20230512_145412_jpg.rf.9224a9f695664a7b936da6fb81af36c9.jpg
2_fovea,fold_1,10,6,6,0,-4,20230512_151907_jpg.rf.8b3da1939d33aa65bfb85cb4ba33d685.jpg
2_fovea,fold_1,1,0,0,0,-1,20230512_151037_jpg.rf.57044d376bf29efab4142e6e059723d3.jpg
2_fovea,fold_1,1,0,0,0,-1,20230512_151510-0-_jpg.rf.8fdff95c003658062d05e4285948dcbb.jpg
2_fovea,fold_1,10,6,6,0,-4,20230512_151857_jpg.rf.d5917286f02e07a5305d7b858c6244ec.jpg
2_fovea,fold_1,2,1,1,0,-1,IMG_20230512_151822_jpg.rf.cd5ee7cbb4e275377fc3e1ca11bd6a01.jpg
2_fovea,fold_1,18,7,7,0,-11,20230512_152223_jpg.rf.7b4c9b6ebd76c6c1084f1453a97610d9.jpg
2_fovea,fold_1,2,1,1,0,-1,0015_jpg.rf.a767e21c0a0684765afe242b8052602a.jpg
2_fovea,fold_1,2,0,0,0,-2,IMG_20230512_145027_jpg.rf.16a85daab3bfea64be4f44d4de24d8b4.jpg
2_fovea,fold_1,2,1,0,1,-1,IMG_20230512_145337_jpg.rf.04c6c7ecd50fc9cd76f28da038eea12a.jpg
2_fovea,fold_1,4,1,0,1,-3,20230512_145119_jpg.rf.f0411939c238246ea7d83cb97f4b291a.jpg
2_fovea,fold_1,1,1,1,0,0,20230512_151618_jpg.rf.9cfdd92f0dd263ec71adc25e0966b10d.jpg
2_fovea,fold_1,21,0,0,0,-21,20230512_150123_jpg.rf.ca38530fba79c2eea723776f3cb9701e.jpg
2_fovea,fold_1,8,5,5,0,-3,IMG_20230512_151954_jpg.rf.1f74638dd64a022c7ddbc6b607ebb63f.jpg
2_fovea,fold_1,2,0,0,0,-2,20230512_153358_jpg.rf.000b91eaf995cb7029bac19a97ae0eab.jpg
2_fovea,fold_1,3,1,1,0,-2,0030_jpg.rf.92e747a4b264c12a0f5bd7b7fff47c97.jpg
2_fovea,fold_1,2,1,1,0,-1,IMG_3838_JPG.rf.6259d7b6f664061333ba70518ffa409a.jpg
2_fovea,fold_1,47,3,0,3,-44,20230512_153205_jpg.rf.a397edfe98870b927aac7d426225215e.jpg
2_fovea,fold_1,3,0,0,0,-3,20230512_151421_jpg.rf.32f90f849ffd68e483c8af1c30cd3e88.jpg
2_fovea,fold_1,4,0,0,0,-4,20230512_150228_jpg.rf.bdef78abc0510427f86904d310db4ffe.jpg
2_fovea,fold_1,1,0,0,0,-1,20230512_150729_jpg.rf.8d31acfa9500f54af8d12c1ddbddbd65.jpg
2_fovea,fold_1,1,0,0,0,-1,IMG_4221_JPG.rf.c34edb7d27501d2bebad754740f2c36d.jpg
2_fovea,fold_1,91,9,2,7,-82,20230512_153222_jpg.rf.02d4e5f1788464607b60d200b123696a.jpg
2_fovea,fold_1,15,10,10,0,-5,20230512_152343_jpg.rf.b78ec2e1eb5a82ab22cb447b29e60a37.jpg
2_fovea,fold_1,4,2,2,0,-2,20230512_145420_jpg.rf.63f8530ad3e9147d791de1d4a62e2845.jpg
2_fovea,fold_1,3,1,1,0,-2,IMG_20230512_145129_jpg.rf.7c57fcf634dd12adb9bd6bfb5ab72307.jpg
2_fovea,fold_1,3,2,2,0,-1,IMG_20230512_152950_jpg.rf.7b0419faa0e6c3e396abcf1d3db70ba2.jpg
2_fovea,fold_1,7,4,2,2,-3,IMG_20230512_145458_jpg.rf.0869453997d27a12e193c3576f5be50f.jpg
2_fovea,fold_1,2,0,0,0,-2,20230512_150320_jpg.rf.f00816162e753a50c482ccbb2723a8bb.jpg
2_fovea,fold_1,2,0,0,0,-2,20230512_151501-0-_jpg.rf.ac937acab812f79dd846ec10e9eb794f.jpg
2_fovea,fold_1,4,2,2,0,-2,IMG_20230512_151857_jpg.rf.f3b0a248067ce9c5df43e8eb1b7b8f48.jpg
2_fovea,fold_1,1,0,0,0,-1,20230512_151507_jpg.rf.83b7b0f7341f0c68f2169ab2e25d50af.jpg
2_fovea,fold_1,4,2,2,0,-2,IMG_4098_JPG.rf.d05c322cd8fa2c89a0d093e8e91666a2.jpg
2_fovea,fold_1,5,0,0,0,-5,IMG_20230512_144938_jpg.rf.61fbc5c9c8be89bcb4b1529921428829.jpg
2_fovea,fold_1,9,6,6,0,-3,20230512_152348_jpg.rf.9a9f308e6e3d3ff1b666f67b5196d238.jpg
2_fovea,fold_1,2,0,0,0,-2,20230512_151131_jpg.rf.62d78c2e91ff2133e0623bbd8de03bda.jpg
2_fovea,fold_1,1,0,0,0,-1,IMG_20230512_150905_jpg.rf.498fdb5cdf1e78cfffa9005586c25d1b.jpg
2_fovea,fold_1,1,0,0,0,-1,20230512_145033_jpg.rf.5a4b7044f38311bf91bd61b2107f6208.jpg
2_fovea,fold_1,2,0,0,0,-2,0002_jpg.rf.244244e268805e9279e2778f66f93c67.jpg
2_fovea,fold_1,9,3,3,0,-6,IMG_20230512_145357_jpg.rf.65481eda27afaba20ecf66958bd1a415.jpg
2_fovea,fold_1,40,11,11,0,-29,IMG_20230512_150251_jpg.rf.2318a91c9b0a0d0c74b337b923e9e074.jpg
2_fovea,fold_1,4,3,1,2,-1,IMG_20230512_145134_jpg.rf.084766d54cd58d09cacfc92914a1a5c7.jpg
2_fovea,fold_1,9,7,6,1,-2,IMG_20230512_152000_jpg.rf.af9cbaac286010743e1eabfda3ff16fd.jpg
2_fovea,fold_1,3,1,0,1,-2,20230512_145302_jpg.rf.52f6bff4360f5a174eb1a21d91490e2f.jpg
2_fovea,fold_1,4,1,1,0,-3,0013_jpg.rf.46c0cfad5d61b22f1717205aab02e682.jpg
2_fovea,fold_1,13,4,2,2,-9,20230512_152958_jpg.rf.43cafd5762e96ebdaf2638b5e2e5ede5.jpg
2_fovea,fold_1,1,0,0,0,-1,IMG_20230512_145002_jpg.rf.a16310bc3cbd1bce46d8e207260f6d2f.jpg
2_fovea,fold_1,20,3,3,0,-17,20230512_150157_jpg.rf.8b6ad4dda7ad6b93ac57bd92f16dcdcd.jpg
2_fovea,fold_1,6,4,1,3,-2,IMG_20230512_144908_684_jpg.rf.89a536225f1a283e12d5bb8970ee31cb.jpg
2_fovea,fold_1,2,0,0,0,-2,20230512_151455_jpg.rf.eb853c4caca8daef122f54e54ffa44ce.jpg
2_fovea,fold_1,3,1,1,0,-2,IMG_20230512_151214_jpg.rf.885e6d5e144fd3b97b6ab96da191a928.jpg
2_fovea,fold_1,2,2,2,0,0,20230512_151744_jpg.rf.b461e1fdf32cd5c1232cf11220a2bef4.jpg
2_fovea,fold_1,7,2,2,0,-5,IMG_3868_JPG.rf.1770b3eda4aaec864f7cf0d27d04888b.jpg
2_fovea,fold_1,7,4,4,0,-3,20230512_151845_jpg.rf.8dee8031c86ff6697d6d671e32b55f55.jpg
2_fovea,fold_1,17,0,0,0,-17,20230512_150009_jpg.rf.5eaca93499ee2328bb5b204bc086fa0e.jpg
2_fovea,fold_1,4,0,0,0,-4,IMG_4055_JPG.rf.a1d3f9eab20829bc4aab9b5d5b3db316.jpg
2_fovea,fold_1,3,0,0,0,-3,20230512_145429_jpg.rf.df99f30a99cc1af30b8fe3054ff8d8af.jpg
2_fovea,fold_1,3,1,0,1,-2,IMG_20230512_150829_549_jpg.rf.017095633151bc8caa1cad24d2d1f6bd.jpg
2_fovea,fold_1,10,0,0,0,-10,0230512_150206_jpg.rf.e404633a283ca64c43725aeb3181ac5b.jpg
2_fovea,fold_1,1,1,1,0,0,20230512_145044_jpg.rf.2dd273c7dcfa2783f4fc1f356c3e0fe1.jpg
2_fovea,fold_1,18,4,4,0,-14,IMG_20230512_153031_jpg.rf.5fce0e233ead5453574fecd0d970a691.jpg
2_fovea,fold_1,3,0,0,0,-3,IMG_4197_JPG.rf.f240386fc9d9d286399404892833ad93.jpg
2_fovea,fold_1,2,0,0,0,-2,MG_20230512_145132_jpg.rf.f7010b407a0b401d833ccbcf5807b8c7.jpg
2_fovea,fold_1,15,0,0,0,-15,20230512_151046_jpg.rf.8feca45b0b1694e2250d447c5e17a7e5.jpg
2_fovea,fold_1,21,1,1,0,-20,20230512_153045_jpg.rf.8ee689d2bb2062ede3d6c1a97a93cb0b.jpg
2_fovea,fold_1,2,0,0,0,-2,0024_jpg.rf.d7ace9e90a7a9b7f0bac8fa590936bec.jpg
2_fovea,fold_1,1,0,0,0,-1,20230512_151452_jpg.rf.f764099c780fa1069a9d911e32493b58.jpg
2_fovea,fold_1,2,2,2,0,0,0040_jpg.rf.510a2eea8b97902d00189cee85d647f2.jpg
2_fovea,fold_1,14,2,1,1,-12,IMG_20230512_144941_jpg.rf.26b2e56c21b9d1f982031b1a6c82b0cf.jpg
2_fovea,fold_1,6,3,3,0,-3,0230512_145304_jpg.rf.923a0f42aba114205181e2b5316865df.jpg
2_fovea,fold_1,14,1,0,1,-13,20230512_153445_jpg.rf.a406add89c229073e8dc9da3e87a1125.jpg
2_fovea,fold_1,11,2,1,1,-9,IMG_20230512_144945_690_jpg.rf.8f6c97bc8ba7a4170c6509fdaf6dcb51.jpg
2_fovea,fold_1,3,0,0,0,-3,20230512_150255_jpg.rf.06d14e4c4625afe9d0a55233a17ba81c.jpg
2_fovea,fold_1,1,1,1,0,0,20230512_145220_jpg.rf.9fc82d7b84c8883df1efc1dd7d51252b.jpg
2_fovea,fold_1,8,0,0,0,-8,IMG_20230512_151110_jpg.rf.43411da66d27f6993f2c94b13a408a1c.jpg
2_fovea,fold_1,1,0,0,0,-1,IMG_20230512_151305_326_jpg.rf.11e52599cf79be602d4d4480bd5cddda.jpg
2_fovea,fold_1,2,0,0,0,-2,0230512_145048_jpg.rf.17eaa837f3d144d8a30470f44f61f75d.jpg
2_fovea,fold_2,11,7,6,1,-4,20230512_152307_jpg.rf.5ed444510318293300b04fc766ce4222.jpg
2_fovea,fold_2,1,0,0,0,-1,20230512_144953_jpg.rf.8283a702fcffd9d6223570436e1bf3fa.jpg
2_fovea,fold_2,6,3,3,0,-3,20230512_145403_jpg.rf.8df05cb3790b7b04d25d1e08e98dc443.jpg
2_fovea,fold_2,5,2,2,0,-3,20230512_145345_jpg.rf.04a7df632b86568b244790bc2612f409.jpg
2_fovea,fold_2,1,1,1,0,0,IMG_20230512_151805_jpg.rf.394aa2e3fd7a17a935ec0df1f3258c2f.jpg
2_fovea,fold_2,1,0,0,0,-1,20230512_151500_jpg.rf.e32b98c8b02b5d583e07193899344442.jpg
2_fovea,fold_2,2,2,2,0,0,0230512_145313_jpg.rf.776dc937578790f899ad676b7712df5d.jpg
2_fovea,fold_2,1,1,0,1,0,20230512_145047_jpg.rf.95f8311e427ec6f1226783bcfa8aaeb0.jpg
2_fovea,fold_2,17,11,10,1,-6,IMG_20230512_152302_jpg.rf.e72dde5d8164d8312cbc60cf674ac1cc.jpg
2_fovea,fold_2,3,2,1,1,-1,20230512_145143_jpg.rf.e512219fc0a6a155cdc8d6e5375509c0.jpg
2_fovea,fold_2,17,5,5,0,-12,20230512_153128_jpg.rf.ea6f913ebe278f58559dcfc65c663e1e.jpg
2_fovea,fold_2,1,1,1,0,0,20230512_151801_jpg.rf.2c3c8c1015e6fae6858f400374255844.jpg
2_fovea,fold_2,2,2,0,2,0,IMG_20230512_150319_jpg.rf.3ae187984f18f173dbb37b3a87dc2edc.jpg
2_fovea,fold_2,2,1,1,0,-1,IMG_20230512_145035_jpg.rf.e406d6ea6e2142bf078dc5712097970d.jpg
2_fovea,fold_2,11,1,1,0,-10,20230512_151045_jpg.rf.a6671c33872e0aa76aa195da177cfb2d.jpg
2_fovea,fold_2,6,3,0,3,-3,20230512_153159_jpg.rf.d07176029cb6d818c3ec89f10bf105eb.jpg
2_fovea,fold_2,2,1,0,1,-1,20230512_145258_jpg.rf.36afe6d426851a363b2a6a7d0c059a06.jpg
2_fovea,fold_2,9,5,4,1,-4,0230512_145016_jpg.rf.c06fc10372ac7c1831d2d51452a8b3e8.jpg
2_fovea,fold_2,5,0,0,0,-5,20230512_151002_jpg.rf.948c61535288e6ba60980bb8fd2b67a6.jpg
2_fovea,fold_2,5,0,0,0,-5,IMG_20230512_150036_jpg.rf.6e167fde12f866a555cb292420cc966c.jpg
2_fovea,fold_2,21,11,10,1,-10,IMG_20230512_150108_jpg.rf.010507bacbd8da808ace5e119e09b182.jpg
2_fovea,fold_2,1,1,0,1,0,IMG_20230512_151210_354_jpg.rf.8bd99e3d531a171119a6ce1f73298053.jpg
2_fovea,fold_2,16,7,7,0,-9,0058_jpg.rf.0a179a6a2aa1a22cf6d0c2490fc3cca2.jpg
2_fovea,fold_2,2,0,0,0,-2,20230512_150805_jpg.rf.c936fd2cb76b51c90f6b1886c1d67b07.jpg
2_fovea,fold_2,38,14,11,3,-24,0512_150128_jpg.rf.2af323c722a16ccc0c5aa34b5e501664.jpg
2_fovea,fold_2,7,3,3,0,-4,20230512_150107_jpg.rf.5e11723e84aa6da5755cf3c63cf34d7e.jpg
2_fovea,fold_2,5,2,0,2,-3,IMG_20230512_152210_460_jpg.rf.ab8278e1877e151e4ae555c6237762a4.jpg
2_fovea,fold_2,1,0,0,0,-1,IMG_20230512_161352_jpg.rf.55bade867ee284f39237788ac06b0acc.jpg
2_fovea,fold_2,1,1,0,1,0,IMG_3833_JPG.rf.abe8bed2e2a60f385c89c035ed2e7754.jpg
2_fovea,fold_2,4,1,1,0,-3,20230512_145400_jpg.rf.487d472b7875668199199822410b27fa.jpg
2_fovea,fold_2,3,2,2,0,-1,0006_jpg.rf.4286dc69c06dcdbaf0df817343256a21.jpg
2_fovea,fold_2,4,3,3,0,-1,20230512_151752_jpg.rf.c6abd13d3824e552c45d2ae43cd156c3.jpg
2_fovea,fold_2,6,4,4,0,-2,20230512_145358_jpg.rf.42f74f37b3baefb9f8cb08628d322a69.jpg
2_fovea,fold_2,1,1,1,0,0,0230512_145420_jpg.rf.e077901cc39df12e7031754a04b4216f.jpg
2_fovea,fold_2,2,0,0,0,-2,20230512_151441_jpg.rf.01b614d64de666a58fed8b8feea9004a.jpg
2_fovea,fold_2,12,2,1,1,-10,20230512_153315_jpg.rf.7906c060598957a1e622c50902191cc1.jpg
2_fovea,fold_2,4,2,1,1,-2,0025_jpg.rf.f5d46a7f5f498531cada47eed608a3e7.jpg
2_fovea,fold_2,6,3,3,0,-3,IMG_3832_JPG.rf.4a27d40741e9e24a57b4d4409e5bf699.jpg
2_fovea,fold_2,4,4,3,1,0,IMG_20230512_145422_423_jpg.rf.a2f634b682eede423e27173c65e298dc.jpg
2_fovea,fold_2,3,2,1,1,-1,IMG_20230512_145034_jpg.rf.b7070d4f3b8615f07e606e417094950b.jpg
2_fovea,fold_2,6,5,4,1,-1,20230512_151810-0-_jpg.rf.5bab122233efd5d6e060c2de01ae9475.jpg
2_fovea,fold_2,1,1,1,0,0,20230512_151649_jpg.rf.62f6a7ef7962197e1933352c3cf07e1d.jpg
2_fovea,fold_2,5,3,2,1,-2,20230512_151315_jpg.rf.7d9aa1fa6aeea9c557900122bb89076d.jpg
2_fovea,fold_2,1,0,0,0,-1,230512_150043_jpg.rf.997b92cbbb33f969daf86ff1c0a48495.jpg
2_fovea,fold_2,18,5,5,0,-13,IMG_4215_JPG.rf.f586481a5ed49d1952135b51b94a258f.jpg
2_fovea,fold_2,15,11,10,1,-4,IMG_20230512_152253_596_jpg.rf.e1455dadb47781b4e95ce4f0479c4643.jpg
2_fovea,fold_2,18,1,0,1,-17,IMG_20230512_150056_181_jpg.rf.337f1b254575b10ba95ca7a5b1e7e5aa.jpg
2_fovea,fold_2,13,2,2,0,-11,20230512_150029_jpg.rf.29ca99ad8a2b5956fdc7e21d1601c79f.jpg
2_fovea,fold_2,1,0,0,0,-1,20230512_145239_jpg.rf.0d14eff09fc5186a9eccb0c477759e6b.jpg
2_fovea,fold_2,20,9,9,0,-11,20230512_153255_jpg.rf.72d8abd35f45fdaa52da9b99aa3daf48.jpg
2_fovea,fold_2,24,19,17,2,-5,0106_jpg.rf.ea3d3d53b74e632d3112cfd4b25da4de.jpg
2_fovea,fold_2,2,1,1,0,-1,0230512_145006_jpg.rf.eb1d6247f79c4ed2e093c5fcaf73e407.jpg
2_fovea,fold_2,4,2,1,1,-2,IMG_20230512_145316_jpg.rf.250aaba6ef305223c5dec100c738233c.jpg
2_fovea,fold_2,11,8,3,5,-3,20230512_145205_jpg.rf.8be964bf86f6306b95645b3e8b4177aa.jpg
2_fovea,fold_2,2,0,0,0,-2,20230512_145125_jpg.rf.c0d2af11ce72a4bb0c259d23b2700862.jpg
2_fovea,fold_2,5,4,4,0,-1,20230512_151810_jpg.rf.b4a391d3bd61afb0cff6f47e49a1736e.jpg
2_fovea,fold_2,8,2,2,0,-6,IMG_20230512_151240_jpg.rf.21dc1955fc3611fdbde01fb2d3db23e3.jpg
2_fovea,fold_2,1,1,0,1,0,IMG_20230512_151233_jpg.rf.75f4efffa9f2c8ddf8c60930c30caa50.jpg
2_fovea,fold_2,2,0,0,0,-2,20230512_145245_jpg.rf.23b906c05c2822f1a0f5a97d26511473.jpg
2_fovea,fold_2,5,3,3,0,-2,20230512_145335-0-_jpg.rf.e11b1b03b49524f5174370062e01b4f7.jpg
2_fovea,fold_2,25,3,3,0,-22,IMG_20230512_150137_686_jpg.rf.87a512bdf05b800f446ab29f4925d265.jpg
2_fovea,fold_2,2,2,1,1,0,IMG_3837_JPG.rf.6f942021a4fd687376ae5b9b4d970b40.jpg
2_fovea,fold_2,17,7,7,0,-10,20230512_144951_jpg.rf.9ab67b54e372e2d5fcc0ba78e49718cf.jpg
2_fovea,fold_2,1,0,0,0,-1,20230512_153216_jpg.rf.eb0c9677e99c15c65103ae3a612d52d8.jpg
2_fovea,fold_2,16,12,10,2,-4,20230512_144957_jpg.rf.edf44bd7d8feadfc28a3389bd946b805.jpg
2_fovea,fold_2,3,2,1,1,-1,IMG_20230512_145032_jpg.rf.d9c71446c077191b543ca5691d58f022.jpg
2_fovea,fold_2,40,8,7,1,-32,20230512_150324_jpg.rf.3ff2950eb65ac5c31086e53bc4e56ed5.jpg
2_fovea,fold_2,1,1,1,0,0,20230512_151651-0-_jpg.rf.b824f35100b3f7edb1d2a6095c5dfaa2.jpg
2_fovea,fold_2,23,8,8,0,-15,20230512_153141_jpg.rf.613e5b5025183f2520937d9596cdd56a.jpg
2_fovea,fold_2,1,0,0,0,-1,IMG_3846_JPG.rf.6ac47067db06f4b0377dc758d0af3e6e.jpg
2_fovea,fold_2,13,5,5,0,-8,IMG_20230512_145059_jpg.rf.ca7ed19e9dee72856eedaac64c143c22.jpg
2_fovea,fold_2,7,1,1,0,-6,20230512_150118_jpg.rf.995a1787a6672b3228e543351c485407.jpg
2_fovea,fold_2,29,7,6,1,-22,20230512_150102_jpg.rf.992c8db88e8e711f38b63308f2f2ceb0.jpg
2_fovea,fold_2,1,0,0,0,-1,IMG_20230512_153419_jpg.rf.9224e0b2559139217bdba3afdc04378c.jpg
2_fovea,fold_2,13,1,0,1,-12,20230512_153022_jpg.rf.863e7532bc45f9f8755c15b6a24dda83.jpg
2_fovea,fold_2,59,12,11,1,-47,20230512_153358_jpg.rf.97d1a8ba190dcaf1d26753099c80dac6.jpg
2_fovea,fold_2,3,3,1,2,0,20230512_145406_jpg.rf.b6c696ca3ffd7789f8655f344c1ccd98.jpg
2_fovea,fold_2,3,1,1,0,-2,IMG_4387_JPG.rf.3205816644d251fe12961d17cfe8b818.jpg
2_fovea,fold_2,10,3,0,3,-7,20230512_150020_jpg.rf.6a0dfe027260521f3168f7985b48272f.jpg
2_fovea,fold_2,1,1,1,0,0,0011_jpg.rf.ef78555de2ee0947227176b9c9b4319b.jpg
2_fovea,fold_2,10,6,5,1,-4,20230512_150229_jpg.rf.db8357bef31fe081f8e5059cfd0c9fb4.jpg
2_fovea,fold_2,2,2,2,0,0,20230512_151743_jpg.rf.6203480990e7a828e8c8e3f743a0053b.jpg
2_fovea,fold_2,6,5,3,2,-1,20230512_145157_jpg.rf.459cfae5642460c5c30e67dd372cadcc.jpg
2_fovea,fold_2,2,0,0,0,-2,20230512_145122_jpg.rf.f302914da7ccad75fb2edfd9b9ec0efd.jpg
2_fovea,fold_2,13,7,6,1,-6,IMG_20230512_145118_jpg.rf.d1ef05f6a7704db2945116a966e5bd70.jpg
2_fovea,fold_2,6,2,0,2,-4,20230512_153037_jpg.rf.b93a210f722c0d5464f223e099ec3dce.jpg
2_fovea,fold_2,3,0,0,0,-3,20230512_150758_jpg.rf.8a907872529b09fec41c34fbc4a3c85b.jpg
2_fovea,fold_2,3,1,0,1,-2,20230512_145126_jpg.rf.76790ff28fba433b2868c3becc799204.jpg
2_fovea,fold_2,111,14,5,9,-97,0105_jpg.rf.21f79c1f08ac725f3eafce77e52091e8.jpg
2_fovea,fold_2,3,1,1,0,-2,20230512_145438_jpg.rf.c1caee1e341cc9a711b6cf640a2a8509.jpg
2_fovea,fold_2,4,3,2,1,-1,IMG_20230512_145346_jpg.rf.515d73a420cc0607f0a677c3ec22ea14.jpg
2_fovea,fold_2,4,0,0,0,-4,20230512_145144_jpg.rf.f15cd7a8e403d35924c9a9953ceb0ed2.jpg
2_fovea,fold_2,11,1,0,1,-10,20230512_150030_jpg.rf.6f76526d3409cadbfe960092b45d99ff.jpg
2_fovea,fold_2,14,4,3,1,-10,20230512_151050_jpg.rf.bb1678e3a1546f2d4b401bf96df99936.jpg
2_fovea,fold_2,1,1,1,0,0,230512_150038_jpg.rf.9ebbdcccc679c75c9dceb5b2e686d104.jpg
2_fovea,fold_2,8,6,6,0,-2,20230512_151748_jpg.rf.fdcf266c293fa03554fecbec46885bcf.jpg
2_fovea,fold_2,4,0,0,0,-4,20230512_145131_jpg.rf.05acfd31fb743167b9795df743ef22b4.jpg
2_fovea,fold_2,5,5,4,1,0,IMG_20230512_150030_jpg.rf.eb7e32ee807e4ad675ec4b1f485d1194.jpg
2_fovea,fold_2,3,3,3,0,0,20230512_151026-copia-1-_jpg.rf.25048c6b13b3d64d8a468f548967f5d4.jpg
2_fovea,fold_2,1,0,0,0,-1,IMG_4042_JPG.rf.3b0722af6ff7f5abfc5b80296e0e51a4.jpg
2_fovea,fold_2,1,0,0,0,-1,0230512_145106_jpg.rf.f11d7922f45bb3e9056a0274e877bd6f.jpg
2_fovea,fold_2,4,3,0,3,-1,20230512_145152_jpg.rf.c078905785bf4f39e87ab4dbfeb67b79.jpg
2_fovea,fold_2,2,1,1,0,-1,IMG_20230512_151751_jpg.rf.86507ee6252cc7d41c2fa99c5f84bbc9.jpg
2_fovea,fold_2,8,6,4,2,-2,20230512_145155_jpg.rf.483609701afa99b05a432395c2a1dc59.jpg
2_fovea,fold_2,1,0,0,0,-1,20230512_151501_jpg.rf.16af334ffaad29022c4afa8eda4bbb5b.jpg
2_fovea,fold_2,4,0,0,0,-4,20230512_150208_jpg.rf.5e82906cb9373103e9e98ed6a4338a1e.jpg
2_fovea,fold_2,2,3,2,1,1,20230512_151704_jpg.rf.fd83532c35f591e140a380aa12cd8530.jpg
2_fovea,fold_2,4,2,2,0,-2,0230512_145310_jpg.rf.58da36115ae6f33dda807758d87657c9.jpg
2_fovea,fold_2,8,3,3,0,-5,20230512_145134_jpg.rf.5d0f231790df81ba4a0051d2b6752135.jpg
2_fovea,fold_2,4,2,2,0,-2,20230512_150055_jpg.rf.4cc48b2b47552b6368afa5d3491ee008.jpg
2_fovea,fold_2,19,15,13,2,-4,IMG_20230512_150053_jpg.rf.0df30dcd2353d3b9fb7a7df012361881.jpg
2_fovea,fold_2,10,5,5,0,-5,20230512_152215_jpg.rf.a4d9425dfde22fcd54004debebaf80ce.jpg
2_fovea,fold_2,6,4,2,2,-2,20230512_145408_jpg.rf.3d8eeed18535cb95a6e8d1931052f34c.jpg
2_fovea,fold_2,8,1,1,0,-7,20230512_152941_jpg.rf.a2201e1690ef639f51bfe7ce95cec221.jpg
2_fovea,fold_2,3,3,3,0,0,20230512_151306_jpg.rf.cfe45d7efb4a4c29beccc71f36871b48.jpg
2_fovea,fold_2,1,1,1,0,0,IMG_20230512_151234_jpg.rf.b19f52712286d372282ee90e4f3a8c24.jpg
2_fovea,fold_2,6,2,2,0,-4,IMG_20230512_145136_jpg.rf.a268e723779ce1a1a30472767d3788c0.jpg
2_fovea,fold_2,4,1,0,1,-3,20230512_145405_jpg.rf.583b8e88a9d9542c857773d30f074199.jpg
2_fovea,fold_2,1,1,1,0,0,20230512_151808_jpg.rf.88493c8cb7d1ddd67bcbdd48f290be76.jpg
2_fovea,fold_2,2,3,2,1,1,IMG_20230512_151255_jpg.rf.085333bc247d4e08cfef9873bd98d250.jpg
2_fovea,fold_2,14,9,4,5,-5,20230512_145200_jpg.rf.a6508f9b4a5dc4d2e37a648f6f58cad7.jpg
2_fovea,fold_2,5,4,1,3,-1,IMG_20230512_150153_jpg.rf.21455b2b84261cf0a3ce6dd9147d31c2.jpg
2_fovea,fold_2,9,6,6,0,-3,0230512_145438_jpg.rf.8d0faa32dac3b0a8d27ae1876a0db052.jpg
2_fovea,fold_2,1,0,0,0,-1,20230512_145023_jpg.rf.b2955fd5ab715016af10f2efa47feb0c.jpg
2_fovea,fold_2,4,0,0,0,-4,IMG_3986_JPG.rf.5f1e1a04a780c294057b3aeb49ce1327.jpg
2_fovea,fold_2,2,2,2,0,0,20230512_151639_jpg.rf.2e5a4b318c40ab84158ba5ef4ab1ae75.jpg
2_fovea,fold_2,2,2,1,1,0,0010_jpg.rf.5d4cbd2e216fb4306b05f3a979d801a6.jpg
2_fovea,fold_2,61,4,0,4,-57,20230512_153154_jpg.rf.8e0789e24006a0265466d9bf9fdd2d5d.jpg
2_fovea,fold_2,3,0,0,0,-3,IMG_3866_JPG.rf.9976a97a1422b88843b54c8cfe8f8cef.jpg
2_fovea,fold_2,2,0,0,0,-2,20230512_145123_jpg.rf.7c684cfce69e0678a5f37aceb8e58703.jpg
2_fovea,fold_2,2,2,2,0,0,20230512_151634_jpg.rf.4af8920897c95556710f5d66b8848580.jpg
2_fovea,fold_2,1,1,1,0,0,20230512_151253_jpg.rf.b5e989a50a5c70e0f8911ebb246c4bd9.jpg
2_fovea,fold_2,6,4,3,1,-2,20230512_153108_jpg.rf.d3d27e961d217f62f45c29eec6d6c2ed.jpg
2_fovea,fold_2,31,10,9,1,-21,0512_150045_jpg.rf.097128a0f4dc3739d053c017dd7fd643.jpg
2_fovea,fold_2,2,2,2,0,0,20230512_145217_jpg.rf.8b4c9e235361be21ec1ef0addc99dc7a.jpg
2_fovea,fold_2,13,1,0,1,-12,20230512_153057_jpg.rf.4d29da76e8c70adbe3707715c3333882.jpg
2_fovea,fold_2,1,1,1,0,0,20230512_145040_jpg.rf.c652c89ab18a37e582fa39fe9f7abdc6.jpg
2_fovea,fold_2,10,7,7,0,-3,IMG_20230512_145100_jpg.rf.e7b035adf2c640d6a600846236b01b19.jpg
2_fovea,fold_2,1,1,1,0,0,20230512_151458_jpg.rf.44033d4e267440e0172a403e2c9b2c2f.jpg
2_fovea,fold_2,1,1,1,0,0,IMG_4039_JPG.rf.3f78f739ca76cba4136559eee15bdd94.jpg
2_fovea,fold_2,15,8,7,1,-7,IMG_20230512_150039_1_jpg.rf.ffd13d7440dc972309a1f58f33063648.jpg
2_fovea,fold_2,2,0,0,0,-2,0230512_145340_jpg.rf.beb3f9c554344398d6f6007f748edd63.jpg
2_fovea,fold_2,8,4,4,0,-4,IMG_4188_JPG.rf.2b1e9cc2bc82b3d05861cab7bdbfb235.jpg
2_fovea,fold_2,4,4,2,2,0,IMG_20230512_145231_804_jpg.rf.35d239e095afd813f22e568b66281c10.jpg
2_fovea,fold_2,8,5,5,0,-3,20230512_152333_jpg.rf.901f79538b04a75cfd995edb99dba147.jpg
2_fovea,fold_2,1,1,0,1,0,IMG_20230512_151122_744_jpg.rf.0203c58a683248c6ba3e7ca2baa5ee22.jpg
2_fovea,fold_2,9,6,5,1,-3,20230512_152403_jpg.rf.21f06ac205b62518bb4ac1c1d05a2bce.jpg
2_fovea,fold_2,21,3,3,0,-18,20230512_150012_jpg.rf.5bc4d2f31a26aab541fdbeb4a437985a.jpg
2_fovea,fold_2,8,4,3,1,-4,20230512_150920_jpg.rf.5224cc7eab4f53f93bdec2d81bba5f0e.jpg
2_fovea,fold_2,7,5,5,0,-2,20230512_145404_jpg.rf.91d448b69a976705a98b28002a84c842.jpg
2_fovea,fold_2,1,1,0,1,0,0003_jpg.rf.bf7cde9cd5a6dc0cc2ee160ef4121efe.jpg
2_fovea,fold_2,7,2,2,0,-5,IMG_20230512_145054_jpg.rf.b241c4cdeabfff0793bff4970cd95da2.jpg
2_fovea,fold_2,1,0,0,0,-1,20230512_145032-0-_jpg.rf.dc8b664d3fb1425d1783c11f8bcb0068.jpg
2_fovea,fold_2,2,0,0,0,-2,20230512_145316-0-_jpg.rf.6c2d352bf056f852f59df415c04c3b73.jpg
2_fovea,fold_2,6,3,3,0,-3,IMG_4037_JPG.rf.c2e2f236825c2dff84efbeb902eeb29d.jpg
2_fovea,fold_2,2,1,0,1,-1,IMG_3916_JPG.rf.250aee83d82e083052118d5322edb81e.jpg
2_fovea,fold_2,3,1,0,1,-2,20230512_150045_jpg.rf.56868f65f25cf730ad8340c6a67caa9b.jpg
2_fovea,fold_3,3,1,0,1,-2,20230512_145409_jpg.rf.d09685c8c603cbe9e1a20305c3a191ef.jpg
2_fovea,fold_3,6,2,2,0,-4,20230512_150944_jpg.rf.eaecb1ecef20585ed9293d182792536f.jpg
2_fovea,fold_3,9,8,7,1,-1,IMG_20230512_152206_244_jpg.rf.39d59820f61b06056f549a4d3442ac7b.jpg
2_fovea,fold_3,5,3,1,2,-2,20230512_151749_jpg.rf.05c1da9e8ad61457f7836f667088adf9.jpg
2_fovea,fold_3,5,3,3,0,-2,0004_jpg.rf.851243b8e41e3a1bd722c5b177c9bf93.jpg
2_fovea,fold_3,1,1,1,0,0,20230512_151806_jpg.rf.26383849e96ac2c96291e0c7409e44d2.jpg
2_fovea,fold_3,1,1,1,0,0,0012_jpg.rf.48d09ce5c069b09d1c9d6cf497ff9a97.jpg
2_fovea,fold_3,5,2,2,0,-3,20230512_151026_jpg.rf.d30352bb19624c98cae22d002974b61a.jpg
2_fovea,fold_3,9,5,5,0,-4,20230512_151855_jpg.rf.e3fa630bb03de4788e09724f320ec036.jpg
2_fovea,fold_3,2,0,0,0,-2,20230512_145316_jpg.rf.496d4ed779e1450c242495fa46e36987.jpg
2_fovea,fold_3,4,3,3,0,-1,20230512_153116_jpg.rf.cdd42e1383bc6c130d47f65e21bcc4e6.jpg
2_fovea,fold_3,5,4,4,0,-1,20230512_145437_jpg.rf.0909c9ccb332356410c1a52743b7c7bf.jpg
2_fovea,fold_3,4,0,0,0,-4,20230512_153139_jpg.rf.c012da59f33e990f927df57e0a6a7f6c.jpg
2_fovea,fold_3,3,1,1,0,-2,0031_jpg.rf.895d9050f9dc5640677a308629b20ad8.jpg
2_fovea,fold_3,21,17,13,4,-4,IMG_20230512_152944_jpg.rf.cda9c2160b066ef7e220cf96a991f737.jpg
2_fovea,fold_3,8,6,4,2,-2,IMG_4187_JPG.rf.f301f6508b0e93d82808ac4e2f80dab0.jpg
2_fovea,fold_3,1,0,0,0,-1,230512_150212_jpg.rf.3e63a63731d99962cf04897093c61c0e.jpg
2_fovea,fold_3,3,1,1,0,-2,20230512_150056_jpg.rf.c9ae963578e609418dc9e533e5a26adf.jpg
2_fovea,fold_3,7,5,4,1,-2,IMG_20230512_153337_765_jpg.rf.f1a04e6d77f25605da1438e3829fd581.jpg
2_fovea,fold_3,10,8,2,6,-2,0200_jpg.rf.72e8b4790e76291a0c9e6877dd61eef5.jpg
2_fovea,fold_3,4,1,0,1,-3,IMG_20230512_151438_jpg.rf.ff747d9ae06e7829a2e860bb43baf295.jpg
2_fovea,fold_3,1,1,1,0,0,IMG_20230512_145007_395_jpg.rf.b8b6b70654f786328e3fe2f85e949a6f.jpg
2_fovea,fold_3,1,0,0,0,-1,0014_jpg.rf.edb35667570fa3a23afcb19d179ea59d.jpg
2_fovea,fold_3,2,0,0,0,-2,20230512_151640_jpg.rf.4b7574d0b6f05544e5a43a5be4589a6f.jpg
2_fovea,fold_3,1,1,1,0,0,20230512_151616_jpg.rf.73b54fe227f3ac8f3da41b5fba2b170a.jpg
2_fovea,fold_3,43,4,2,2,-39,IMG_20230512_150354_jpg.rf.1ed97bfbf8670ca6750d76619dac51ef.jpg
2_fovea,fold_3,1,0,0,0,-1,20230512_145009_jpg.rf.9f8f641e028bed4b2706301af0fb27ee.jpg
2_fovea,fold_3,3,3,3,0,0,20230512_152204_jpg.rf.b0b665cf50c6b54094f4fe1a4a01ecce.jpg
2_fovea,fold_3,4,2,1,1,-2,20230512_145348-0-_jpg.rf.a616aa6a3ced888f83d2044dbd9ec726.jpg
2_fovea,fold_3,9,5,3,2,-4,IMG_20230512_145301_jpg.rf.71b506460c51cef84cbbfdc651695e13.jpg
2_fovea,fold_3,9,6,5,1,-3,20230512_145156_jpg.rf.85e178453eba594f6ce65cebf40de3fb.jpg
2_fovea,fold_3,3,0,0,0,-3,20230512_150025_jpg.rf.0bef8a6273605277f912993bceb28c2c.jpg
2_fovea,fold_3,4,0,0,0,-4,20230512_145130_jpg.rf.51678843234545aa7f95a07feefbe048.jpg
2_fovea,fold_3,1,0,0,0,-1,0230512_145124_jpg.rf.24447141d50bf7957914c622cb19bbc6.jpg
2_fovea,fold_3,1,1,1,0,0,20230512_151656_jpg.rf.581bfb229dea559f67a2aa2ac578db62.jpg
2_fovea,fold_3,2,0,0,0,-2,IMG_20230512_145127_jpg.rf.d2db7f78af8d459d1ccab501da8c6fcd.jpg
2_fovea,fold_3,3,3,2,1,0,IMG_20230512_145110_jpg.rf.d1d01bf0ca4a3344a6bf7d4b94e63c96.jpg
2_fovea,fold_3,2,0,0,0,-2,230512_150052_jpg.rf.495fe344c6875f2116d1ef5a0bd92daf.jpg
2_fovea,fold_3,3,2,1,1,-1,IMG_3934_JPG.rf.1b359ac7d45ac33c7623f668cb9731d0.jpg
2_fovea,fold_3,8,5,2,3,-3,IMG_20230512_150231_jpg.rf.764af7adf374d2dee3739d99e3a0d56a.jpg
2_fovea,fold_3,7,3,2,1,-4,IMG_20230512_145110_246_jpg.rf.153877ddf43d3d76a37f64fb0aa5f617.jpg
2_fovea,fold_3,15,6,5,1,-9,20230512_150106_jpg.rf.3025eeb24b28ae43f2ad27872636bbbf.jpg
2_fovea,fold_3,1,1,0,1,0,20230512_151113_jpg.rf.b6cd4222d666bbace543a8c77d865f35.jpg
2_fovea,fold_3,2,2,2,0,0,20230512_151756_jpg.rf.6e05ac20e235330456b0b0d06c00138c.jpg
2_fovea,fold_3,1,0,0,0,-1,20230512_151035_jpg.rf.103e19cb70bac5049a33c63e773d1a79.jpg
2_fovea,fold_3,6,5,3,2,-1,230512_145340_jpg.rf.9fdd58e2d10ba1375e278a07b95c337c.jpg
2_fovea,fold_3,12,2,0,2,-10,20230512_145203_jpg.rf.35ba545e195d0af402a018f91a322dab.jpg
2_fovea,fold_3,11,10,7,3,-1,IMG_20230512_153029_jpg.rf.80e951915c88eafeea885e5fb27b45e8.jpg
2_fovea,fold_3,2,0,0,0,-2,0230512_145130_jpg.rf.faddf96f4d26a63f9284354dd447afd4.jpg
2_fovea,fold_3,13,5,4,1,-8,20230512_145238_jpg.rf.b85535f8851b826fe2e42e26692f5635.jpg
2_fovea,fold_3,9,2,1,1,-7,20230512_153316_jpg.rf.24b77c461257ba1bd947e731de450708.jpg
2_fovea,fold_3,27,3,3,0,-24,20230512_150125_jpg.rf.d10c3232f4247c5514953cf92c7083c5.jpg
2_fovea,fold_3,3,0,0,0,-3,20230512_151438_jpg.rf.9d2b9be770df6ec4ba79d984fe00b8b4.jpg
2_fovea,fold_3,50,18,18,0,-32,0512_150210_jpg.rf.a172e8c839e22e596b7db396b08d63d1.jpg
2_fovea,fold_3,17,11,8,3,-6,20230512_150321_jpg.rf.a5e551cbda2cf857d53bcbd4d60b92c5.jpg
2_fovea,fold_3,1,0,0,0,-1,20230512_151213_jpg.rf.419a445cd8b3392ce737e6b1c6cb0d88.jpg
2_fovea,fold_3,7,7,7,0,0,IMG_20230512_152958_116_jpg.rf.12bbdfc4e9ae5914029f9e97d0fcd224.jpg
2_fovea,fold_3,8,2,2,0,-6,0230512_145231_jpg.rf.f02c6f94b7286a6b59a1c8b2423f5ba8.jpg
2_fovea,fold_3,20,13,10,3,-7,20230512_152944_jpg.rf.3c5b2edc21ab50f9893441607f43f699.jpg
2_fovea,fold_3,10,8,7,1,-2,20230512_152328_jpg.rf.9afc7b5536cb56c41fedd9c22fd78fe4.jpg
2_fovea,fold_3,1,0,0,0,-1,20230512_151448_jpg.rf.83cf709cf0b2547d212be3a377779599.jpg
2_fovea,fold_3,4,0,0,0,-4,20230512_145151_jpg.rf.1c7cdb8ed83d156aba9a1e8e94becd21.jpg
2_fovea,fold_3,2,1,1,0,-1,0230512_145009_jpg.rf.027a2f31eb1269ab45f13bf35444b96c.jpg
2_fovea,fold_3,24,9,9,0,-15,20230512_153310_jpg.rf.4207c4421e3464536cb4bd47453058d2.jpg
2_fovea,fold_3,1,0,0,0,-1,20230512_145103_jpg.rf.62604473c5e590c815e5d908b8d354a0.jpg
2_fovea,fold_3,2,0,0,0,-2,IMG_20230512_145351_839_jpg.rf.676aa37e025296713a6e39f90d91aa3b.jpg
2_fovea,fold_3,4,3,3,0,-1,20230512_152301-0-_jpg.rf.1afa46256fa26afe6cd36253d167878e.jpg
2_fovea,fold_3,5,3,3,0,-2,IMG_20230512_145310_230_jpg.rf.a3b7f15bfc867ece22ea5c289b0d4b74.jpg
2_fovea,fold_3,12,6,6,0,-6,20230512_150153_jpg.rf.330fb945dbe64ad88c012d6c611ab4e9.jpg
2_fovea,fold_3,9,7,6,1,-2,20230512_152315_jpg.rf.e5aebd25c65f9475f8256b49c71ff68a.jpg
2_fovea,fold_3,1,0,0,0,-1,20230512_151304_jpg.rf.820f387501b1325203f72b034ae1ff0a.jpg
2_fovea,fold_3,5,2,1,1,-3,IMG_3842_JPG.rf.4a4a46be5bc0098c5e1314e61ddc11de.jpg
2_fovea,fold_3,1,1,1,0,0,20230512_145219_jpg.rf.0755ac5ed17a2444b92a33aaea06d7a3.jpg
2_fovea,fold_3,16,6,6,0,-10,20230512_150148_jpg.rf.0d501896a72c41b99bfcd956b0436fb3.jpg
2_fovea,fold_3,5,1,0,1,-4,IMG_20230512_145011_556_jpg.rf.00fbb204260504401d5042a1e1cd5b8d.jpg
2_fovea,fold_3,1,1,0,1,0,IMG_20230512_145336_167_jpg.rf.b667487bd924e740ebac74f50e1e463d.jpg
2_fovea,fold_3,11,9,9,0,-2,20230512_150201_jpg.rf.c4784605e4e8290a39a5a8546b8daf34.jpg
2_fovea,fold_3,14,11,10,1,-3,0056_jpg.rf.de05042e164d7742536e2b31f92d3670.jpg
2_fovea,fold_3,1,1,1,0,0,0034_jpg.rf.32acf93f344bd74d2605e49ed3db9e0e.jpg
2_fovea,fold_3,9,3,2,1,-6,0230512_150100_jpg.rf.bac5d1418079223e898fdae8b34c9b0d.jpg
2_fovea,fold_3,2,0,0,0,-2,IMG_3983_JPG.rf.9148c9d4463c4afaf34c762d4c53ead6.jpg
2_fovea,fold_3,13,6,4,2,-7,20230512_150105_jpg.rf.9bb4f73900fecf656a093f8eac337860.jpg
2_fovea,fold_3,4,0,0,0,-4,20230512_145124_jpg.rf.b61b648c127689b8eeb3a43495c3df3e.jpg
2_fovea,fold_3,16,10,10,0,-6,IMG_20230512_152416_jpg.rf.924528612413e225894a24fc2dec0a36.jpg
2_fovea,fold_3,1,2,1,1,1,20230512_152207_jpg.rf.61fece27ba33f3c6fc069a211008dab5.jpg
2_fovea,fold_3,23,4,4,0,-19,_20230512_150225_jpg.rf.9718d11f60b7e396ae6928ae7f14c90b.jpg
2_fovea,fold_3,19,10,10,0,-9,20230512_150239_jpg.rf.e13a84d4d7ec0f7e070c7ccb4fb737b3.jpg
2_fovea,fold_3,4,3,3,0,-1,20230512_152346_jpg.rf.a8c2948d3e9aa465d912f3465556eb90.jpg
2_fovea,fold_3,6,2,2,0,-4,20230512_150818_jpg.rf.58c0f3208c48520ddc0588916be6397c.jpg
2_fovea,fold_3,1,1,1,0,0,IMG_20230512_150843_jpg.rf.3c9dacc8aa8ae98bcec98a6b950df819.jpg
2_fovea,fold_3,1,0,0,0,-1,IMG_3839_JPG.rf.2b8f533bc337b2b41e4aa08d82c895f0.jpg
2_fovea,fold_3,13,0,0,0,-13,IMG_20230512_150401_jpg.rf.0f4c64f7dd592050ecd9a38797714f40.jpg
2_fovea,fold_3,4,2,0,2,-2,0008_jpg.rf.3fe730c41fdc7b3704f6885ae667338f.jpg
2_fovea,fold_3,7,3,3,0,-4,IMG_20230512_150236_jpg.rf.b127381341df0777f6b90c3d6193ab5f.jpg
2_fovea,fold_3,13,7,5,2,-6,20230512_153104_jpg.rf.e6b0a044d9369e49df9c83ed02c5f924.jpg
2_fovea,fold_3,1,1,1,0,0,20230512_151446_jpg.rf.e46015a969282d2959dba6262188eb21.jpg
2_fovea,fold_3,1,0,0,0,-1,IMG_4046_JPG.rf.5365cbd02513c386b454d943407c56e0.jpg
2_fovea,fold_3,7,3,3,0,-4,IMG_20230512_150841_155_jpg.rf.8f074ff9aa19c6cf12ce37edaace8c77.jpg
2_fovea,fold_3,3,1,1,0,-2,20230512_145122-0-_jpg.rf.7f7266ca36660b1ab4d0a4f2a704a54e.jpg
2_fovea,fold_3,3,2,2,0,-1,20230512_151620_jpg.rf.ced9071f82dc586dd5ac71f5fae00dc4.jpg
2_fovea,fold_3,1,1,1,0,0,20230512_151655_jpg.rf.1681dccfc685ad40e584cad62c4f6b8e.jpg
2_fovea,fold_3,8,4,2,2,-4,0230512_145235_jpg.rf.20bb212232c9b2421611218796835da2.jpg
2_fovea,fold_3,13,2,2,0,-11,20230512_151008_jpg.rf.0cd6367e8494296811c3d1a88e22360b.jpg
2_fovea,fold_3,12,12,10,2,0,IMG_20230512_152352_jpg.rf.2c7ab0d8791aacf1c20aa134ddf7f9ed.jpg
2_fovea,fold_3,2,2,1,1,0,IMG_20230512_151034_jpg.rf.d8d2ab03b8a59931929429b4bc8c7106.jpg
2_fovea,fold_3,12,1,0,1,-11,IMG_20230512_150124_jpg.rf.fef0579e7a6b4c283294de15512f524a.jpg
2_fovea,fold_3,7,2,0,2,-5,20230512_150027_jpg.rf.787439d34fc22269c3ab90e55ea595ed.jpg
2_fovea,fold_3,3,2,2,0,-1,20230512_151627_jpg.rf.9dc28340fd04ffea8cf28dd5e51283d6.jpg
2_fovea,fold_3,4,2,1,1,-2,IMG_20230512_151218_jpg.rf.10b21ddd648ad67d1f264e8b99ead4d4.jpg
2_fovea,fold_3,37,14,14,0,-23,IMG_20230512_150249_jpg.rf.61bc4fbd0c49a88a29443f72cc742e3b.jpg
2_fovea,fold_3,6,1,1,0,-5,20230512_150023_jpg.rf.06c0ade806a1d3e688bc144ef13dbaf8.jpg
2_fovea,fold_3,8,7,5,2,-1,20230512_150210_jpg.rf.e4435f297c285583a73370f97d9cef80.jpg
2_fovea,fold_3,8,5,5,0,-3,IMG_4089_JPG.rf.7967cd5700ba2e9b62aa13ecaa3a28b1.jpg
2_fovea,fold_3,0,5,0,5,5,0031_jpg.rf.00b387ba75b602a79b19e9003038b8ea.jpg
2_fovea,fold_3,3,1,1,0,-2,IMG_4196_JPG.rf.66adce382a697aad33bcbc7ab8814677.jpg
2_fovea,fold_3,26,3,2,1,-23,0512_150111_jpg.rf.d4cf10c518eff125048b590e0a4605cb.jpg
2_fovea,fold_3,2,2,2,0,0,IMG_20230512_151827_jpg.rf.e428f11ebc690c01de13c493aaf89f10.jpg
2_fovea,fold_3,4,0,0,0,-4,0009_jpg.rf.14ae6cb384f301625cca9baa804d99e2.jpg
2_fovea,fold_3,6,4,2,2,-2,IMG_20230512_145423_jpg.rf.f32325604574f1dc3efee2c645d2272b.jpg
2_fovea,fold_3,8,0,0,0,-8,20230512_150140_jpg.rf.b2c7162d38d1696ac9436b4c5de3c5bd.jpg
2_fovea,fold_3,3,2,1,1,-1,20230512_145132_jpg.rf.b2c282982621d398e0a5b6f181a8e8c1.jpg
2_fovea,fold_3,18,15,14,1,-3,20230512_153054_jpg.rf.acae07a63d6f22a0dc7fca55cf6b2d89.jpg
2_fovea,fold_3,5,4,4,0,-1,0005_jpg.rf.619937b06bbe7d217806b697a9eaf55e.jpg
2_fovea,fold_3,2,0,0,0,-2,230512_150120_jpg.rf.1f7889194211bdac4259fdcd65e2af46.jpg
2_fovea,fold_3,17,7,6,1,-10,IMG_20230512_150215_jpg.rf.9b54f4c34af6ee37c5ada817e2111c19.jpg
2_fovea,fold_3,3,1,0,1,-2,20230512_145242_jpg.rf.88c3024b1c64b0b6b0db5dddea0bbe0e.jpg
2_fovea,fold_3,17,11,9,2,-6,0230512_145032_jpg.rf.e9aeb44392fbee708cc4bb450582bc0f.jpg
2_fovea,fold_3,1,0,0,0,-1,0001_jpg.rf.a9b41d3e1ed49082f175c1d3de0b732e.jpg
2_fovea,fold_3,19,11,11,0,-8,IMG_20230512_150300_jpg.rf.4a9882ab0ad5a15acf150bad52ccf7d8.jpg
2_fovea,fold_3,26,9,7,2,-17,IMG_20230512_150103_353_jpg.rf.eaad90385ad647d1df922a626623f903.jpg
2_fovea,fold_3,7,1,1,0,-6,20230512_150022_jpg.rf.5a680d2814abd10e92a1f6ddf628a4b0.jpg
2_fovea,fold_3,2,0,0,0,-2,0015_jpg.rf.1f8e46b5b78af1818a40afacf5a7fe1f.jpg
2_fovea,fold_3,4,0,0,0,-4,IMG_20230512_144918_793_jpg.rf.fe7a52b8285a2a10f29948f41ac02b51.jpg
2_fovea,fold_3,3,1,1,0,-2,20230512_145233_jpg.rf.8a9f06089b7122f3b71b6b1b537d6310.jpg
2_fovea,fold_3,1,1,1,0,0,20230512_151802_jpg.rf.9a715b86b471f00ddc7bd3a521537317.jpg
2_fovea,fold_3,18,12,12,0,-6,20230512_153055_jpg.rf.0b63692f9c79fad5834fab15740f4292.jpg
2_fovea,fold_3,2,2,1,1,0,20230512_151739_jpg.rf.fecdc818de88f0d7b449820f099a729b.jpg
2_fovea,fold_3,4,2,1,1,-2,20230512_150313_jpg.rf.7d2a23518189f8dfc49022c0bb08346b.jpg
2_fovea,fold_3,6,4,4,0,-2,20230512_153401_jpg.rf.1ded42782d8fd0ae0793add50267e0f5.jpg
2_fovea,fold_3,3,2,2,0,-1,20230512_152321_jpg.rf.b0515ed603d5d83688c8ee2dfedeaa66.jpg
2_fovea,fold_3,1,0,0,0,-1,20230512_151233_jpg.rf.57d77820fe4dbc49f59fbae1adba2530.jpg
2_fovea,fold_3,8,7,7,0,-1,IMG_20230512_145010_jpg.rf.ba751af01c38c7678521f2c4ac49568d.jpg
2_fovea,fold_3,11,2,2,0,-9,20230512_150957_jpg.rf.2c85fc69db682fcfa08ad10362437bf3.jpg
2_fovea,fold_3,2,1,1,0,-1,0026_jpg.rf.10b0037e1af1fddb19365505a0710c5e.jpg
2_fovea,fold_3,1,0,0,0,-1,0230512_145119_jpg.rf.a6362e13240d8879ce6e61258d8292ff.jpg
2_fovea,fold_3,12,3,2,1,-9,IMG_20230512_152237_316_jpg.rf.d5f18e3c135f2f386671e759efda8b69.jpg
2_fovea,fold_3,13,11,10,1,-2,20230512_152314_jpg.rf.6c3a181a30741b0f98140ba02a523656.jpg
2_fovea,fold_3,21,5,3,2,-16,IMG_20230512_150127_jpg.rf.93acf533bedd75541341479d4df15bde.jpg
2_fovea,fold_3,10,8,8,0,-2,IMG_4194_JPG.rf.4cdca480fa2d46704cadc5840d0238b9.jpg
2_fovea,fold_3,2,1,1,0,-1,20230512_145425_jpg.rf.8c9689378836a9437ec8ca49c37064b8.jpg
2_fovea,fold_3,9,2,1,1,-7,20230512_150034_jpg.rf.d8c7b9720feb16c5a52d002b7d3fdbec.jpg
2_fovea,fold_3,2,2,2,0,0,20230512_151800_jpg.rf.60975505aa8c8066f47f273831b23407.jpg
2_fovea,fold_3,15,13,13,0,-2,IMG_20230512_152327_jpg.rf.9a4db2d219a086a344f3eb954ba715b9.jpg
2_fovea,fold_3,8,7,4,3,-1,20230512_153038_jpg.rf.263cbf9b4c15ef94a433b3b4d9c52ad6.jpg
2_fovea,fold_3,2,1,1,0,-1,20230512_151740_jpg.rf.bfe7cb62c2579413cf5790e5fdbe33bc.jpg
2_fovea,fold_3,3,1,1,0,-2,20230512_151622_jpg.rf.99d95c55959b0e321e3679e87f923922.jpg
2_fovea,fold_3,1,1,1,0,0,0007_jpg.rf.2f8d48ecd0ea275fbd9f39696545a7de.jpg
2_fovea,fold_4,8,4,4,0,-4,20230512_152304_jpg.rf.af417071e5055ff7a21c7e5c8a36b6b4.jpg
2_fovea,fold_4,2,1,1,0,-1,IMG_4032_JPG.rf.24900b5575b9992102af280f6bba47e6.jpg
2_fovea,fold_4,2,1,1,0,-1,0230512_145348_jpg.rf.cdc212bd3fb2bf4f176382d869092c48.jpg
2_fovea,fold_4,3,2,2,0,-1,20230512_151623_jpg.rf.72bb569548154b9cacef8ad44ea34cbb.jpg
2_fovea,fold_4,16,2,1,1,-14,20230512_150033_jpg.rf.187d7f8b3b10fd4c55a59ca829ef7fc8.jpg
2_fovea,fold_4,5,2,2,0,-3,20230512_151847_jpg.rf.bd70f9e3dff9227488b4ca7adbf77b50.jpg
2_fovea,fold_4,17,11,8,3,-6,0230512_145037_jpg.rf.043bbe5a69ebdbfca0307a4e11b0ac63.jpg
2_fovea,fold_4,35,7,7,0,-28,20230512_150150_jpg.rf.7c6e4ba9b7c81892495bdb947e71e7bc.jpg
2_fovea,fold_4,12,11,10,1,-1,20230512_151910_jpg.rf.83e74c185917f56390fb7c632f1ddbb8.jpg
2_fovea,fold_4,13,7,3,4,-6,IMG_20230512_153056_jpg.rf.ce869252548200602c656449cd5652e5.jpg
2_fovea,fold_4,6,5,5,0,-1,20230512_152218_jpg.rf.93c255ace7ac5cb6c518b519f276c38a.jpg
2_fovea,fold_4,1,1,1,0,0,IMG_20230512_150858_jpg.rf.0c886d7a0228ac541d46c5461d00eaa9.jpg
2_fovea,fold_4,8,0,0,0,-8,IMG_20230512_153026_jpg.rf.8b55b13a2be603023efcf36910819c5c.jpg
2_fovea,fold_4,20,17,17,0,-3,IMG_20230512_162026_jpg.rf.5b2e0930b83dcdad9e4b2c7dc2220ad8.jpg
2_fovea,fold_4,3,0,0,0,-3,20230512_152203_jpg.rf.f37f9576053c5dda9448b82302e0a353.jpg
2_fovea,fold_4,7,2,2,0,-5,20230512_150912_jpg.rf.18152396c31db59c1819409ba319c0aa.jpg
2_fovea,fold_4,1,1,1,0,0,20230512_151104_jpg.rf.68db94fa29d48c9461b06ea1012225cb.jpg
2_fovea,fold_4,9,2,0,2,-7,IMG_4184_JPG.rf.c3ce659fb0267eb11d28871cd003f680.jpg
2_fovea,fold_4,8,7,6,1,-1,IMG_20230512_152244_576_jpg.rf.97d6ebe9005d26f9e1a4c40801745b3f.jpg
2_fovea,fold_4,6,1,1,0,-5,IMG_20230512_144951_654_jpg.rf.73864ab361d6a49bef8ae0582378dcd8.jpg
2_fovea,fold_4,4,3,3,0,-1,20230512_152245_jpg.rf.ad9c9eed13ca805362ff37a6409c22f1.jpg
2_fovea,fold_4,7,3,3,0,-4,0230512_145259_jpg.rf.a81f0fe30e13f9985ea29fbb8c3ca4bb.jpg
2_fovea,fold_4,1,0,0,0,-1,20230512_151444_jpg.rf.d7d4a6ea41d6e0b978df16189a7ef0b7.jpg
2_fovea,fold_4,3,2,2,0,-1,IMG_20230512_145249_jpg.rf.3fc3e8c98a6aad287c04adaf81f76d80.jpg
2_fovea,fold_4,13,12,12,0,-1,20230512_152301_jpg.rf.13169aad5cc03cf2c0524d6515d1d94b.jpg
2_fovea,fold_4,8,3,3,0,-5,20230512_150133_jpg.rf.959f58c55ea7f14e5d45aefc1a142e65.jpg
2_fovea,fold_4,5,1,1,0,-4,IMG_20230512_145102_470_jpg.rf.a4be99517dd9cf481f2fb0f577967e6e.jpg
2_fovea,fold_4,16,9,7,2,-7,IMG_3905_JPG.rf.442064c53f4baafe2a90c8d4533175cf.jpg
2_fovea,fold_4,3,2,2,0,-1,20230512_151752-0-_jpg.rf.adde6111e2c01f49d300871eeeeaf43b.jpg
2_fovea,fold_4,15,6,6,0,-9,IMG_20230512_153244_jpg.rf.fd36ed68885d906d1bfe0772308714e1.jpg
2_fovea,fold_4,45,15,13,2,-30,IMG_20230512_150252_jpg.rf.91876ddbae7daf47c170e3510196d23c.jpg
2_fovea,fold_4,15,4,3,1,-11,0230512_144954_jpg.rf.9e07b2d4ee27051f0fa96e46105520b2.jpg
2_fovea,fold_4,9,2,1,1,-7,20230512_151010_jpg.rf.ff0a6fa0a1930269ecf709bdd00cc6b8.jpg
2_fovea,fold_4,1,0,0,0,-1,20230512_145011_jpg.rf.85e961b884fe88c3056ad6c5a04daafb.jpg
2_fovea,fold_4,1,1,1,0,0,20230512_151659_jpg.rf.d533f433ef4f94da44e6019d93e2f69d.jpg
2_fovea,fold_4,6,1,1,0,-5,20230512_144945_jpg.rf.49417903dca45c5adf0a0717d2a3dda5.jpg
2_fovea,fold_4,6,5,5,0,-1,20230512_152305_jpg.rf.b263e7fe5ca0aa0ae073ef44c4d6ad63.jpg
2_fovea,fold_4,2,1,1,0,-1,20230512_152256_jpg.rf.414a0a8bdcc3eb0a766f8a87f6a30f22.jpg
2_fovea,fold_4,5,5,4,1,0,20230512_151844_jpg.rf.b9cd7c0869b5dcad46ed7aa755549a1d.jpg
2_fovea,fold_4,12,2,1,1,-10,20230512_145238-0-_jpg.rf.a0bc376d8aa6c21ae201e90cd541ddca.jpg
2_fovea,fold_4,11,9,8,1,-2,IMG_20230512_152349_jpg.rf.76f8813a71224f65490c6d1d4faea02e.jpg
2_fovea,fold_4,8,5,5,0,-3,20230512_145210_jpg.rf.6800be488a1a4beab14cab796974b7e7.jpg
2_fovea,fold_4,38,16,14,2,-22,IMG_20230512_150114_jpg.rf.d5fd8310f61f94bfde93cace46c477bb.jpg
2_fovea,fold_4,2,0,0,0,-2,IMG_20230512_151102_245_jpg.rf.2d98a1d78cce88aad42bfe628f8ebe8d.jpg
2_fovea,fold_4,13,1,1,0,-12,IMG_20230512_151332_jpg.rf.58fb5690cf39dcfb9f524a2ffc7cd6b2.jpg
2_fovea,fold_4,4,3,3,0,-1,20230512_145359_jpg.rf.538caafcbceeeab2a7c4cb9e58bb1e6a.jpg
2_fovea,fold_4,4,1,1,0,-3,0230512_145436_jpg.rf.68d4283942702699c181b1c4e2b81a95.jpg
2_fovea,fold_4,1,0,0,0,-1,0012_jpg.rf.5fee49c3e98f9b2a75823078d85768de.jpg
2_fovea,fold_4,7,1,1,0,-6,20230512_150040-0-_jpg.rf.c74af3340e71a4f4d5a1fc4d5da8ffe5.jpg
2_fovea,fold_4,8,2,2,0,-6,IMG_20230512_150239_jpg.rf.0eb9dc459dd6d692fc26252cf2107fd0.jpg
2_fovea,fold_4,1,0,0,0,-1,0230512_145052_jpg.rf.f17d7b98aa9a0360c0acc806b326b6a7.jpg
2_fovea,fold_4,13,9,9,0,-4,IMG_20230512_152453_jpg.rf.1723f10503a3e6db7fbceca5913e5ee1.jpg
2_fovea,fold_4,15,13,12,1,-2,0044_jpg.rf.a0660e380e16b315347f5e8999d870df.jpg
2_fovea,fold_4,1,1,1,0,0,20230512_145416_jpg.rf.85e0cfe06b91ae56be79ec72f5f2166f.jpg
2_fovea,fold_4,8,4,4,0,-4,20230512_145343_jpg.rf.e8b4ce21c1272def811c108b7b1604e1.jpg
2_fovea,fold_4,45,12,11,1,-33,0512_150205_jpg.rf.698866d107ebfcc4f94fd99f31b35b02.jpg
2_fovea,fold_4,2,2,1,1,0,IMG_20230512_151308_jpg.rf.9eafa4b376d2b0b24c2d76c7cefacf05.jpg
2_fovea,fold_4,53,11,11,0,-42,0512_150120_jpg.rf.1a423f81d04e2ea199fda4f8950d5ec2.jpg
2_fovea,fold_4,1,1,1,0,0,20230512_145323_jpg.rf.42fec2bfece6489ae531e4112d227ded.jpg
2_fovea,fold_4,2,1,0,1,-1,IMG_20230512_151304_jpg.rf.bdf70f382af5e54ed70fa1fa32041649.jpg
2_fovea,fold_4,1,0,0,0,-1,20230512_153306_jpg.rf.d458260a195df2ca8597a9690a8bc292.jpg
2_fovea,fold_4,10,6,5,1,-4,20230512_151858_jpg.rf.3e2b4dbf1ece4e9a00109cbeb8dc13dd.jpg
2_fovea,fold_4,6,3,3,0,-3,IMG_20230512_151212_jpg.rf.f922d49a1e43e214462b88c675a0f36c.jpg
2_fovea,fold_4,24,2,1,1,-22,20230512_153019_jpg.rf.6b11b011a1b75c2eb51c302864a6ea12.jpg
2_fovea,fold_4,16,11,11,0,-5,20230512_150111_jpg.rf.3f08c8521cd7c859a80b7ba2d1856e75.jpg
2_fovea,fold_4,1,1,1,0,0,20230512_151650_jpg.rf.18be50d732782b5b8fb5f6c6db59cc14.jpg
2_fovea,fold_4,4,0,0,0,-4,20230512_144940_jpg.rf.47a23c7f63536b38b08e8f2722741d17.jpg
2_fovea,fold_4,11,10,9,1,-1,0054_jpg.rf.5df028d18381f316e9ed0d97adbbfbc0.jpg
2_fovea,fold_4,5,0,0,0,-5,IMG_4217_JPG.rf.b26704f0c46f7b6c0d25d7f2aa4eac49.jpg
2_fovea,fold_4,4,3,3,0,-1,20230512_145352-0-_jpg.rf.bd97ac0cb6ee49b575c0ecff7f91e2a1.jpg
2_fovea,fold_4,1,0,0,0,-1,IMG_3856_JPG.rf.4cd3bfac67d223cd7bd1b1efd3b24a09.jpg
2_fovea,fold_4,20,11,11,0,-9,IMG_20230512_152344_jpg.rf.fd23ba06eae998d14ce833db2c7d2195.jpg
2_fovea,fold_4,17,3,3,0,-14,IMG_20230512_150217_jpg.rf.59ee9b06cb5a58b718b0ff7c76a2573f.jpg
2_fovea,fold_4,1,1,1,0,0,20230512_151654-0-_jpg.rf.21ff99bb21484d784b641bc49d9310ea.jpg
2_fovea,fold_4,13,7,7,0,-6,IMG_20230512_151617_084_jpg.rf.864b3ce525fdd2abc7cc1f20bd6005c7.jpg
2_fovea,fold_4,5,2,2,0,-3,230512_150030_jpg.rf.35a4005da91e89204ecd28ce53e7d8ee.jpg
2_fovea,fold_4,6,2,2,0,-4,20230512_150037_jpg.rf.a47f7ce797194722a66a03263aee18ea.jpg
2_fovea,fold_4,5,2,2,0,-3,IMG_20230512_150051_jpg.rf.66c8214813ef8f830b3612827d4de766.jpg
2_fovea,fold_4,14,1,1,0,-13,20230512_152949_jpg.rf.67f9765f971d32daf7623088e0781422.jpg
2_fovea,fold_4,2,1,1,0,-1,20230512_150046_jpg.rf.a3f3b22b2918be1f870eb4ccdaab79d1.jpg
2_fovea,fold_4,7,1,0,1,-6,IMG_20230512_150112_1_jpg.rf.bf75baa207583c375190da53145a7679.jpg
2_fovea,fold_4,15,8,6,2,-7,IMG_20230512_153023_jpg.rf.317d3bbb9dbd87e5a653c2851476e12f.jpg
2_fovea,fold_4,5,1,1,0,-4,IMG_3847_JPG.rf.7ed87b14fc0af6892da29e4861a20db2.jpg
2_fovea,fold_4,3,0,0,0,-3,0003_jpg.rf.808f042f9b4d2044e82ecf546085a2b3.jpg
2_fovea,fold_4,16,2,2,0,-14,20230512_151042_jpg.rf.668f39eb72d209648acafdc48e653b94.jpg
2_fovea,fold_4,7,3,3,0,-4,20230512_151549_jpg.rf.f43c366ab902f205b42b2d3ece3e5840.jpg
2_fovea,fold_4,6,4,4,0,-2,20230512_145344_jpg.rf.3bb4caede9892124f0b05d554bde4f37.jpg
2_fovea,fold_4,1,0,0,0,-1,20230512_145106_jpg.rf.f8f6fb5e7680b51b521aeb38bd04b4d4.jpg
2_fovea,fold_4,4,0,0,0,-4,IMG_4056_JPG.rf.26cf10e8b88a0d85256d77231719fa6f.jpg
2_fovea,fold_4,25,3,3,0,-22,0512_150105_jpg.rf.bf34c202007f5f0e97f15dd34c8af9ec.jpg
2_fovea,fold_4,1,0,0,0,-1,20230512_145259_jpg.rf.4e068952a2cfa65232622575f2c5e59f.jpg
2_fovea,fold_4,8,4,2,2,-4,IMG_20230512_150233_jpg.rf.fda528f9aab7dbc67a541c09b3ad100a.jpg
2_fovea,fold_4,23,5,3,2,-18,IMG_20230512_150117_559_jpg.rf.acc98bc013000372fc9482efda238776.jpg
2_fovea,fold_4,20,8,6,2,-12,IMG_20230512_150227_jpg.rf.c50986ec06debff70d855a963ab1652a.jpg
2_fovea,fold_4,1,1,1,0,0,20230512_145254_jpg.rf.9747b881733bcadb9a2575a7adfaf75f.jpg
2_fovea,fold_4,7,0,0,0,-7,20230512_151550_jpg.rf.c44e1e4b7281907db5e481f675bb38ec.jpg
2_fovea,fold_4,9,8,7,1,-1,20230512_152300_jpg.rf.ca2bad1620eeb8a9708c24c8c2a6140e.jpg
2_fovea,fold_4,1,0,0,0,-1,20230512_151454_jpg.rf.2edeb7ad32e74ab446183c1ed2a6a8db.jpg
2_fovea,fold_4,2,0,0,0,-2,20230512_151458_jpg.rf.e6aebc1a203d13c8d455292cbf8efbd5.jpg
2_fovea,fold_4,2,1,1,0,-1,20230512_151804_jpg.rf.85f9cab4d985c7a3ab655e9e58f37592.jpg
2_fovea,fold_4,4,1,1,0,-3,20230512_150056-0-_jpg.rf.726ba341e3872665ea20101a9121709b.jpg
2_fovea,fold_4,1,2,1,1,1,20230512_151710-0-_jpg.rf.d1c6ce2dc1214885b420fa5cf5b548eb.jpg
2_fovea,fold_4,7,3,3,0,-4,0035_jpg.rf.88b59c904d75a54342b73641b3751f03.jpg
2_fovea,fold_4,3,2,2,0,-1,20230512_150207_jpg.rf.2636d37c60105f9dc29244105d586763.jpg
2_fovea,fold_4,11,4,2,2,-7,20230512_153529_jpg.rf.9da097c550c92828a111a560d7417f19.jpg
2_fovea,fold_4,2,0,0,0,-2,20230512_145142_jpg.rf.4c1baf7188f9de7e345b9d556ae04487.jpg
2_fovea,fold_4,1,0,0,0,-1,0021_jpg.rf.f361beb31a38d69ae7d5b1ba99586d9f.jpg
2_fovea,fold_4,1,0,0,0,-1,IMG_20230512_145308_jpg.rf.60b7e140102953684517e9840c3f84fd.jpg
2_fovea,fold_4,1,0,0,0,-1,20230512_145115_jpg.rf.559191d80ad4506d081542afe21569dc.jpg
2_fovea,fold_4,8,9,9,0,1,20230512_151848-0-_jpg.rf.4c259cab53877565769f8e42eb6a0530.jpg
2_fovea,fold_4,2,0,0,0,-2,IMG_20230512_153102_jpg.rf.358691eda0f0c7c79eb866b582696397.jpg
2_fovea,fold_4,3,1,1,0,-2,IMG_20230512_150935_625_jpg.rf.cff6166bfeadb181c727209a263dcaff.jpg
2_fovea,fold_4,3,1,1,0,-2,IMG_3985_JPG.rf.5c7d7114a15a375a31c89b82a6710707.jpg
2_fovea,fold_4,2,1,1,0,-1,20230512_151632_jpg.rf.fb7428039c06580293185bb9fd642dff.jpg
2_fovea,fold_4,2,0,0,0,-2,IMG_20230512_151628_jpg.rf.0963b2196e508f701f2dc60946b1db1f.jpg
2_fovea,fold_4,1,1,1,0,0,0230512_145319_jpg.rf.7d5ab2070daeed5a15f73e243edac4bd.jpg
2_fovea,fold_4,5,2,2,0,-3,IMG_3914_JPG.rf.ca20ceecff09da300344c1920873e12b.jpg
2_fovea,fold_4,3,0,0,0,-3,IMG_4036_JPG.rf.c2b46ca616106cdb334a1b0aac2c914c.jpg
2_fovea,fold_4,2,0,0,0,-2,0230512_145122_jpg.rf.d772ceaa3f11800d1db3d3fc009b64fa.jpg
2_fovea,fold_4,22,11,8,3,-11,20230512_153049_jpg.rf.523c3f6b00af1f2e03d5832e7dd51cae.jpg
2_fovea,fold_4,3,0,0,0,-3,IMG_20230512_151832_jpg.rf.b82753ef867011bf9f3989f4130320b7.jpg
2_fovea,fold_4,1,1,1,0,0,20230512_151710_jpg.rf.e2a5628c7930faedb74febbd18a15ccd.jpg
2_fovea,fold_4,5,1,0,1,-4,IMG_4185_JPG.rf.6ef6b7a942afe064f7a7a9e4939729df.jpg
2_fovea,fold_4,0,9,0,9,9,20230512_151901_jpg.rf.b378a9d5c3045cf87dd1529a7b516a3a.jpg
2_fovea,fold_4,0,12,0,12,12,0512_150124_jpg.rf.7253b200930360a6b66d16035d62353c.jpg
2_fovea,fold_4,3,1,1,0,-2,IMG_4195_JPG.rf.0d03c7bef40b40141ba8fa902afc3944.jpg
2_fovea,fold_4,4,0,0,0,-4,20230512_151029_jpg.rf.aa4b3114b5545da90c2fa92150f01f70.jpg
2_fovea,fold_4,20,0,0,0,-20,20230512_153247_jpg.rf.78c6c0964c07caf937b2079e23dcd922.jpg
2_fovea,fold_4,7,1,1,0,-6,IMG_20230512_153040_jpg.rf.3179cdcfc75730df90bea9e4cbaf0f49.jpg
2_fovea,fold_4,10,5,2,3,-5,IMG_20230512_145141_jpg.rf.c065d756b2e91f8933ac0a39ecf7c61c.jpg
2_fovea,fold_4,3,4,2,2,1,IMG_20230512_145333_jpg.rf.4bf3129c20f06bdb19d22b037e743535.jpg
2_fovea,fold_4,3,1,1,0,-2,20230512_151621_jpg.rf.1cbfdf5023fe1c36f7e1875304467d87.jpg
2_fovea,fold_4,4,1,1,0,-3,IMG_20230512_145030_jpg.rf.a2c5e550d29709fcbbe253d3a17faa45.jpg
2_fovea,fold_4,5,4,4,0,-1,20230512_152223_jpg.rf.f6e3e9cd94a0f7908edd48a70c791781.jpg
2_fovea,fold_4,17,8,8,0,-9,IMG_20230512_152350_jpg.rf.4fb06c58b682b06360ed9fa33472ca3f.jpg
2_fovea,fold_4,16,6,6,0,-10,20230512_150149_jpg.rf.5f8b1bb241d961acb2fc7ceb62fbcbe5.jpg
2_fovea,fold_4,7,4,3,1,-3,20230512_152306_jpg.rf.20aa1ef8f2026e47d56210676e93fca7.jpg
2_fovea,fold_4,21,7,6,1,-14,20230512_144930_jpg.rf.f3caeeb846d5d4f624e9885bcb85d864.jpg
2_fovea,fold_4,14,3,1,2,-11,IMG_20230512_153017_077_jpg.rf.70df56b8159d336a40a3fab054edb7c4.jpg
2_fovea,fold_4,6,2,1,1,-4,IMG_20230512_144916_143_jpg.rf.00ee144f83892f61d5178b7edacdc535.jpg
2_fovea,fold_4,1,0,0,0,-1,0018_jpg.rf.ca81692f06f9a1e7e06b1042d8cbe236.jpg
2_fovea,fold_4,7,5,5,0,-2,20230512_152242_jpg.rf.4dee3224c614312f3bd59fc772965ff5.jpg
2_fovea,fold_4,9,1,1,0,-8,IMG_20230512_150043_1_jpg.rf.5e7eb6e74c9c826c0209bc26685279a3.jpg
2_fovea,fold_4,1,0,0,0,-1,0230512_145013_jpg.rf.14bb403c31ebd5a9f4be760858d91e7c.jpg
2_fovea,fold_4,1,0,0,0,-1,IMG_4044_JPG.rf.e22068c91df69c24b01d3bb4f484ccf9.jpg
2_fovea,fold_4,9,0,0,0,-9,IMG_20230512_150125_jpg.rf.bdb9638a94f4957f29777b278afdfb54.jpg
2_fovea,fold_4,17,1,0,1,-16,20230512_152946_jpg.rf.00fa418fbf2242a22bd020d8133a24ee.jpg
2_fovea,fold_4,19,3,3,0,-16,IMG_20230512_150131_jpg.rf.325767bc75099b22d288f353f1a8fbe2.jpg
2_fovea,fold_4,16,0,0,0,-16,20230512_151041_jpg.rf.0b792381ac6bb324435dd5a7b43616cf.jpg
2_fovea,fold_4,2,0,0,0,-2,20230512_151443_jpg.rf.7d2dfd53f11811d0c3a7fe9e184ef15f.jpg
2_fovea,fold_4,13,9,9,0,-4,20230512_153243_jpg.rf.a8672f75e3195db775772b68bce054bf.jpg
2_fovea,fold_4,7,6,5,1,-1,IMG_3912_JPG.rf.6558238f753c37ffb70dd8d3bcee5e9f.jpg
2_fovea,fold_4,13,2,1,1,-11,IMG_20230512_151318_682_jpg.rf.cdeb9703323a496f0e9620a04f4ec09d.jpg
2_fovea,fold_4,1,0,0,0,-1,0038_jpg.rf.d0b487b5b7af9ce9d50c875d519b9707.jpg
2_fovea,fold_4,13,7,5,2,-6,20230512_150015_jpg.rf.5089b7d402f3ce99da9541171299577e.jpg
2_fovea,fold_4,13,5,5,0,-8,20230512_153332_jpg.rf.f6c943fc1dfba3d62a21eb08ecf60b8c.jpg
2_fovea,fold_4,7,3,2,1,-4,20230512_152247_jpg.rf.df7d569b56aaba2e6bf5fc59ec8f414c.jpg
2_fovea,fold_5,23,13,10,3,-10,IMG_20230512_150248_jpg.rf.11fd0431dfaace4800d3f2d4912bd780.jpg
2_fovea,fold_5,9,5,5,0,-4,20230512_150203_jpg.rf.d7cdb618f9cc06830ca3fad4137b7cac.jpg
2_fovea,fold_5,13,5,3,2,-8,IMG_20230512_145048_jpg.rf.2f0c31d1a5ff8b461878196ebf8c11df.jpg
2_fovea,fold_5,3,2,2,0,-1,20230512_145350-0-_jpg.rf.ccf3d3aca429fe2887c17c60d55a358a.jpg
2_fovea,fold_5,14,7,6,1,-7,IMG_20230512_153052_jpg.rf.8577be081284ea5d1672c21d4fd9f288.jpg
2_fovea,fold_5,2,2,2,0,0,20230512_151628_jpg.rf.fdfad9f330381519b41b6c69eeae4609.jpg
2_fovea,fold_5,4,2,1,1,-2,20230512_150906_jpg.rf.b4718b9b84d49303d6b0fb5e035fe49b.jpg
2_fovea,fold_5,2,2,1,1,0,IMG_20230512_151744_jpg.rf.1d579e4bc8e6391207029a3d59c821a9.jpg
2_fovea,fold_5,2,0,0,0,-2,0013_jpg.rf.55b646371565f20bce0f6ce403646502.jpg
2_fovea,fold_5,16,6,4,2,-10,20230512_145021_jpg.rf.57a18381e0e233f1d4d97199a9263ed4.jpg
2_fovea,fold_5,4,3,3,0,-1,20230512_152325_jpg.rf.b754896fe384db191f35564d52272327.jpg
2_fovea,fold_5,3,1,1,0,-2,IMG_20230512_151247_jpg.rf.33589b240751a2f02c7a7c51bafafe59.jpg
2_fovea,fold_5,3,2,2,0,-1,20230512_151624_jpg.rf.339fa34d1377a1b59daa0460f8896c47.jpg
2_fovea,fold_5,7,4,1,3,-3,IMG_20230512_145013_jpg.rf.23ebd19f18a23ba18f9bde6b91f93cbd.jpg
2_fovea,fold_5,5,2,1,1,-3,20230512_153327_jpg.rf.07e6f7dfffed230d78bc971f5cdb9b9f.jpg
2_fovea,fold_5,1,1,1,0,0,20230512_151652_jpg.rf.42dfca221b4b4fbaf828e370670fd031.jpg
2_fovea,fold_5,13,0,0,0,-13,20230512_151021-copia-1-_jpg.rf.abdeaa1b054ea3b58658807cca9089ae.jpg
2_fovea,fold_5,2,2,1,1,0,IMG_20230512_151820_jpg.rf.2fe30b8ed1d8e20bac353cf3379cdcce.jpg
2_fovea,fold_5,9,3,3,0,-6,IMG_20230512_151055_jpg.rf.4509eabdb200535ad64add0b786d59a4.jpg
2_fovea,fold_5,3,1,1,0,-2,20230512_150026_jpg.rf.33fe35571137ce16bd8c3bd383b8db8f.jpg
2_fovea,fold_5,4,1,1,0,-3,0005_jpg.rf.024cc60176c5f8a007eca0cbdacb4691.jpg
2_fovea,fold_5,17,2,2,0,-15,20230512_151040_jpg.rf.87640fb95b74f117e81bcca0c41f76af.jpg
2_fovea,fold_5,11,3,3,0,-8,20230512_152314_jpg.rf.0becd9c30d5157c4b2a582e3fa4b759a.jpg
2_fovea,fold_5,11,6,6,0,-5,20230512_151853_jpg.rf.b5af18c1578fd0fbb73f9427792d45c0.jpg
2_fovea,fold_5,1,0,0,0,-1,20230512_150249_jpg.rf.78e9f249c2e4a31b39a078b7266ac51a.jpg
2_fovea,fold_5,22,6,3,3,-16,20230512_150104_jpg.rf.291e8ff0d311863c8ac10188b0cb1b28.jpg
2_fovea,fold_5,3,2,1,1,-1,20230512_145232_jpg.rf.f26463ccf279cd604dca1dded979fa14.jpg
2_fovea,fold_5,10,1,0,1,-9,20230512_153454_jpg.rf.a2384c87b34aeaa97bbbbd20e8b1d56b.jpg
2_fovea,fold_5,1,0,0,0,-1,20230512_151017_jpg.rf.c588fa9199c6dffdb1179f7f483c865f.jpg
2_fovea,fold_5,17,13,11,2,-4,20230512_150146_jpg.rf.e84fc4cf33f8326d64d02b7ed8cafce4.jpg
2_fovea,fold_5,6,1,0,1,-5,IMG_3850_JPG.rf.7f7105ed07be37f94ee73db7da91b99e.jpg
2_fovea,fold_5,1,0,0,0,-1,20230512_145114_jpg.rf.38c9c923c79af5172bfb7315ee2859bb.jpg
2_fovea,fold_5,1,1,0,1,0,20230512_152332_jpg.rf.4836b4b24c985755468de47d12fd4fa5.jpg
2_fovea,fold_5,6,1,0,1,-5,20230512_151136_jpg.rf.a8aef98dbb4c86bffec8ae4287c1dc6e.jpg
2_fovea,fold_5,5,4,4,0,-1,IMG_20230512_152359_jpg.rf.a5ab36a1dd0fd3e5088b4ed61c7990eb.jpg
2_fovea,fold_5,17,10,8,2,-7,IMG_4208_JPG.rf.8f59289e526ec56a405f244ebaa1a95a.jpg
2_fovea,fold_5,1,0,0,0,-1,20230512_151208_jpg.rf.0f6b66ca4ada91b2974b5945e2b92069.jpg
2_fovea,fold_5,3,2,2,0,-1,20230512_151839_jpg.rf.7e5100e585fd816285691f17e14cfcdb.jpg
2_fovea,fold_5,4,0,0,0,-4,IMG_3919_JPG.rf.9a5b0afd3da0db473f842046c5113690.jpg
2_fovea,fold_5,8,0,0,0,-8,20230512_145241_jpg.rf.455691f27dd7da4e6c25ba615f3f2620.jpg
2_fovea,fold_5,2,2,2,0,0,0230512_145355_jpg.rf.c17e94a0f80c4c06f2a620a85826ebcc.jpg
2_fovea,fold_5,1,0,0,0,-1,20230512_151504_jpg.rf.c79fb008568aeb31342688eb80ad9a49.jpg
2_fovea,fold_5,2,2,2,0,0,0029_jpg.rf.e9d3f2a53d6d73564cd418ea60fbbd61.jpg
2_fovea,fold_5,2,0,0,0,-2,20230512_151133_jpg.rf.a96da38b573a4da364c3f36aaf0c460d.jpg
2_fovea,fold_5,2,2,2,0,0,IMG_20230512_151814_jpg.rf.d8d7b03e58abeca643b8f9e71acfd81a.jpg
2_fovea,fold_5,1,0,0,0,-1,20230512_151010_jpg.rf.a46c76d923129f16810ff21ca0937475.jpg
2_fovea,fold_5,2,0,0,0,-2,0032_jpg.rf.ac745db746452e37d39279a2c8ecd454.jpg
2_fovea,fold_5,8,6,6,0,-2,20230512_151510_jpg.rf.b27f217e8ec95c059fa149f7f8f03d2b.jpg
2_fovea,fold_5,3,2,2,0,-1,IMG_20230512_151228_jpg.rf.1e509a8a9a3464432051f5ec53cc611c.jpg
2_fovea,fold_5,15,12,12,0,-3,0045_jpg.rf.b8baabd840c67f80f92a3844015afe9b.jpg
2_fovea,fold_5,13,2,2,0,-11,20230512_151047_jpg.rf.3fb94f0bd6175b2f1306a1aac0027216.jpg
2_fovea,fold_5,12,5,5,0,-7,IMG_20230512_150922_jpg.rf.e1a7736e96dfcd7e2b06e2f5c94a3cc1.jpg
2_fovea,fold_5,1,0,0,0,-1,0010_jpg.rf.d1d93d099773f36e90b527f8611d128c.jpg
2_fovea,fold_5,68,23,19,4,-45,IMG_20230512_153133_jpg.rf.b54f10d107857a0eb7fbb7943b030152.jpg
2_fovea,fold_5,1,1,0,1,0,IMG_20230512_151445_jpg.rf.853f3efcb5076d2d7bac2e663f2804bd.jpg
2_fovea,fold_5,1,0,0,0,-1,IMG_20230512_151214_161_jpg.rf.057ee941cfb105e5fd41f7e4342f657a.jpg
2_fovea,fold_5,1,0,0,0,-1,230512_150310_jpg.rf.25af60211cc7ea70d0a37dae89d778ae.jpg
2_fovea,fold_5,11,6,6,0,-5,IMG_20230512_151958_jpg.rf.c0c5a182cd6f5f4319120803cadd4e15.jpg
2_fovea,fold_5,7,1,0,1,-6,230512_150020_jpg.rf.3321ea3a69f605601bbe1180e33c4372.jpg
2_fovea,fold_5,2,2,2,0,0,20230512_151705_jpg.rf.5d4aace27e10d6b9f9dcd14c2eb80876.jpg
2_fovea,fold_5,10,4,4,0,-6,IMG_20230512_151057_jpg.rf.34b51a9edb1d08b21feec0712493ad44.jpg
2_fovea,fold_5,4,4,4,0,0,20230512_151746_jpg.rf.28bbdba7c34f11ae2fa3b6c62e25edcc.jpg
2_fovea,fold_5,12,1,1,0,-11,20230512_145147_jpg.rf.8cbc9f87bfc771396f02c8e27231d7ee.jpg
2_fovea,fold_5,5,5,5,0,0,IMG_20230512_152233_631_jpg.rf.5a6ed894f5cd8513bac1f0dfbdeb7bf3.jpg
2_fovea,fold_5,1,1,1,0,0,20230512_145424_jpg.rf.fdacfd117c87835a809a784e9019c683.jpg
2_fovea,fold_5,1,1,1,0,0,20230512_145347_jpg.rf.d1edf1d3992c10216d75faac6523aed9.jpg
2_fovea,fold_5,7,3,2,1,-4,IMG_20230512_145116_jpg.rf.89714791069678114dd234188f4e153e.jpg
2_fovea,fold_5,5,4,4,0,-1,20230512_152308_jpg.rf.f4e8f4ca110dded8e5b00937a84760be.jpg
2_fovea,fold_5,11,0,0,0,-11,IMG_4212_JPG.rf.93840a5a997c2230b8ec5404df51506e.jpg
2_fovea,fold_5,22,9,8,1,-13,20230512_150120_jpg.rf.e2c884c6c431ae355dbe5eae448fe9fe.jpg
2_fovea,fold_5,1,1,1,0,0,0035_jpg.rf.8f80b9113851faa3ce22f7a4237e063b.jpg
2_fovea,fold_5,1,0,0,0,-1,IMG_4020_JPG.rf.bc2697c76c5828734e1ac848245c5a5b.jpg
2_fovea,fold_5,6,2,2,0,-4,IMG_20230512_151224_jpg.rf.f07ca2ca5270e16cfa2d0b808d60cc7f.jpg
2_fovea,fold_5,14,7,6,1,-7,20230512_152357_jpg.rf.6852fe96763037ed9985128c109b3ce2.jpg
2_fovea,fold_5,21,8,7,1,-13,IMG_20230512_150344_jpg.rf.21eb7b1441ddc9b2740cc4367709590f.jpg
2_fovea,fold_5,2,1,0,1,-1,20230512_145054_jpg.rf.3d4529e01dd37f4f80ba26154a898555.jpg
2_fovea,fold_5,7,5,5,0,-2,20230512_152258_jpg.rf.7636714c888f4e6cbf70120b64064d40.jpg
2_fovea,fold_5,2,2,2,0,0,20230512_151841_jpg.rf.9dd3a6bca715d1085cb1da5cae6efd0f.jpg
2_fovea,fold_5,19,5,5,0,-14,20230512_150051_jpg.rf.c03c04498642818f22eb4115246bdb27.jpg
2_fovea,fold_5,2,2,2,0,0,20230512_151635_jpg.rf.ee2ff8efc5aaa53fea09028b60c05e75.jpg
2_fovea,fold_5,24,3,3,0,-21,IMG_20230512_150107_368_jpg.rf.841def69669689958248c77fd74c6ef5.jpg
2_fovea,fold_5,1,1,1,0,0,20230512_151647_jpg.rf.367411ded71931545e2f1f2799cebf0b.jpg
2_fovea,fold_5,2,0,0,0,-2,20230512_151223_jpg.rf.6a7ba0efceb9c41d056eee7ad9219353.jpg
2_fovea,fold_5,4,0,0,0,-4,20230512_145213_jpg.rf.166b2f375e79324c95dc48c23bef06fa.jpg
2_fovea,fold_5,2,0,0,0,-2,IMG_3844_JPG.rf.8a9213642776490b8b621595f6183af2.jpg
2_fovea,fold_5,14,4,0,4,-10,20230512_145202_jpg.rf.fc0b0601e248df8d80e9bb9ba998d0e7.jpg
2_fovea,fold_5,26,1,1,0,-25,0512_150040_jpg.rf.f8c148cb1d657923d62ef9d7c2a4e8c4.jpg
2_fovea,fold_5,9,8,8,0,-1,20230512_153259_jpg.rf.893deba08433f5f85baa0becc85071b1.jpg
2_fovea,fold_5,1,1,1,0,0,IMG_20230512_150840_jpg.rf.3e9980cbe445c9f1025d481e7a7a5710.jpg
2_fovea,fold_5,17,1,0,1,-16,20230512_151049_jpg.rf.7faee580bbaad04f4aee5a6edf72e5b5.jpg
2_fovea,fold_5,43,10,7,3,-33,0512_150100_jpg.rf.9eaed3be83ecba8e3e4efbdc882c1fa5.jpg
2_fovea,fold_5,2,0,0,0,-2,230512_150026_jpg.rf.633ed1e3a24d8c7ecacc82788de5c3b8.jpg
2_fovea,fold_5,3,0,0,0,-3,IMG_20230512_153013_jpg.rf.93712b9e1c24432fd87372997521847c.jpg
2_fovea,fold_5,2,0,0,0,-2,0017_jpg.rf.c3653cc70e103964ca9e6a3e85f3f694.jpg
2_fovea,fold_5,5,1,0,1,-4,20230512_151508_jpg.rf.00e90b7105d608decd85f3e850e1f875.jpg
2_fovea,fold_5,8,2,2,0,-6,IMG_20230512_150939_jpg.rf.d5260c01e2cabb005d119333eda4e87d.jpg
2_fovea,fold_5,2,0,0,0,-2,IMG_4021_JPG.rf.7556e49a1eda27532dfb6cc32c974482.jpg
2_fovea,fold_5,5,3,3,0,-2,20230512_152302_jpg.rf.016780b8da4c66843b955300975f2747.jpg
2_fovea,fold_5,34,11,9,2,-23,IMG_20230512_150128_453_jpg.rf.081da15c5e562b5ce7f42ab95339a34a.jpg
2_fovea,fold_5,1,1,1,0,0,0027_jpg.rf.041bc0af55a373703357342785fa3667.jpg
2_fovea,fold_5,1,0,0,0,-1,20230512_150050_jpg.rf.c95631863834d93e37ddc2fda8829ab4.jpg
2_fovea,fold_5,10,9,7,2,-1,IMG_20230512_153016_jpg.rf.c257848a0cea9445774e7172a68a0d16.jpg
2_fovea,fold_5,21,8,8,0,-13,20230512_152409_jpg.rf.5d8e7c06336544573f46c12fe04ef26b.jpg
2_fovea,fold_5,4,1,1,0,-3,IMG_20230512_151230_jpg.rf.77eaf1e461982f94562c61c5de9e3444.jpg
2_fovea,fold_5,3,1,1,0,-2,IMG_4192_JPG.rf.915fc04cdd59b40454fa22fea6dcf2f7.jpg
2_fovea,fold_5,1,1,1,0,0,20230512_145226_jpg.rf.d01dc6c5e4859db13d337281014a74b1.jpg
2_fovea,fold_5,1,1,1,0,0,20230512_151100_jpg.rf.8c5db2f9786fe5fedf170c30766e11a8.jpg
2_fovea,fold_5,11,8,7,1,-3,20230512_151912_jpg.rf.2dfbdab89b348f4eda01f5edbb8bf596.jpg
2_fovea,fold_5,8,3,2,1,-5,20230512_145439_jpg.rf.21c5c0c901e6a327a75c7f0dc4eafc1c.jpg
2_fovea,fold_5,1,0,0,0,-1,IMG_20230512_151206_373_jpg.rf.25070077bf672ae36c15ea6e22fdc049.jpg
2_fovea,fold_5,1,1,1,0,0,20230512_145257_jpg.rf.f1c0c8bd862cb12f380ae5d7949e68a2.jpg
2_fovea,fold_5,5,2,2,0,-3,IMG_20230512_153021_jpg.rf.c74db55af384c855422ee71d8c0c24a2.jpg
2_fovea,fold_5,20,10,8,2,-10,IMG_20230512_152355_jpg.rf.1ee2ad035e7125aadb708f8b70abd231.jpg
2_fovea,fold_5,3,6,2,4,3,20230512_152249_jpg.rf.9209f7c7b47e7778a14dc41949d8882b.jpg
2_fovea,fold_5,1,0,0,0,-1,20230512_151230_jpg.rf.ab81eae29bf9052e3dd989b36b3a00cd.jpg
2_fovea,fold_5,3,2,2,0,-1,IMG_3915_JPG.rf.83d4afabcacf1fe7976e4f01a8b55687.jpg
2_fovea,fold_5,2,2,1,1,0,IMG_3913_JPG.rf.23307ea91d746d228b58a6db32ff0bca.jpg
2_fovea,fold_5,10,6,2,4,-4,IMG_20230512_145140_jpg.rf.a089bf5c311c725d73e925fe2d7d4c66.jpg
2_fovea,fold_5,10,8,8,0,-2,20230512_151859_jpg.rf.820ed98fb886601f4f15717490003a3e.jpg
2_fovea,fold_5,3,3,3,0,0,20230512_152225_jpg.rf.889528313caa94497bf581fc9b6ec204.jpg
2_fovea,fold_5,7,5,5,0,-2,20230512_145340_jpg.rf.962ef85b90f87307d46df866e8b6be07.jpg
2_fovea,fold_5,1,0,0,0,-1,IMG_4397_JPG.rf.ff87fb693a34984f9e818a3a3a1a79b3.jpg
2_fovea,fold_5,11,10,10,0,-1,20230512_151903_jpg.rf.e84304253d71e06ad8473e1be6aa7582.jpg
2_fovea,fold_5,16,7,4,3,-9,IMG_20230512_150056_jpg.rf.65358cd23942ee92bc5024b41d26500a.jpg
2_fovea,fold_5,29,7,5,2,-22,0512_150057_jpg.rf.c228357b2bf9bb499210e8c8c7afa45b.jpg
2_fovea,fold_5,2,0,0,0,-2,20230512_153435_jpg.rf.52f71510b3fa5d1e5d0f6e2468cab216.jpg
2_fovea,fold_5,16,4,2,2,-12,IMG_20230512_145123_jpg.rf.1bbba4202dcb5637d1840db017c11671.jpg
2_fovea,fold_5,1,0,0,0,-1,20230512_153421_jpg.rf.4cb37bb0380a93d519214becab03862c.jpg
2_fovea,fold_5,16,6,6,0,-10,20230512_144939_jpg.rf.32f704ff01b8b91ab11ac16462053c96.jpg
2_fovea,fold_5,1,0,0,0,-1,20230512_151453_jpg.rf.fc89aea08c4953e972d355bc593bd6ae.jpg
2_fovea,fold_5,1,0,0,0,-1,IMG_4019_JPG.rf.13ea285b754475b580f840ba9fc99608.jpg
2_fovea,fold_5,5,4,4,0,-1,20230512_152320_jpg.rf.373cf359be94c413709d04995faada1e.jpg
2_fovea,fold_5,1,0,0,0,-1,IMG_20230512_145029_jpg.rf.7bf65ac7d5d4f934ebfd179e7ad97968.jpg
2_fovea,fold_5,2,2,2,0,0,0049_jpg.rf.d9e63c2316d02b96968a7dd44061b337.jpg
2_fovea,fold_5,1,0,0,0,-1,230512_150124_jpg.rf.a1dce64e321706af2f260a6b933ae5d1.jpg
2_fovea,fold_5,1,0,0,0,-1,20230512_145108_jpg.rf.cfa16a281bcee146efbf5aac473021a3.jpg
2_fovea,fold_5,3,0,0,0,-3,20230512_145127_jpg.rf.2e6c583887c26feb5d54542c0b963ea1.jpg
2_fovea,fold_5,7,1,0,1,-6,IMG_20230512_151451_jpg.rf.2218d423d5bccf8392a803b3052b5d3b.jpg
2_fovea,fold_5,5,3,3,0,-2,0230512_145345_jpg.rf.349c9a4b5a46e8d3477462f4e4215cba.jpg
2_fovea,fold_5,11,8,8,0,-3,20230512_151908_jpg.rf.b315ad5e28b7bf0551708d4ea9d3dd39.jpg
2_fovea,fold_5,12,3,3,0,-9,20230512_152237_jpg.rf.808fe6741a783c4fa83bfabf79676eac.jpg
2_fovea,fold_5,1,1,1,0,0,20230512_151806-0-_jpg.rf.ee8c0cb2ceb0752fb58a7e8380a489b8.jpg
2_fovea,fold_5,5,3,3,0,-2,20230512_152311_jpg.rf.5e824954dc303eba4a13e80481374d92.jpg
2_fovea,fold_5,5,1,0,1,-4,IMG_20230512_151619_jpg.rf.602d997ec01411a318e031faecec475a.jpg
2_fovea,fold_5,8,5,4,1,-3,20230512_150205_jpg.rf.af4ff5234c4e2039ba4aa43dfef61137.jpg
2_fovea,fold_5,1,1,1,0,0,20230512_151641_jpg.rf.9d3677c71aedef7846514f40d39cc285.jpg
2_fovea,fold_5,1,0,0,0,-1,IMG_4396_JPG.rf.a6ca21b5c9e64200051d628058fac8d3.jpg
2_fovea,fold_5,4,3,3,0,-1,IMG_20230512_151255_jpg.rf.7a344a314dbceac482eaa7344270d575.jpg
2_fovea,fold_5,3,1,1,0,-2,20230512_145413_jpg.rf.d92c86a64c63fad8780cddf8f9af65d7.jpg
2_fovea,fold_5,15,8,7,1,-7,IMG_20230512_153000_904_jpg.rf.0910e6a7b929687a7f2cb7d8110febe6.jpg
2_fovea,fold_5,3,3,2,1,0,IMG_3864_JPG.rf.0b9655ea20ce691d9f9006c6ab150d3c.jpg
2_fovea,fold_5,10,5,3,2,-5,230512_145026_jpg.rf.f23932c58f897cb3d0594cc7af5c44f4.jpg
2_fovea,fold_5,6,1,1,0,-5,230512_150021_jpg.rf.9f8dde8cf7d3e52b983f2e1dee1f56d6.jpg
2_fovea,fold_5,21,10,10,0,-11,20230512_152319_jpg.rf.3d825a3794a8b316d78f9af2806a7c6c.jpg
2_fovea,fold_5,1,1,1,0,0,20230512_152353_jpg.rf.ed8431bc0af772a21f7e6f7b52b33d4e.jpg
2_fovea,fold_5,10,6,6,0,-4,20230512_151345_jpg.rf.4dd52a96ef715b94641151e55cadac59.jpg
2_fovea,fold_5,6,3,3,0,-3,20230512_145401_jpg.rf.44167fa74f8667ec2ab9d47632567ba8.jpg
2_fovea,fold_6,1,0,0,0,-1,IMG_3918_JPG.rf.73a732415980a079e2ee9f088f0b902b.jpg
2_fovea,fold_6,3,0,0,0,-3,20230512_150304_jpg.rf.42997b281c38f2d2e1caa252c8202466.jpg
2_fovea,fold_6,1,0,0,0,-1,20230512_145018_jpg.rf.6120633e9f3b01a0322386f7107b3216.jpg
2_fovea,fold_6,2,3,1,2,1,IMG_20230512_151746_jpg.rf.e11cc2bdd754b8c380d4b2f51b494333.jpg
2_fovea,fold_6,1,0,0,0,-1,IMG_3859_JPG.rf.217ab58b1022e7dbdcc07a4a48bdf055.jpg
2_fovea,fold_6,3,0,0,0,-3,20230512_151142_jpg.rf.959c44ca45dfd6e8f7458240928724a4.jpg
2_fovea,fold_6,7,7,6,1,0,IMG_20230512_153034_jpg.rf.d2546314233e70df166dd444373fe566.jpg
2_fovea,fold_6,39,2,1,1,-37,20230512_150259_jpg.rf.640d17e1a5cec14371d2ef32c74c215b.jpg
2_fovea,fold_6,1,1,1,0,0,20230512_151613-0-_jpg.rf.d6f5456bcfe941a2766b34ca25d6e64c.jpg
2_fovea,fold_6,1,0,0,0,-1,20230512_151247_jpg.rf.559bbd96f04ed0b61011356b33038efb.jpg
2_fovea,fold_6,12,11,11,0,-1,20230512_151901-0-_jpg.rf.23717847adee37125505701d84f8b2c4.jpg
2_fovea,fold_6,2,2,2,0,0,0230512_145403_jpg.rf.86e849309856a70f7343d14e0be80d1f.jpg
2_fovea,fold_6,18,9,7,2,-9,20230512_150212-0-_jpg.rf.42aaa169dabc6e224af1ad2603fa77d9.jpg
2_fovea,fold_6,1,1,1,0,0,IMG_20230512_150958_jpg.rf.806f513ed04cbf893c8a805d028e17a5.jpg
2_fovea,fold_6,6,1,0,1,-5,IMG_20230512_150849_517_jpg.rf.8292597aeb2edd9ad9a8634d1e6ce325.jpg
2_fovea,fold_6,5,6,2,4,1,20230512_153406_jpg.rf.5fd9ed7f498c063bbe363af58bf64afe.jpg
2_fovea,fold_6,1,1,1,0,0,20230512_145139_jpg.rf.1ccaa55656a3b72abb079fcaca9ebd91.jpg
2_fovea,fold_6,9,4,3,1,-5,20230512_145207_jpg.rf.d6520c0b52ca9d11cbdb08e7fcad7279.jpg
2_fovea,fold_6,1,1,1,0,0,20230512_151709_jpg.rf.67e1deefca206f50f10d35552ae2213f.jpg
2_fovea,fold_6,9,7,7,0,-2,20230512_152229_jpg.rf.f718118201e6c3b0a3b3d89958725c05.jpg
2_fovea,fold_6,18,4,2,2,-14,20230512_151030_jpg.rf.99cd8001fdf2562bbd43c3e28ec3bc18.jpg
2_fovea,fold_6,1,1,1,0,0,0016_jpg.rf.2a262f7303067736073549486906cc43.jpg
2_fovea,fold_6,1,1,1,0,0,20230512_151651_jpg.rf.d9eebb8d47a3a2ecc2b5ab5fce867c62.jpg
2_fovea,fold_6,3,2,2,0,-1,IMG_20230512_151216_jpg.rf.212dba7457c89d85163142d3417d011a.jpg
2_fovea,fold_6,2,0,0,0,-2,20230512_151754_jpg.rf.54ba86e6a384ea604ca2e9b48b6baaf5.jpg
2_fovea,fold_6,7,4,1,3,-3,MG_20230512_145052_jpg.rf.e48facc3a59ffc87c5c20e1e858d782f.jpg
2_fovea,fold_6,1,0,0,0,-1,20230512_145105_jpg.rf.773b834198bf17c51531470842565757.jpg
2_fovea,fold_6,2,1,0,1,-1,20230512_150310_jpg.rf.1c8474c411cc1309fdcb6f4f05ad76e7.jpg
2_fovea,fold_6,11,2,2,0,-9,IMG_20230512_151242_jpg.rf.46afd180ee87359123f370468c16ecd9.jpg
2_fovea,fold_6,7,1,0,1,-6,IMG_20230512_150822_610_jpg.rf.202648ab81c8a246ef6e9d92f76fc793.jpg
2_fovea,fold_6,13,9,8,1,-4,0230512_150158_jpg.rf.87404c9e49a82e56c7dade7c3898effc.jpg
2_fovea,fold_6,3,3,2,1,0,20230512_145214_jpg.rf.7dff106d138e1a8492bda9d8a939f1df.jpg
2_fovea,fold_6,12,2,2,0,-10,20230512_150028_jpg.rf.af876dc827626d5f87a6fe1e271ef879.jpg
2_fovea,fold_6,10,5,3,2,-5,20230512_150924_jpg.rf.e5426caf129241e7f71edfd6460ffb7b.jpg
2_fovea,fold_6,36,16,15,1,-20,IMG_20230512_150302_jpg.rf.9b111acf170d8c1671212ec46ca5f96b.jpg
2_fovea,fold_6,2,1,0,1,-1,IMG_3855_JPG.rf.3c07d7a3a717987d18e4881f741f0109.jpg
2_fovea,fold_6,42,16,7,9,-26,0002_jpg.rf.e28c19f2eeb804b4f3db5cb8a9b96722.jpg
2_fovea,fold_6,2,3,2,1,1,20230512_151519_jpg.rf.a798ec75f634d9c0b2099d74e6391b2f.jpg
2_fovea,fold_6,1,0,0,0,-1,20230512_145231_jpg.rf.5067ec9a11eb10e94f1992fa7b9fdca9.jpg
2_fovea,fold_6,6,5,4,1,-1,20230512_151813_jpg.rf.8e04e5f09260558a80ad8ed222a6842d.jpg
2_fovea,fold_6,17,14,13,1,-3,0039_jpg.rf.24da2dcb61a34ae88e4e3ae85334ec49.jpg
2_fovea,fold_6,2,0,0,0,-2,IMG_4016_JPG.rf.57796edbcc20ef6bb7930ae2c9b790e7.jpg
2_fovea,fold_6,9,5,3,2,-4,0230512_150107_jpg.rf.255ebb7bf873cd1fb62870dd946c636b.jpg
2_fovea,fold_6,1,1,1,0,0,IMG_4045_JPG.rf.5fd568888c253fc15e61ef0e6a600736.jpg
2_fovea,fold_6,2,1,0,1,-1,20230512_151706_jpg.rf.a1ec45640c8ceaf421bdd396abbff09a.jpg
2_fovea,fold_6,5,1,0,1,-4,IMG_20230512_150931_075_jpg.rf.e33516383d2c37617b8a3623da6f46df.jpg
2_fovea,fold_6,2,1,1,0,-1,20230512_150045-0-_jpg.rf.e0a79a709ca27bbd1ddee5f8a4336ea8.jpg
2_fovea,fold_6,5,4,4,0,-1,20230512_152227_jpg.rf.0537631b05bb432698dc401e82e41cdd.jpg
2_fovea,fold_6,6,5,5,0,-1,20230512_151547_jpg.rf.11083d91d633eac77747e3332d593385.jpg
2_fovea,fold_6,12,1,0,1,-11,20230512_151043_jpg.rf.3411f895e2985588186e8495e99b2a5d.jpg
2_fovea,fold_6,2,0,0,0,-2,20230512_150754_jpg.rf.25cdffe09e3da5825e5287e9707d28b7.jpg
2_fovea,fold_6,2,1,1,0,-1,20230512_150054_jpg.rf.d397e2f4f89585ae423d36316b68e0d3.jpg
2_fovea,fold_6,1,1,1,0,0,20230512_151658_jpg.rf.64accf87df1b759e733862bd5826d73c.jpg
2_fovea,fold_6,9,4,4,0,-5,20230512_150251_jpg.rf.5e1c1bb0e6397c87b2959920705bf3e4.jpg
2_fovea,fold_6,1,0,0,0,-1,20230512_145027_jpg.rf.ec568ee157ffdc70fa125022bd4e2226.jpg
2_fovea,fold_6,24,18,13,5,-6,IMG_3929_JPG.rf.a2180d03c20d1cfeece3cc8d116bef58.jpg
2_fovea,fold_6,6,4,4,0,-2,IMG_20230512_145356_jpg.rf.aade91e03425891ebb1e7913c596a6bb.jpg
2_fovea,fold_6,4,2,1,1,-2,20230512_151320_jpg.rf.000a402e9a61ca254ddb3eb836b8d52e.jpg
2_fovea,fold_6,1,3,2,1,2,20230512_150053_jpg.rf.088308ae98c13a53c0cd09a0c5d7873d.jpg
2_fovea,fold_6,2,1,1,0,-1,IMG_4030_JPG.rf.d581bcd4c0908b4512a05d8d538db640.jpg
2_fovea,fold_6,2,0,0,0,-2,20230512_145101_jpg.rf.2e2ab39bfad17ac6cf7a40fbca0233b7.jpg
2_fovea,fold_6,11,2,2,0,-9,20230512_151319_jpg.rf.95cf4d71c19232b1c36b69b6329abdb6.jpg
2_fovea,fold_6,1,1,1,0,0,20230512_145222_jpg.rf.dc5b10230a198c45f4f849d8bea6cf45.jpg
2_fovea,fold_6,13,9,9,0,-4,0003_jpg.rf.a4014333632a8045d62b2480bccb288b.jpg
2_fovea,fold_6,21,14,8,6,-7,IMG_20230512_150346_jpg.rf.5eb42adbd89cd335587264e87d4a07ea.jpg
2_fovea,fold_6,2,2,1,1,0,20230512_151742_jpg.rf.734b217dddc054e2dbb00d9964713986.jpg
2_fovea,fold_6,1,0,0,0,-1,20230512_145328_jpg.rf.dcfa7faebf8b77528401b336abf6eaad.jpg
2_fovea,fold_6,5,4,4,0,-1,20230512_145335_jpg.rf.896d2a48efad0e17923f2fec260761b0.jpg
2_fovea,fold_6,4,0,0,0,-4,IMG_4386_JPG.rf.642872f82064187dff74f15b1ff0a923.jpg
2_fovea,fold_6,2,0,0,0,-2,20230512_150049_jpg.rf.e1512981920c32d09de9c291359753fd.jpg
2_fovea,fold_6,2,0,0,0,-2,IMG_3848_JPG.rf.6bccac66dae879c76b4ff16dd5be0243.jpg
2_fovea,fold_6,4,1,0,1,-3,0230512_145343_jpg.rf.fcd20fb05b55e0279971dbad416be7a2.jpg
2_fovea,fold_6,5,1,1,0,-4,IMG_4092_JPG.rf.3e9ac49e2c6b51adac2c75ecdf6ebc5b.jpg
2_fovea,fold_6,5,4,1,3,-1,20230512_150110_jpg.rf.36e77e8ab39d8ce0cccdd59c9e84ceca.jpg
2_fovea,fold_6,2,1,1,0,-1,IMG_20230512_150928_jpg.rf.713e71e29e1ae02d5cdba88b3134bae9.jpg
2_fovea,fold_6,3,0,0,0,-3,230512_150127_jpg.rf.85daac8693c9a5866ff2f7839d81d2e8.jpg
2_fovea,fold_6,2,3,2,1,1,20230512_145048_jpg.rf.6202c446935381c48cf520aa5c6640f6.jpg
2_fovea,fold_6,16,3,0,3,-13,IMG_3930_JPG.rf.7a6e996e69e203ed4aa5de3126a2d2ee.jpg
2_fovea,fold_6,10,8,7,1,-2,20230512_152223_jpg.rf.9ee2de301ef5a2a10d57b30f309a7d84.jpg
2_fovea,fold_6,7,4,3,1,-3,IMG_4057_JPG.rf.62dc219aee41c1e1eeb47a2bd511e5f0.jpg
2_fovea,fold_6,29,13,10,3,-16,0512_150154_jpg.rf.6ab493c468717275a5b2b74420a88180.jpg
2_fovea,fold_6,13,7,5,2,-6,IMG_20230512_153036_jpg.rf.92b3c0599c74bfff25f17f2e97011b27.jpg
2_fovea,fold_6,4,0,0,0,-4,0230512_145357_jpg.rf.bb3b0c47d3344c5f0714c51d50f9eab8.jpg
2_fovea,fold_6,6,3,3,0,-3,20230512_145337_jpg.rf.eb0881ecd757c868e839b7663c8ec930.jpg
2_fovea,fold_6,1,0,0,0,-1,230512_150306_jpg.rf.57428899933c6b401506a61768585669.jpg
2_fovea,fold_6,3,3,2,1,0,20230512_151543_jpg.rf.10d24602404882d9cc93169ca45912de.jpg
2_fovea,fold_6,101,9,9,0,-92,0108_jpg.rf.e585b32f135131ce6476b6962a9dbad4.jpg
2_fovea,fold_6,18,11,11,0,-7,20230512_152242_jpg.rf.db9cf140b85724a386050e2debe57fa2.jpg
2_fovea,fold_6,8,4,4,0,-4,20230512_145153_jpg.rf.31de3120042ffe1cc96af5b129c48c8d.jpg
2_fovea,fold_6,2,1,1,0,-1,20230512_151240_jpg.rf.d86e0b8b1457d5a8b4c4c2db8c1e9b84.jpg
2_fovea,fold_6,2,0,0,0,-2,20230512_145338_jpg.rf.210a3a3cfad0b0ee89036fcc677c1076.jpg
2_fovea,fold_6,4,4,4,0,0,IMG_4094_JPG.rf.fc1f6e86b3b032266a05b3508e461113.jpg
2_fovea,fold_6,2,1,1,0,-1,IMG_20230512_151944_jpg.rf.d5aeefc60fa0f36a43c0496ef0aef803.jpg
2_fovea,fold_6,3,2,2,0,-1,20230512_145339_jpg.rf.bf7369afe55b64f770770e2bc84385eb.jpg
2_fovea,fold_6,18,15,13,2,-3,IMG_20230512_152305_jpg.rf.12f543505870e65321b9087ee0584124.jpg
2_fovea,fold_6,2,0,0,0,-2,IMG_4025_JPG.rf.8d3de7ea571de848fc149e176c6897c3.jpg
2_fovea,fold_6,1,0,0,0,-1,20230512_151505-0-_jpg.rf.55f9872a1224dfaeaf8fca6da2616e98.jpg
2_fovea,fold_6,20,1,1,0,-19,IMG_20230512_150212_422_jpg.rf.e76cd69c3a527a0ab898b69fef489876.jpg
2_fovea,fold_6,6,3,2,1,-3,20230512_150139_jpg.rf.84eb5a1f5ed3efe7d09bc7dd51a476e8.jpg
2_fovea,fold_6,2,0,0,0,-2,20230512_145013_jpg.rf.5b923d696845fee91efca209fb16b8b7.jpg
2_fovea,fold_6,2,0,0,0,-2,20230512_153004_jpg.rf.362642eaeb26a8549f4da1202eebd478.jpg
2_fovea,fold_6,15,1,0,1,-14,20230512_153313_jpg.rf.77943aee7a7bf04a3db49e3f4dc00814.jpg
2_fovea,fold_6,1,0,0,0,-1,20230512_153355_jpg.rf.8223bc454d4e607609c33d5982f02df2.jpg
2_fovea,fold_6,11,5,4,1,-6,20230512_151544_jpg.rf.3baf349b8c061da5ae2bbe4333bd3506.jpg
2_fovea,fold_6,4,2,1,1,-2,IMG_20230512_151443_jpg.rf.72eb3bb7a6af81a16f5db60357cc4e37.jpg
2_fovea,fold_6,18,12,12,0,-6,IMG_20230512_152317_jpg.rf.7f9c7624fac8ec2441ebdd0d2ba16ec5.jpg
2_fovea,fold_6,3,2,2,0,-1,IMG_20230512_145132_jpg.rf.d215e294ca9ff5ec89558b9b78083b48.jpg
2_fovea,fold_6,2,2,2,0,0,0230512_145400_jpg.rf.2839dc03d44af92c89a92bc7b644ab85.jpg
2_fovea,fold_6,1,0,0,0,-1,20230512_150224_jpg.rf.f64a4cfe331fa0a225b85de2782b4b40.jpg
2_fovea,fold_6,1,1,1,0,0,IMG_20230512_151810_jpg.rf.82616c1ceb56e348dbbddc1a08161690.jpg
2_fovea,fold_6,1,1,1,0,0,20230512_145333_jpg.rf.afbd586b0c1d9f54c3d3ea178568eb9d.jpg
2_fovea,fold_6,5,3,2,1,-2,230512_150144_jpg.rf.17c847f6562b5ceb1d19a0239be452dc.jpg
2_fovea,fold_6,5,1,1,0,-4,20230512_153523_jpg.rf.94e20d7417dcd4856650e05b3a708e35.jpg
2_fovea,fold_6,17,10,10,0,-7,IMG_20230512_152414_jpg.rf.2a84950ae556ac2909c0e739dbdb963e.jpg
2_fovea,fold_6,7,6,6,0,-1,IMG_4101_JPG.rf.8c4f8e4e10187eb9df93264151a1ed8d.jpg
2_fovea,fold_6,4,0,0,0,-4,230512_145050_jpg.rf.c9c628742a57d86b1f31849454a8559b.jpg
2_fovea,fold_6,2,2,2,0,0,20230512_151702_jpg.rf.0456f0fe756386f89c4b23d655ea901b.jpg
2_fovea,fold_6,13,6,2,4,-7,20230512_150113_jpg.rf.3a5a13ac96bac5c0e6e2c49bc83c904b.jpg
2_fovea,fold_6,11,2,2,0,-9,20230512_151044_jpg.rf.bd2efab172db3bb0ca6ce2ff37f6a8ca.jpg
2_fovea,fold_6,3,1,1,0,-2,20230512_145339-0-_jpg.rf.fea54fcbceb00e71f078268b9b40d178.jpg
2_fovea,fold_6,1,0,0,0,-1,20230512_150234_jpg.rf.f07768807cd91c66efa0a831a47227f2.jpg
2_fovea,fold_6,1,1,1,0,0,20230512_152328_jpg.rf.2ee5fc7202b8e73c23dedf7899bfd23d.jpg
2_fovea,fold_6,1,1,1,0,0,20230512_150736_jpg.rf.86dffaa733e76af31361da63d1f9c5be.jpg
2_fovea,fold_6,1,0,0,0,-1,IMG_20230512_151152_632_jpg.rf.e78de54f18056ed239e1e53f8b27b606.jpg
2_fovea,fold_6,1,0,0,0,-1,IMG_20230512_145000_jpg.rf.08a86ebaadb5647031d884039f76ad3d.jpg
2_fovea,fold_6,5,4,4,0,-1,MG_20230512_145246_jpg.rf.c35a60cd9e1280159604c5915a9e199e.jpg
2_fovea,fold_6,1,1,1,0,0,20230512_151222_jpg.rf.77904cc81033fc2ad3a414b07b9c1b2e.jpg
2_fovea,fold_6,14,8,4,4,-6,IMG_20230512_145147_jpg.rf.8cac9a120dccf5b1ce92992c1c714c4d.jpg
2_fovea,fold_6,18,6,6,0,-12,0201_jpg.rf.517ca1ec56a693f7c628bd07b5acdfc2.jpg
2_fovea,fold_6,1,1,1,0,0,20230512_151615_jpg.rf.3d0f727d5e2b61ba73995558758dffb3.jpg
2_fovea,fold_6,6,5,5,0,-1,IMG_4097_JPG.rf.4f85a4c675f81cdca11f141abb8d7c2d.jpg
2_fovea,fold_6,2,1,0,1,-1,20230512_151705-0-_jpg.rf.3ca3d09e046dc693a1fb88dca9ebaa3b.jpg
2_fovea,fold_6,2,0,0,0,-2,20230512_153408_jpg.rf.b5d7a9cb1b0260613799e2d57092c4ec.jpg
2_fovea,fold_6,1,0,0,0,-1,IMG_20230512_151127_629_jpg.rf.f41df076266191a6a8a7eca7b189e061.jpg
2_fovea,fold_6,1,1,1,0,0,0028_jpg.rf.2103488effe87e7c2da4cf07f6ed7f75.jpg
2_fovea,fold_6,4,1,1,0,-3,IMG_4054_JPG.rf.c3d803491fea4d419a745a606ab372e6.jpg
2_fovea,fold_6,6,4,4,0,-2,0061_jpg.rf.9c87cf09deaf73a61f5ac233c2bdb702.jpg
2_fovea,fold_6,1,0,0,0,-1,20230512_145032_jpg.rf.a2eb942256aef666c2ddc91b6c22b7a5.jpg
2_fovea,fold_6,1,1,1,0,0,20230512_145138_jpg.rf.04549600bf4eee12b13c6119d3c35a78.jpg
2_fovea,fold_6,3,3,1,2,0,20230512_150019_jpg.rf.3831013b1b3289f609c139cb5b3ee2d0.jpg
2_fovea,fold_6,5,2,2,0,-3,IMG_20230512_151248_jpg.rf.fd83e7f5d0f84675cb06da482f588b3b.jpg
2_fovea,fold_6,1,0,0,0,-1,20230512_150810_jpg.rf.ca47a1fafa212b60e926b93e5eb8674b.jpg
2_fovea,fold_6,5,3,2,1,-2,20230512_145436_jpg.rf.f86063716cf890f2f2412ed2bc009f84.jpg
2_fovea,fold_6,12,4,2,2,-8,20230512_150103_jpg.rf.7c63165e8e1129a671cb603fa47109d8.jpg
2_fovea,fold_6,1,0,0,0,-1,0019_jpg.rf.f929e8c0a480b1ec40d48ffa32427490.jpg
2_fovea,fold_6,15,3,3,0,-12,20230512_151327_jpg.rf.d5fc64b9888dff7235c7da7317d07fc0.jpg
2_fovea,fold_6,15,5,4,1,-10,20230512_145239_jpg.rf.36d4ca0350293c4011bd19f94bc7867d.jpg
2_fovea,fold_6,9,3,2,1,-6,IMG_20230512_151048_jpg.rf.c92aa7d50112ca96c1f3bdd418f74d1c.jpg
2_fovea,fold_6,1,0,0,0,-1,IMG_3917_JPG.rf.7696994544924bd6d81ad9d1ace3f843.jpg
2_fovea,fold_6,5,2,2,0,-3,20230512_150057_jpg.rf.8739eeb8744698e06d085991ee1483d5.jpg
2_fovea,fold_6,7,2,2,0,-5,IMG_20230512_151223_jpg.rf.af08f6dc665fcecd42728873d339f65f.jpg
2_fovea,fold_6,9,5,5,0,-4,IMG_20230512_145259_jpg.rf.655fa0eaa10935cb21a8b2452c556c92.jpg
2_fovea,fold_6,2,0,0,0,-2,IMG_20230512_145024_jpg.rf.48184e0191f6dc0deaabedad53f15496.jpg
2_fovea,fold_6,13,11,9,2,-2,IMG_20230512_152228_454_jpg.rf.41bea2902570b7445e0f1ec3abc4a012.jpg
2_fovea,fold_6,3,0,0,0,-3,230512_150042_jpg.rf.333656aaee32bab812e48513c9f469d1.jpg
2_fovea,fold_6,2,1,1,0,-1,20230512_145431_jpg.rf.026561e5d2d5a23868267be144014c1a.jpg
2_fovea,fold_6,2,1,1,0,-1,IMG_4029_JPG.rf.5a655364af1d770d5e464fd022215d30.jpg
2_fovea,fold_7,12,10,10,0,-2,IMG_20230512_152242_316_jpg.rf.640eb728992e501ad35261a525ddcd6f.jpg
2_fovea,fold_7,21,7,7,0,-14,20230512_153312_jpg.rf.9bc8be12c2f1c3b853b5dd7ce2de2445.jpg
2_fovea,fold_7,1,0,0,0,-1,IMG_4043_JPG.rf.3fd3ae2706b1bd88e07090f3f20fe829.jpg
2_fovea,fold_7,1,0,0,0,-1,20230512_145250_jpg.rf.effdab3112b728049f9a595e68cc1fbe.jpg
2_fovea,fold_7,2,0,0,0,-2,IMG_3845_JPG.rf.99db8c1cc5267eb444c95ebe84cd88ba.jpg
2_fovea,fold_7,2,2,2,0,0,20230512_151759-0-_jpg.rf.9397d17b6e9b50b8b3327c1f6e7e4e13.jpg
2_fovea,fold_7,23,5,5,0,-18,20230512_153047_jpg.rf.c2e7222d0e6d439a279014b9de708707.jpg
2_fovea,fold_7,1,0,0,0,-1,IMG_20230512_144936_jpg.rf.02a75ef0c1666837558e6b5e99086463.jpg
2_fovea,fold_7,4,2,1,1,-2,IMG_20230512_145250_052_jpg.rf.22501a15b7ee521908502f0562f1943b.jpg
2_fovea,fold_7,1,0,0,0,-1,IMG_20230512_151943_jpg.rf.245470432c5353d43170f1aa8d72aa47.jpg
2_fovea,fold_7,15,7,7,0,-8,20230512_152312_jpg.rf.27e0a448e297ab33c52fb903a0a61757.jpg
2_fovea,fold_7,22,4,2,2,-18,IMG_20230512_150103_jpg.rf.0a6f19ce6332956f8b29791a9f2bfd27.jpg
2_fovea,fold_7,18,0,0,0,-18,20230512_150003_jpg.rf.4bee1a84712696acd3c6434f86ac8310.jpg
2_fovea,fold_7,3,0,0,0,-3,20230512_150158_jpg.rf.38b8f697e558e1ec0f9c87c946a7c86d.jpg
2_fovea,fold_7,3,1,1,0,-2,20230512_145319_jpg.rf.cd5fadb6c5fddffa67d73b8b37272f64.jpg
2_fovea,fold_7,30,0,0,0,-30,20230512_150004_jpg.rf.495dbb753fb5fd527e14101c52213803.jpg
2_fovea,fold_7,1,1,1,0,0,20230512_151613_jpg.rf.e0b45cee6190ca8866233157c4462548.jpg
2_fovea,fold_7,0,14,0,14,14,IMG_20230512_150254_jpg.rf.a5c0f01d411bde413dbb553e6557c16f.jpg
2_fovea,fold_7,2,1,0,1,-1,IMG_20230512_145306_094_jpg.rf.09cc5cc7fd6ffa704dffb84466385562.jpg
2_fovea,fold_7,16,8,7,1,-8,20230512_152241_jpg.rf.9b0739a668aaaecd1a1d3e7bf8b2688f.jpg
2_fovea,fold_7,1,1,1,0,0,20230512_145417_jpg.rf.db3be61a74c7e02c4d1054b72f46745b.jpg
2_fovea,fold_7,7,5,4,1,-2,20230512_151546_jpg.rf.650e7a29638d0dabdf27fcfefcab07cb.jpg
2_fovea,fold_7,3,3,3,0,0,20230512_152322_jpg.rf.53fd89be056ce49374a18ace4aa4f447.jpg
2_fovea,fold_7,2,1,1,0,-1,20230512_150824_jpg.rf.9590430380cde837c5b86f877c2bf080.jpg
2_fovea,fold_7,1,0,0,0,-1,20230512_151604_jpg.rf.39e93e2b60bed55a4fb26d60d17f81ce.jpg
2_fovea,fold_7,6,6,5,1,0,20230512_152250_jpg.rf.0c23d9c9105722daa1a62bbed8129065.jpg
2_fovea,fold_7,10,3,3,0,-7,20230512_153314_jpg.rf.fdc2e0650616a2e23fae79ddbc6b98bb.jpg
2_fovea,fold_7,1,1,1,0,0,20230512_151540_jpg.rf.6fc0f7a0e69e619bbef3fea84a825105.jpg
2_fovea,fold_7,9,1,1,0,-8,IMG_20230512_150115_jpg.rf.93d6ec31991ffdb896e9bf82280f1f99.jpg
2_fovea,fold_7,19,3,2,1,-16,20230512_150010_jpg.rf.620f860344c0524a1ea0d2095e555387.jpg
2_fovea,fold_7,1,0,0,0,-1,0230512_145318_jpg.rf.98f8a12ed2e48f7e62edcc542f5a7a3b.jpg
2_fovea,fold_7,9,2,2,0,-7,20230512_151513_jpg.rf.9ba62843997a0b42cb30d66d35cfe761.jpg
2_fovea,fold_7,2,1,1,0,-1,20230512_145051_jpg.rf.603261488d01ac12c49ce95447252a07.jpg
2_fovea,fold_7,3,3,3,0,0,20230512_151745_jpg.rf.26e57cd112d09282bbedc612b9e3bddc.jpg
2_fovea,fold_7,29,9,7,2,-20,IMG_20230512_150104_jpg.rf.d5cb8950b8524a6e8b69b37121f816be.jpg
2_fovea,fold_7,11,9,8,1,-2,IMG_20230512_151854_jpg.rf.96120163430ff0d69f2a3b4c65cf13be.jpg
2_fovea,fold_7,1,1,1,0,0,20230512_151443_jpg.rf.02c0d1f9196b0a7db17357b113fa32ed.jpg
2_fovea,fold_7,4,4,4,0,0,0059_jpg.rf.9ac56781472ffe9dda122b176baf1512.jpg
2_fovea,fold_7,8,4,3,1,-4,IMG_20230512_145441_jpg.rf.6b7c2d8bfc0ced9198b112d0d6ade7e2.jpg
2_fovea,fold_7,11,3,2,1,-8,20230512_145235_jpg.rf.7588a0153c1b25a775a82b15cb976f2d.jpg
2_fovea,fold_7,1,1,1,0,0,IMG_20230512_151147_269_jpg.rf.6170f9ba05705d7d45cbb1c21073f67c.jpg
2_fovea,fold_7,3,1,0,1,-2,20230512_150145_jpg.rf.8935abf1c95d41b2b953913a4d6f31f7.jpg
2_fovea,fold_7,14,11,10,1,-3,IMG_20230512_152216_096_jpg.rf.adf03897848531ce89d004439a8fa974.jpg
2_fovea,fold_7,13,1,0,1,-12,IMG_20230512_150128_jpg.rf.4b6044488f522150e791a223d8868723.jpg
2_fovea,fold_7,15,10,9,1,-5,20230512_151529_jpg.rf.13e844f081c4efeefda4af063187f6d3.jpg
2_fovea,fold_7,1,0,0,0,-1,20230512_151036_jpg.rf.f3b838a0faab4c3495dd44281c87539d.jpg
2_fovea,fold_7,1,0,0,0,-1,IMG_20230512_150926_jpg.rf.592b75864e594302b259312be28a0792.jpg
2_fovea,fold_7,6,2,2,0,-4,IMG_20230512_150317_jpg.rf.ac25b1898213749cb0686c2bc3130301.jpg
2_fovea,fold_7,4,2,1,1,-2,0004_jpg.rf.cad1f4f7c2a5a911d6d1cdfa5f75d055.jpg
2_fovea,fold_7,6,3,2,1,-3,20230512_150135_jpg.rf.d4fd2dcfb498280a8309f6f9fbf3b816.jpg
2_fovea,fold_7,11,4,4,0,-7,IMG_20230512_151556_798_jpg.rf.64e451fae797a84c7394203ef45fb0a5.jpg
2_fovea,fold_7,13,6,6,0,-7,IMG_20230512_152158_858_jpg.rf.1a8b5fd8c9168917604cd153b5720b1d.jpg
2_fovea,fold_7,37,8,8,0,-29,0512_150144_jpg.rf.eb6f48f566e7b2e533d3c169bb9783b0.jpg
2_fovea,fold_7,1,1,1,0,0,20230512_151643_jpg.rf.cd8dd51a7f1332798879f4e5d7e928f6.jpg
2_fovea,fold_7,3,0,0,0,-3,20230512_150301_jpg.rf.9f5a1e2491eb0f23ad2976622defdd66.jpg
2_fovea,fold_7,1,0,0,0,-1,20230512_145434_jpg.rf.c6e724cc40d69fabc8ce6dc7f102385b.jpg
2_fovea,fold_7,3,0,0,0,-3,0230512_145050_jpg.rf.2803b267b643801d5d6b63fa2d927f37.jpg
2_fovea,fold_7,1,0,0,0,-1,IMG_20230512_144948_jpg.rf.982c926a32fe1a245ffd566259fcb9bb.jpg
2_fovea,fold_7,6,2,2,0,-4,20230512_152308_jpg.rf.bfaaf2477f56005e5db4ac2d8a0dd0a7.jpg
2_fovea,fold_7,1,1,0,1,0,20230512_144954_jpg.rf.b91c4aef38ae9c4f6e5c0bcc155cdbb9.jpg
2_fovea,fold_7,2,0,0,0,-2,20230512_145012_jpg.rf.7e7325fc33c5f9d9c92a4f4f8c48bd73.jpg
2_fovea,fold_7,3,3,3,0,0,20230512_151626_jpg.rf.ce9aac74e8994e1b51e9f517df6a0830.jpg
2_fovea,fold_7,6,3,3,0,-3,IMG_20230512_145241_jpg.rf.298cf145f167e685da520bffba4d53a8.jpg
2_fovea,fold_7,4,1,0,1,-3,20230512_151307_jpg.rf.21fca3895ba4bf60b18eb9cd32d76ed9.jpg
2_fovea,fold_7,8,2,0,2,-6,20230512_150035_jpg.rf.590e7ece3e6e94d92163049b218f2085.jpg
2_fovea,fold_7,11,4,1,3,-7,20230512_144943_jpg.rf.6e882f14ce6985046782f1fb925495d2.jpg
2_fovea,fold_7,1,0,0,0,-1,20230512_151231_jpg.rf.4dc10049f8ecfe04ad41c2d1b1428792.jpg
2_fovea,fold_7,46,10,0,10,-36,20230512_153213_jpg.rf.9ee2b7f723899fca4419bd4e0c4eec72.jpg
2_fovea,fold_7,16,5,3,2,-11,IMG_20230512_153426_jpg.rf.13530953faa743fa6763be6d0ab583af.jpg
2_fovea,fold_7,2,0,0,0,-2,20230512_151459_jpg.rf.b5fc6223eb6e9549a2bed14367997348.jpg
2_fovea,fold_7,5,1,1,0,-4,IMG_20230512_145052_jpg.rf.1f1d0e8ea8a62acdeb924c64ae560628.jpg
2_fovea,fold_7,1,1,1,0,0,20230512_152330_jpg.rf.d9a6f6c4784e57ad912b6182a3fd0211.jpg
2_fovea,fold_7,1,1,1,0,0,0017_jpg.rf.324871efad4024d500a23b82191808a8.jpg
2_fovea,fold_7,1,0,0,0,-1,IMG_20230512_150908_jpg.rf.753a3cfb7ff38bc8300418f88dbf331c.jpg
2_fovea,fold_7,2,2,2,0,0,20230512_151703_jpg.rf.2faae265964e4a8dd7c48f882318b9e2.jpg
2_fovea,fold_7,5,3,3,0,-2,20230512_151812_jpg.rf.4e67fe81dff51295403e0c06c0621c2f.jpg
2_fovea,fold_7,1,1,0,1,0,20230512_153218_jpg.rf.64a3b9a40868420e3930fa153e76d395.jpg
2_fovea,fold_7,13,10,9,1,-3,20230512_153010_jpg.rf.b8501fc8a709517e34e7cb69002aa015.jpg
2_fovea,fold_7,17,5,3,2,-12,0038_jpg.rf.3f55cd3c03a14d11b3849a2a910a3773.jpg
2_fovea,fold_7,1,0,0,0,-1,20230512_145247_jpg.rf.9d204b8a475593430db82a060e2456d1.jpg
2_fovea,fold_7,9,7,7,0,-2,20230512_151909_jpg.rf.aead0419a0a121c39fda16a03595ab78.jpg
2_fovea,fold_7,13,5,5,0,-8,20230512_153312-0-_jpg.rf.8f1668ec1eddb4c37aa8c4c6b04cdd81.jpg
2_fovea,fold_7,2,1,1,0,-1,0002_jpg.rf.11a670be82fdde02b205d9929f761ed7.jpg
2_fovea,fold_7,17,0,0,0,-17,20230512_150002_jpg.rf.264d90b8bb0bb75c8bbe433b3c221545.jpg
2_fovea,fold_7,12,5,5,0,-7,20230512_150200_jpg.rf.2582038eca240736fe94eb2ed6cae31e.jpg
2_fovea,fold_7,7,1,1,0,-6,20230512_150042_jpg.rf.613029bfbedc91e536387ccf8df16dd0.jpg
2_fovea,fold_7,2,1,1,0,-1,20230512_152249_jpg.rf.04c1bebce986183bedd854bb677da384.jpg
2_fovea,fold_7,2,1,1,0,-1,20230512_151701_jpg.rf.819108571877bfd9f9063c78d807263f.jpg
2_fovea,fold_7,13,6,5,1,-7,IMG_20230512_145142_jpg.rf.fb2156626619cc38cf3127f70d63b5f0.jpg
2_fovea,fold_7,10,6,6,0,-4,20230512_145209_jpg.rf.2f0dfe951cb0a7165c942a2117e73f0d.jpg
2_fovea,fold_7,2,1,1,0,-1,20230512_145136_jpg.rf.852bd73d66d536a7a4ffbed448466961.jpg
2_fovea,fold_7,5,2,2,0,-3,IMG_20230512_151217_jpg.rf.04d3195207b1eb7346b1ba52c101a706.jpg
2_fovea,fold_7,8,2,1,1,-6,20230512_153130_jpg.rf.9b7bb97006640f6490a71f226200a2ca.jpg
2_fovea,fold_7,2,2,2,0,0,20230512_151638_jpg.rf.a0292d546f8d78bd93a8e0b8e16cdcad.jpg
2_fovea,fold_7,17,8,6,2,-9,20230512_150154_jpg.rf.89a63f38c3d9a5091806e13ec9a0b9d0.jpg
2_fovea,fold_7,8,6,6,0,-2,20230512_151851-0-_jpg.rf.fb46950ff8ddbfa6d4406784eb5e22b5.jpg
2_fovea,fold_7,33,1,1,0,-32,IMG_20230512_150352_jpg.rf.c1ca8bf250991c89b762984231b93a22.jpg
2_fovea,fold_7,9,3,3,0,-6,230512_150136_jpg.rf.1e2f1e90c67eb7b8f01703f120072671.jpg
2_fovea,fold_7,2,1,1,0,-1,0230512_145303_jpg.rf.48b2ec4c0dbde15f8f5f8b3bd2b59378.jpg
2_fovea,fold_7,1,0,0,0,-1,20230512_151014_jpg.rf.1daaabfd079316b6b36cd3f076521079.jpg
2_fovea,fold_7,7,1,0,1,-6,20230512_150115_jpg.rf.1e159ea5bb7c2543a1928c133ef9b549.jpg
2_fovea,fold_7,1,1,1,0,0,20230512_151753_jpg.rf.a14249ba89cecfaa73e632b588efdfd7.jpg
2_fovea,fold_7,2,3,2,1,1,20230512_151637_jpg.rf.a44f9c09520025824affd7d45589da18.jpg
2_fovea,fold_7,9,8,8,0,-1,20230512_152217_jpg.rf.a958863ea2bb344fee3c8c7b29889838.jpg
2_fovea,fold_7,2,1,0,1,-1,MG_20230512_145032_jpg.rf.043a11012a2a8dcb1cee1fc40482b97d.jpg
2_fovea,fold_7,6,3,2,1,-3,IMG_3831_JPG.rf.5b9e206f11628659b685b91001a564e0.jpg
2_fovea,fold_7,10,1,0,1,-9,IMG_20230512_150826_018_jpg.rf.6cdf008f2fd91c8d5a59ecb707eb0a93.jpg
2_fovea,fold_7,8,7,7,0,-1,IMG_4096_JPG.rf.8be1b70c0cb24617e853855e4e345ebe.jpg
2_fovea,fold_7,7,5,4,1,-2,0047_jpg.rf.f81c0ac4631d37256a41aa0d36e49744.jpg
2_fovea,fold_7,8,0,0,0,-8,IMG_20230512_151221_jpg.rf.1eaad9c5a6a8acb495445f202d82d696.jpg
2_fovea,fold_7,2,0,0,0,-2,230512_150056_jpg.rf.63fc419be91fa960c9fdd540582bc424.jpg
2_fovea,fold_7,1,1,1,0,0,20230512_145435_jpg.rf.0381cab4fa18f72340c2377d16cc9660.jpg
2_fovea,fold_7,21,0,0,0,-21,IMG_20230512_153447_jpg.rf.f9b2e4987e37b091be6072cae946d663.jpg
2_fovea,fold_7,14,2,1,1,-12,20230512_150101_jpg.rf.cc96a2d607d78ec899d39fd65e3ffcef.jpg
2_fovea,fold_7,5,2,2,0,-3,0230512_145402_jpg.rf.b34ea25b1c9ac3f7cc8061e80027c857.jpg
2_fovea,fold_7,11,5,3,2,-6,IMG_20230512_145018_jpg.rf.d1613b46f617939d055c5b8c109e9fa3.jpg
2_fovea,fold_7,3,1,1,0,-2,IMG_20230512_145338_jpg.rf.079f726ce175cc710ca12b4c3caa612c.jpg
2_fovea,fold_7,6,3,3,0,-3,20230512_145402_jpg.rf.2adab9c4657dc31e00e7139d61d9500a.jpg
2_fovea,fold_7,11,9,9,0,-2,0046_jpg.rf.e1528b2cf27767ce9998ebd79d287f47.jpg
2_fovea,fold_7,1,0,0,0,-1,0023_jpg.rf.816619f3269b0637f700332186be4dc7.jpg
2_fovea,fold_7,5,2,2,0,-3,IMG_3994_JPG.rf.3f53434cd9176d3f8187cface46b0ee0.jpg
2_fovea,fold_7,6,1,1,0,-5,20230512_150209_jpg.rf.386fa5331924ef6713a22c58b720e320.jpg
2_fovea,fold_7,5,0,0,0,-5,230512_150029_jpg.rf.12bae245124889830af4fc74e9e52dc8.jpg
2_fovea,fold_7,4,4,4,0,0,20230512_152303_jpg.rf.51286f7b0969a38d9408ce913d70bf49.jpg
2_fovea,fold_7,5,3,3,0,-2,20230512_145222_jpg.rf.fd35bc6270e794e1ad0a42037bded3b6.jpg
2_fovea,fold_7,9,7,7,0,-2,20230512_151906_jpg.rf.898831e6903935bdc29051a4dc1aec5d.jpg
2_fovea,fold_7,40,2,1,1,-38,IMG_20230512_153257_jpg.rf.d9dc811045c5a29bd9426b22f724b734.jpg
2_fovea,fold_7,3,0,0,0,-3,20230512_151140_jpg.rf.7db6428b7e2bbbef7dd568e63b356863.jpg
2_fovea,fold_7,1,0,0,0,-1,IMG_20230512_153421_jpg.rf.6158f971c571c6c40a9f73c5154fea7e.jpg
2_fovea,fold_7,3,1,0,1,-2,IMG_3991_JPG.rf.956960577cc9ffaab083d7a4f4c5bd11.jpg
2_fovea,fold_7,10,0,0,0,-10,20230512_150040_jpg.rf.aa50ac3e2a5a2042940711140afd2b9a.jpg
2_fovea,fold_7,1,0,0,0,-1,20230512_151227_jpg.rf.27d11f08dc002dbce0c7ab80e18ba38a.jpg
2_fovea,fold_7,4,2,2,0,-2,IMG_20230512_151208_jpg.rf.be5e6b4532e99f11dd349cc77c5094ca.jpg
2_fovea,fold_7,1,0,0,0,-1,IMG_20230512_150835_jpg.rf.5163b3bd6692963a73a0e71f347963cd.jpg
2_fovea,fold_7,1,2,0,2,1,20230512_153356_jpg.rf.4d48f88351e5397a697a75c05a09f970.jpg
2_fovea,fold_7,2,0,0,0,-2,20230512_151054_jpg.rf.7c0b5c7091bc1f6a8f74bc553c645583.jpg
2_fovea,fold_7,8,3,3,0,-5,20230512_151856_jpg.rf.e796d63958aed52d331329de4229f784.jpg
2_fovea,fold_7,42,2,0,2,-40,20230512_150217_jpg.rf.43a34e583d3360fb03c78ebcf6334f2b.jpg
2_fovea,fold_7,1,0,0,0,-1,20230512_151616_jpg.rf.319cd6543513a0db4c94621f3c78c207.jpg
2_fovea,fold_7,1,0,0,0,-1,20230512_145235_jpg.rf.609ee666fef18c181192a729599f029f.jpg
2_fovea,fold_7,17,4,0,4,-13,IMG_20230512_150105_jpg.rf.570debb8303e1ced483c9d4a2731ffec.jpg
2_fovea,fold_7,15,11,9,2,-4,IMG_20230512_153006_493_jpg.rf.8cb0e9085e5e5a8d382f8e2647075293.jpg
2_fovea,fold_7,1,0,0,0,-1,20230512_151335_jpg.rf.28b2031d23e55f8020b7aa20b9efc752.jpg
2_fovea,fold_7,1,1,0,1,0,IMG_20230512_145233_jpg.rf.d273d9a04013a4fdb680069c5f2e4780.jpg
2_fovea,fold_7,1,1,0,1,0,IMG_3841_JPG.rf.adc4a928f5d56c89691b1d5525a2cb06.jpg
2_fovea,fold_7,23,4,2,2,-19,20230512_150127_jpg.rf.f6e969d7228c49f8b298a15c5ea0d88d.jpg
2_fovea,fold_7,8,1,0,1,-7,20230512_150319_jpg.rf.71d19e64b856b04c9ab111407595de18.jpg
2_fovea,fold_7,8,1,0,1,-7,20230512_151037_jpg.rf.85e4a64b3db494811f84775d729cc9e7.jpg
2_fovea,fold_7,1,0,0,0,-1,IMG_4393_JPG.rf.47566015c2485f15e5114808d8a0d4ed.jpg
2_fovea,fold_7,2,1,1,0,-1,IMG_20230512_151816_jpg.rf.8fba275d23a787980bb56f34532a5efd.jpg
2_fovea,fold_7,6,5,5,0,-1,20230512_151851_jpg.rf.96579435ffaa9d451e63a406f34fab4e.jpg
2_fovea,fold_7,3,1,1,0,-2,IMG_4388_JPG.rf.1ddaadb8d3afe73ea7e33c9a29acec1e.jpg
2_fovea,fold_7,19,3,2,1,-16,IMG_20230512_150059_992_jpg.rf.b49a36b89c3ed0b8925e2ad7f1b905b9.jpg
2_fovea,fold_7,13,1,1,0,-12,230512_150153_jpg.rf.fb4c5b04651624464aee8747090f6cee.jpg
2_fovea,fold_7,9,1,1,0,-8,20230512_150329_jpg.rf.fd5367a6796a2fc3f0181a6e4c4b9513.jpg
2_fovea,fold_7,1,0,0,0,-1,230512_150122_jpg.rf.d2ef84171022dfe6b7f85166ab202b72.jpg
2_fovea,fold_7,6,0,0,0,-6,IMG_20230512_151041_jpg.rf.eda52b9119a16dac9d1d2632ea4d34bd.jpg
2_fovea,fold_8,26,14,11,3,-12,20230512_153257_jpg.rf.b0ed75a4fd63f8fa4923e04bdb1c38e2.jpg
2_fovea,fold_8,7,4,4,0,-3,20230512_152257_jpg.rf.25eef75e9cfc61b58dc03da8328d53ad.jpg
2_fovea,fold_8,9,2,1,1,-7,230512_150137_jpg.rf.a07a63205732aea6ea773793a5a4e25c.jpg
2_fovea,fold_8,2,0,0,0,-2,IMG_20230512_145254_jpg.rf.dfd1ca61f82842fe96ba39de8974f5d4.jpg
2_fovea,fold_8,13,2,2,0,-11,20230512_150244_jpg.rf.1ef934795ff31c5b43b6da861b2ac051.jpg
2_fovea,fold_8,4,0,0,0,-4,IMG_20230512_145320_405_jpg.rf.143f083c59c1dedbd9f3f7f157927edf.jpg
2_fovea,fold_8,1,1,1,0,0,IMG_4050_JPG.rf.242fde50c6291117b6172ee1dc45f081.jpg
2_fovea,fold_8,1,0,0,0,-1,20230512_145043_jpg.rf.943869aa154c2400192f3cbbf372a136.jpg
2_fovea,fold_8,1,0,0,0,-1,20230512_145034_jpg.rf.1bf97c164c29fec5dca87d03670ab344.jpg
2_fovea,fold_8,2,0,0,0,-2,IMG_4034_JPG.rf.92867b137f89f18d7bfc2034cbb1597f.jpg
2_fovea,fold_8,11,1,1,0,-10,20230512_150131_jpg.rf.b7b4ef28a3d5833ddf815ebcf9a8b336.jpg
2_fovea,fold_8,1,1,1,0,0,20230512_145223_jpg.rf.e86673dc1e563853935de252c1c2a11e.jpg
2_fovea,fold_8,2,0,0,0,-2,20230512_145313_jpg.rf.a52df235ea36832731aa90971489567a.jpg
2_fovea,fold_8,1,1,1,0,0,20230512_151654_jpg.rf.1ff5a5051a16402ce45fe6ca565c9239.jpg
2_fovea,fold_8,2,0,0,0,-2,20230512_145135_jpg.rf.4d3af6f64064db39df70b1e3672a3f63.jpg
2_fovea,fold_8,1,0,0,0,-1,IMG_20230512_153408_091_jpg.rf.d4b7f029dd191b0e3fc52b4b39bf8116.jpg
2_fovea,fold_8,2,1,1,0,-1,20230512_151619_jpg.rf.c7fb218f315f99ea72e78a520cc5dc68.jpg
2_fovea,fold_8,65,4,3,1,-61,IMG_20230512_153155_jpg.rf.348475844dfbdea71bac7dbce8198f44.jpg
2_fovea,fold_8,26,10,8,2,-16,IMG_3928_JPG.rf.b59dd1a245d0a61096acf104642a588f.jpg
2_fovea,fold_8,1,0,0,0,-1,0230512_145026_jpg.rf.e1ea5177e0224a86904eddffb8258ab9.jpg
2_fovea,fold_8,3,1,0,1,-2,IMG_3865_JPG.rf.85489cc903cddfc5bd27ee6328f5235e.jpg
2_fovea,fold_8,17,3,2,1,-14,IMG_20230512_145019_771_jpg.rf.d4b15f5b7869ffc05f7387247c4f82ae.jpg
2_fovea,fold_8,3,0,0,0,-3,IMG_3909_JPG.rf.be7478f841f6abc72fcc654df3e13ada.jpg
2_fovea,fold_8,7,3,3,0,-4,20230512_151849_jpg.rf.52b8fefba379829baeca592f085340cd.jpg
2_fovea,fold_8,8,4,4,0,-4,IMG_20230512_151934_jpg.rf.543796bd925563f125516769b066b214.jpg
2_fovea,fold_8,2,1,1,0,-1,0008_jpg.rf.058dbc5491e7240170841cbeb7cfebca.jpg
2_fovea,fold_8,2,0,0,0,-2,20230512_151804-0-_jpg.rf.da37c80768423b2be325cf7dcf3b8efd.jpg
2_fovea,fold_8,4,0,0,0,-4,20230512_151138_jpg.rf.bd5d8d04a758d594acc2af15dc942b5f.jpg
2_fovea,fold_8,13,6,6,0,-7,20230512_152309_jpg.rf.e6272cf81ee3a89c98dea29c7ca87fde.jpg
2_fovea,fold_8,8,3,3,0,-5,20230512_150137_jpg.rf.c6db7854f50b446566afe69c0e3bae6f.jpg
2_fovea,fold_8,1,0,0,0,-1,IMG_3858_JPG.rf.10b8772deec081b08895efdc83efbfcc.jpg
2_fovea,fold_8,1,0,0,0,-1,20230512_151447_jpg.rf.8a684005457ea3cadf9943d40014e87f.jpg
2_fovea,fold_8,9,0,0,0,-9,IMG_20230512_144959_jpg.rf.8d9a872947615acdbff5cf0776139cb9.jpg
2_fovea,fold_8,17,0,0,0,-17,20230512_153021_jpg.rf.6b38fba9b80543e229dc93ffb5e19695.jpg
2_fovea,fold_8,11,0,0,0,-11,20230512_151051_jpg.rf.dcb4ee42b399c0d6007719e173f728b6.jpg
2_fovea,fold_8,10,5,5,0,-5,20230512_151854_jpg.rf.0809016c2e20da637cbac7d27e6fb6c0.jpg
2_fovea,fold_8,2,1,1,0,-1,20230512_145219_jpg.rf.f22be001a717798eb8a2168d0d3421ab.jpg
2_fovea,fold_8,5,1,1,0,-4,230512_150140_jpg.rf.7c74dbb84999f31492125730db986f40.jpg
2_fovea,fold_8,10,0,0,0,-10,20230512_151021_jpg.rf.de7c03d7cc7906d7c81bff3b479fd9e5.jpg
2_fovea,fold_8,11,2,1,1,-9,20230512_145237_jpg.rf.d8f058e0b402e3d1e808be861e667173.jpg
2_fovea,fold_8,152,13,0,13,-139,0100_jpg.rf.05cd5bba5e3a338b9bab8b49b2c62230.jpg
2_fovea,fold_8,2,0,0,0,-2,20230512_151516_jpg.rf.4075925f758530db09c215e48201f510.jpg
2_fovea,fold_8,4,0,0,0,-4,IMG_20230512_151322_jpg.rf.f87bdadf921aef8dde8daecc2efda877.jpg
2_fovea,fold_8,1,1,1,0,0,20230512_151310_jpg.rf.49e186e145599c0c576f88f77a48645f.jpg
2_fovea,fold_8,2,2,2,0,0,20230512_151840_jpg.rf.225d382469feb3893ab8adf440f0dcdd.jpg
2_fovea,fold_8,15,6,3,3,-9,IMG_20230512_150202_jpg.rf.605274560fcfde991ad3e82107d6fd8c.jpg
2_fovea,fold_8,28,4,3,1,-24,0512_150115_jpg.rf.572fa1a857240740ab2fd9c0bd962a84.jpg
2_fovea,fold_8,11,0,0,0,-11,IMG_20230512_150135_011_jpg.rf.7d2abfcfbd33399d0709cdb1f6848e09.jpg
2_fovea,fold_8,1,1,1,0,0,20230512_145421_jpg.rf.3704320bbaa6e937ed0261aa404772f1.jpg
2_fovea,fold_8,14,3,3,0,-11,0042_jpg.rf.7ffcac34c8b8720199d793d39ebf099c.jpg
2_fovea,fold_8,34,0,0,0,-34,0512_150108_jpg.rf.2a2b0446e2345745280376767e5d1b27.jpg
2_fovea,fold_8,3,0,0,0,-3,IMG_20230512_152407_jpg.rf.987c14f960c413f0e6ece4c99d516916.jpg
2_fovea,fold_8,7,2,1,1,-5,20230512_150116_jpg.rf.4cdde848ca21f7424c94dada8a3603c8.jpg
2_fovea,fold_8,1,1,1,0,0,20230512_151642_jpg.rf.8d7807db8a2c50e7601e595cb8e4d441.jpg
2_fovea,fold_8,1,0,0,0,-1,IMG_20230512_161346_jpg.rf.f2d66ae86a3dee44e0234f6002702110.jpg
2_fovea,fold_8,3,0,0,0,-3,20230512_151340_jpg.rf.1e7341de1b15f16ffc701c3b53542fe7.jpg
2_fovea,fold_8,5,2,2,0,-3,20230512_145411_jpg.rf.962646db69e6629f3a045dc737b54f0c.jpg
2_fovea,fold_8,12,0,0,0,-12,20230512_145240_jpg.rf.a5091d10c5393608b704fe2d2a846263.jpg
2_fovea,fold_8,12,5,5,0,-7,IMG_20230512_152002_jpg.rf.0e50ad947bcac786ec04e7adf1df3e90.jpg
2_fovea,fold_8,8,4,4,0,-4,IMG_4207_JPG.rf.330747e746ba1f08f12c25a697df8506.jpg
2_fovea,fold_8,24,0,0,0,-24,IMG_20230512_150022_jpg.rf.951e0e5b24bd9b0e9ad93c5f8e19127d.jpg
2_fovea,fold_8,1,0,0,0,-1,20230512_151445_jpg.rf.7d699391bb3084d81ea03299229ab140.jpg
2_fovea,fold_8,3,1,1,0,-2,IMG_20230512_145332_184_jpg.rf.332c2aa459e521d0576953fca1e0a03f.jpg
2_fovea,fold_8,3,1,1,0,-2,20230512_145052_jpg.rf.e4d9741a91ef6c0f9f053feb1ffe1df5.jpg
2_fovea,fold_8,12,4,3,1,-8,0032_jpg.rf.bbf27b122201c3fdb2fa22a360b64846.jpg
2_fovea,fold_8,4,0,0,0,-4,20230512_151300_jpg.rf.f994d9472b1ee1ddd3ac8ab3a3cc2a12.jpg
2_fovea,fold_8,7,1,0,1,-6,20230512_150036_jpg.rf.409641b85ef17642977736d9dc873ae4.jpg
2_fovea,fold_8,1,0,0,0,-1,IMG_20230512_144910_997_jpg.rf.93aca80524806445b3dfb1818fa4806a.jpg
2_fovea,fold_8,7,4,3,1,-3,IMG_20230512_152357_jpg.rf.77160d5f48db0fa53a72198288557af6.jpg
2_fovea,fold_8,7,5,4,1,-2,20230512_145341_jpg.rf.85ffc7a18e0ad722dbf476743313df02.jpg
2_fovea,fold_8,16,3,3,0,-13,IMG_20230512_151902_jpg.rf.86d659e2d2eb4651a989633ff7c3cb87.jpg
2_fovea,fold_8,17,3,1,2,-14,230512_150202_jpg.rf.ea33cf5fe5f6662c3682e389e8685dfb.jpg
2_fovea,fold_8,12,7,7,0,-5,0048_jpg.rf.ec48089b3f18d5818c04f71cecd05f38.jpg
2_fovea,fold_8,2,2,0,2,0,IMG_4091_JPG.rf.a9405bd034e33eacf6b2883c9ed04e2e.jpg
2_fovea,fold_8,13,0,0,0,-13,IMG_20230512_150158_jpg.rf.c8fd099b0d72b4e29fc1807382e042b1.jpg
2_fovea,fold_8,2,1,0,1,-1,20230512_144932_jpg.rf.a725c2a7e9c0d34d34a6abd7d299f6df.jpg
2_fovea,fold_8,16,0,0,0,-16,20230512_151039_jpg.rf.bb11ca2d78a6f005bcb2f521dfcf0dce.jpg
2_fovea,fold_8,5,3,3,0,-2,20230512_152301_jpg.rf.3701d53ed7c06271583a063371e238d1.jpg
2_fovea,fold_8,7,0,0,0,-7,IMG_20230512_145108_jpg.rf.5b77832e2c70819f5a5de9e318768425.jpg
2_fovea,fold_8,3,0,0,0,-3,IMG_3849_JPG.rf.7ce1df74f4ca793d89d2042ccc5766ef.jpg
2_fovea,fold_8,10,2,0,2,-8,20230512_145206_jpg.rf.4cf9a1bcd726515460c68ec0b753f06a.jpg
2_fovea,fold_8,21,0,0,0,-21,IMG_20230512_150057_jpg.rf.1d901fec112c2705325b5b23647b5cfe.jpg
2_fovea,fold_8,5,4,4,0,-1,20230512_151846_jpg.rf.aaa6e44ba0c35df5988efcf5a4f2510c.jpg
2_fovea,fold_8,22,5,5,0,-17,IMG_20230512_153211_jpg.rf.8b8c95e482643af377a9a4d7a0182777.jpg
2_fovea,fold_8,3,1,1,0,-2,0230512_145440_jpg.rf.26be693a65087ccb13d4129f4c93b786.jpg
2_fovea,fold_8,9,0,0,0,-9,IMG_3931_JPG.rf.fcba871e1d94de33741779717c57137f.jpg
2_fovea,fold_8,1,0,0,0,-1,20230512_145025_jpg.rf.15940c55814fd494ff830db5a9061d30.jpg
2_fovea,fold_8,1,1,1,0,0,IMG_20230512_145352_jpg.rf.1c96dea3488a61099952ab7250fce4b2.jpg
2_fovea,fold_8,3,0,0,0,-3,20230512_145231_jpg.rf.77f03cc3c54cff48c03e24558d36189b.jpg
2_fovea,fold_8,16,0,0,0,-16,IMG_20230512_151508_jpg.rf.c78520025916588a7657b75ae388cb8f.jpg
2_fovea,fold_8,12,5,3,2,-7,IMG_20230512_145022_866_jpg.rf.245d67f93e45a020eb21fdd8f4124767.jpg
2_fovea,fold_8,4,0,0,0,-4,20230512_145329_jpg.rf.0c0d42d6e893d6efcd4b3119ce990d0e.jpg
2_fovea,fold_8,2,0,0,0,-2,20230512_145433_jpg.rf.5924d4f1a47105e53efa0a08085450a7.jpg
2_fovea,fold_8,3,0,0,0,-3,IMG_20230512_152405_jpg.rf.ebe5f63b7b940c8d9a74c8fb5839d39b.jpg
2_fovea,fold_8,6,0,0,0,-6,20230512_150204_jpg.rf.87f7c1141bc54dad9c82b36c8beb1bb9.jpg
2_fovea,fold_8,1,0,0,0,-1,230512_150118_jpg.rf.ecc50b57dabc83b04e792a7ddde388f8.jpg
2_fovea,fold_8,2,0,0,0,-2,20230512_150052_jpg.rf.9bdf107fc37c37b05aa46914e8882f17.jpg
2_fovea,fold_8,5,0,0,0,-5,20230512_151135_jpg.rf.3b3e99725d0ae8b34747d0ed51687a4a.jpg
2_fovea,fold_8,2,0,0,0,-2,230512_145056_jpg.rf.cb3d61bce2d4e0686bc0310ab76413a2.jpg
2_fovea,fold_8,25,0,0,0,-25,IMG_20230512_150208_jpg.rf.14a0d0d16b6d32327bcec6959b738634.jpg
2_fovea,fold_8,30,3,2,1,-27,IMG_20230512_150210_524_jpg.rf.476d8805b0160b5143ad37609399dc72.jpg
2_fovea,fold_8,1,0,0,0,-1,20230512_151455_jpg.rf.ea02e305291eae5ae85ae54d0ebfe26d.jpg
2_fovea,fold_8,19,1,1,0,-18,IMG_20230512_150024_jpg.rf.5425ded2475701fa14408062843212ec.jpg
2_fovea,fold_8,10,1,0,1,-9,20230512_153132_jpg.rf.cac6aa1f1a0f028046df980276b5e4e6.jpg
2_fovea,fold_8,1,0,0,0,-1,MG_20230512_145316_jpg.rf.4d66c8eb78cdd81e04686ee0f7aa4fdf.jpg
2_fovea,fold_8,12,5,5,0,-7,20230512_152311_jpg.rf.7f2da0009f2fa07600b981c50d8d6ebf.jpg
2_fovea,fold_8,1,0,0,0,-1,20230512_145036_jpg.rf.1ecc4ae3f81e22aac59d8b3b9c1034cd.jpg
2_fovea,fold_8,1,0,0,0,-1,IMG_4390_JPG.rf.2018de24c221ce01e2c3239735a272af.jpg
2_fovea,fold_8,14,3,3,0,-11,IMG_20230512_145158_jpg.rf.6d28bd6cb232ef60feeaaa2d893d7326.jpg
2_fovea,fold_8,4,0,0,0,-4,IMG_20230512_150225_jpg.rf.5e6e4781174588e28c95f110bb49edf2.jpg
2_fovea,fold_8,17,0,0,0,-17,20230512_151035_jpg.rf.7593703cffcf4a6285b53ddb6e104d39.jpg
2_fovea,fold_8,5,0,0,0,-5,_20230512_150252_jpg.rf.c7786b04a48eca5fec5127b90d27efc6.jpg
2_fovea,fold_8,10,2,2,0,-8,IMG_20230512_161908_jpg.rf.c3138f9567f619fcdc8eb8c700bfcff8.jpg
2_fovea,fold_8,8,0,0,0,-8,20230512_150001_jpg.rf.74ea9697c92aedc234993b5551f7f1b4.jpg
2_fovea,fold_8,5,1,0,1,-4,IMG_20230512_151249_373_jpg.rf.f2dd29bba78783f6fbe29e66675bd321.jpg
2_fovea,fold_8,3,2,1,1,-1,IMG_20230512_151542_635_jpg.rf.1e2c1e872c81db1f473f8c586f3ce9d9.jpg
2_fovea,fold_8,3,1,1,0,-2,20230512_151619-0-_jpg.rf.5d6f8d7a8176754cc78ef08a707b7ea8.jpg
2_fovea,fold_8,8,2,1,1,-6,IMG_20230512_145253_jpg.rf.7d0a492e681439db3a20eb64e356d8ff.jpg
2_fovea,fold_8,2,1,1,0,-1,20230512_151636_jpg.rf.0e80ecb006eb88d60de9b99c0fac2245.jpg
2_fovea,fold_8,11,5,5,0,-6,IMG_3926_JPG.rf.769c3267365e5531dec34c648a73f597.jpg
2_fovea,fold_8,13,6,4,2,-7,IMG_20230512_145120_jpg.rf.3ecb5837a329b79ac20997cfe24d3124.jpg
2_fovea,fold_8,3,0,0,0,-3,230512_150054_jpg.rf.ec6dcd9709fc100d27b3f2f4937b7712.jpg
2_fovea,fold_8,7,0,0,0,-7,IMG_20230512_150945_jpg.rf.26027cad843e4a3c904d281bd5e443ab.jpg
2_fovea,fold_8,2,1,1,0,-1,20230512_151755_jpg.rf.f2aa85c403e0f77cda500046a0fd667f.jpg
2_fovea,fold_8,7,8,7,1,1,20230512_152237_jpg.rf.dceb042d25e3e44ad022b7c4330f1dcf.jpg
2_fovea,fold_8,19,7,7,0,-12,20230512_153013_jpg.rf.ebf5724207d5fe9aba867759ed6ae350.jpg
2_fovea,fold_8,3,0,0,0,-3,230512_150143_jpg.rf.b686af9ba8be8219e2e0a152ff0123f1.jpg
2_fovea,fold_8,1,0,0,0,-1,IMG_20230512_151231_jpg.rf.f19d35ba554c9c3e62efe863fb1dd098.jpg
2_fovea,fold_8,1,0,0,0,-1,20230512_151451-0-_jpg.rf.352f3ab1f1271f1dc2c7503413d5072b.jpg
2_fovea,fold_8,13,1,1,0,-12,IMG_20230512_151640_056_jpg.rf.69bbb5903a2369e6d01c4fd2bef65e1f.jpg
2_fovea,fold_8,5,0,0,0,-5,230512_150033_jpg.rf.ceea84e0a6184331d2af5a24cba9a7d0.jpg
2_fovea,fold_8,11,6,6,0,-5,0053_jpg.rf.09112cd43c7e1f0da4351e79ab49af2f.jpg
2_fovea,fold_8,12,1,1,0,-11,IMG_20230512_151339_jpg.rf.13ce8b9b66953b0f57413fa693a3dc35.jpg
2_fovea,fold_8,2,0,0,0,-2,IMG_20230512_151240_565_jpg.rf.fdf2f78ec041a34d2611406b29953d18.jpg
2_fovea,fold_8,23,10,8,2,-13,IMG_20230512_150201_jpg.rf.81da174bcf14fd53b844cf7cae9f7a28.jpg
2_fovea,fold_8,27,5,0,5,-22,20230512_153207_jpg.rf.81b28e88b96ae01a62cb2b2cdc468e08.jpg
2_fovea,fold_8,3,3,2,1,0,20230512_151625_jpg.rf.6d8f8d5fffad59d6ccff118606bdd771.jpg
2_fovea,fold_8,8,2,2,0,-6,IMG_20230512_145440_jpg.rf.4fae61f59dfa2249c388f714b68ca784.jpg
2_fovea,fold_8,2,0,0,0,-2,IMG_4191_JPG.rf.f40d8980877c6222a068ed1ef1102afa.jpg
2_fovea,fold_8,1,0,0,0,-1,20230512_153345_jpg.rf.7d2374802dfa67e187bded47020403c1.jpg
2_fovea,fold_8,1,0,0,0,-1,20230512_150733_jpg.rf.dfdc2eb0d94519616a7ec9cf127c8f8a.jpg
2_fovea,fold_8,1,1,1,0,0,IMG_4028_JPG.rf.c7571b8910b4228b0179b0ffc703ee1e.jpg
2_fovea,fold_8,9,2,0,2,-7,0230512_150115_jpg.rf.50a5de1d8e046395fd6c82509eb7d363.jpg
2_fovea,fold_8,2,0,0,0,-2,20230512_145355_jpg.rf.67799c9783b1beeb42aebdae40eac27d.jpg
2_fovea,fold_8,9,0,0,0,-9,IMG_3989_JPG.rf.51b8252c5f0a8196d379e91fcc91ad06.jpg
2_fovea,fold_8,1,0,0,0,-1,20230512_145111_jpg.rf.ab829e89e439dc4aa65d413090f00b2d.jpg
2_fovea,fold_8,5,2,2,0,-3,20230512_152259_jpg.rf.fef7e558f14c303ecfa184eb656375ce.jpg
2_fovea,fold_8,1,0,0,0,-1,IMG_20230512_151033_jpg.rf.4872ff92d415a45e16c1f52f8b7ae6db.jpg
2_fovea,fold_8,32,10,9,1,-22,IMG_20230512_153350_jpg.rf.cc68f1c6759992fe198286f32b0171ec.jpg
2_fovea,fold_8,2,0,0,0,-2,20230512_151506_jpg.rf.2d22a2b23e3853093943da42a80fc17b.jpg
2_fovea,fold_8,1,1,0,1,0,IMG_4015_JPG.rf.8f40d2d78e19693b5d38d76ffd50d286.jpg
2_fovea,fold_8,10,9,9,0,-1,20230512_152217_jpg.rf.a3962f3838250709a368b8f241c7bcad.jpg
2_fovea,fold_8,3,0,0,0,-3,230512_150048_jpg.rf.2a601f5dc5ab605aa2563bcbc35c41e1.jpg
2_fovea,fold_8,14,3,3,0,-11,IMG_20230512_152954_jpg.rf.6f297f29021342f064430fb1e8d22587.jpg
2_fovea,fold_8,2,0,0,0,-2,IMG_4053_JPG.rf.307ece37dd62cbaea82bfd7b14f0ee36.jpg
2_fovea,fold_8,17,1,1,0,-16,20230512_152942_jpg.rf.cc3d43f0d1f322fa8da500d78ce3a8be.jpg
2_fovea,fold_8,3,0,0,0,-3,IMG_20230512_151637_jpg.rf.e79b46fd14d5a0af0846c34d1a920413.jpg
2_fovea,fold_9,7,1,1,0,-6,20230512_152158_jpg.rf.02f9c3c00108d9da3f80f2943458d80a.jpg
2_fovea,fold_9,4,0,0,0,-4,IMG_20230512_145312_784_jpg.rf.58023d0721ac49469db4e79c05fb5cba.jpg
2_fovea,fold_9,25,3,3,0,-22,20230512_150144_jpg.rf.ecf1f47bccdedeca682aab00e68f4fbf.jpg
2_fovea,fold_9,4,0,0,0,-4,20230512_145408-0-_jpg.rf.7d30c64c68760c899eab7f27576adaec.jpg
2_fovea,fold_9,17,0,0,0,-17,IMG_20230512_153014_136_jpg.rf.ac9f2fc67a44db81aef730e99a1dba0a.jpg
2_fovea,fold_9,20,0,0,0,-20,20230512_153043_jpg.rf.5cddf43df464d99390a41596bf2ccdf2.jpg
2_fovea,fold_9,8,2,2,0,-6,20230512_153242_jpg.rf.5d53d7e395b76d25f2510396dec3f47a.jpg
2_fovea,fold_9,7,0,0,0,-7,20230512_151538_jpg.rf.d5df90d6db920f66f1d45e4cfa70a411.jpg
2_fovea,fold_9,5,3,3,0,-2,0050_jpg.rf.47c1ed097ad14e52c46f19b2b3e3f5a2.jpg
2_fovea,fold_9,3,0,0,0,-3,20230512_150109_jpg.rf.4d2c542089703d638847cefe3c0e0669.jpg
2_fovea,fold_9,12,1,1,0,-11,IMG_20230512_151658_955_jpg.rf.6f77aded32a46d8083d7d4e54c112bb9.jpg
2_fovea,fold_9,5,0,0,0,-5,IMG_20230512_145258_492_jpg.rf.3ae44ee592a82ee046166d1017a1f348.jpg
2_fovea,fold_9,3,3,3,0,0,IMG_20230512_152403_jpg.rf.708a0e8a856b9c4ca92a84e1450a3e60.jpg
2_fovea,fold_9,7,1,1,0,-6,20230512_151548_jpg.rf.de9bfd82e4ede57511bc911fc34f5695.jpg
2_fovea,fold_9,1,0,0,0,-1,IMG_20230512_151202_728_jpg.rf.1d8a1071a58b84a0628884454a63ef8a.jpg
2_fovea,fold_9,11,5,5,0,-6,20230512_152251_jpg.rf.f4cd881ef463deae8c6458635e8849ac.jpg
2_fovea,fold_9,4,0,0,0,-4,IMG_3835_JPG.rf.e405f9fb7ccfe92ed96a553465aa1ec9.jpg
2_fovea,fold_9,18,0,0,0,-18,20230512_144934_jpg.rf.03898f9c31f25d3ec984bc32b412d5af.jpg
2_fovea,fold_9,4,0,0,0,-4,IMG_3867_JPG.rf.ec5d38e5d6681088aaa0d2786eb3bb2b.jpg
2_fovea,fold_9,13,4,3,1,-9,IMG_20230512_152345_469_jpg.rf.3dde8c68a98233421212da59bcbe366e.jpg
2_fovea,fold_9,19,7,6,1,-12,IMG_20230512_152322_jpg.rf.190afc8c001b1a757ff0cc847eea784d.jpg
2_fovea,fold_9,15,0,0,0,-15,0230512_145001_jpg.rf.da230b3dcac925c28f8c0273b5776c9a.jpg
2_fovea,fold_9,8,3,3,0,-5,20230512_151900_jpg.rf.1250b5103b69822786ae601e0a5c5f68.jpg
2_fovea,fold_9,3,0,0,0,-3,IMG_20230512_145043_jpg.rf.3d90edfd5a365d1ec3876fca50ab884d.jpg
2_fovea,fold_9,2,0,0,0,-2,IMG_20230512_145345_250_jpg.rf.15fc60af583ce168515577f073866f5f.jpg
2_fovea,fold_9,14,3,3,0,-11,20230512_152217_jpg.rf.2fdd5053b538b85b1941d0bb5e4261ca.jpg
2_fovea,fold_9,5,0,0,0,-5,230512_150109_jpg.rf.fe44d8827f0b8ae246022ca47b5c4c2c.jpg
2_fovea,fold_9,9,6,4,2,-3,20230512_152318_jpg.rf.15ef28475daedc6fc4e098af4a1459e5.jpg
2_fovea,fold_9,11,2,2,0,-9,IMG_20230512_151554_209_jpg.rf.f15eb1b2793910f53035e241375725c8.jpg
2_fovea,fold_9,1,0,0,0,-1,20230512_151039_jpg.rf.12dc8e8ab83bd9d6e1e941c7a0c05874.jpg
2_fovea,fold_9,1,0,0,0,-1,IMG_3908_JPG.rf.04ee0448a5e502f1d8c821cea701a7e1.jpg
2_fovea,fold_9,2,0,0,0,-2,20230512_150227_jpg.rf.4d20daf17aea8771758821741496ecfd.jpg
2_fovea,fold_9,1,0,0,0,-1,20230512_153412_jpg.rf.86821476b6a03cfd46882b168695fa0b.jpg
2_fovea,fold_9,11,0,0,0,-11,20230512_153437_jpg.rf.be3d60256eef37a332523d849f2754c6.jpg
2_fovea,fold_9,1,0,0,0,-1,20230512_150221_jpg.rf.16f1f40fdbd20de3345eed95661a9875.jpg
2_fovea,fold_9,6,0,0,0,-6,20230512_145324_jpg.rf.20601749525cadde15c78b46cd0fd934.jpg
2_fovea,fold_9,11,1,0,1,-10,IMG_20230512_151501_jpg.rf.050803adc8687422b6d0ca0c55649365.jpg
2_fovea,fold_9,8,1,1,0,-7,0041_jpg.rf.dc9ba1dc663668cabb27474922349a17.jpg
2_fovea,fold_9,8,0,0,0,-8,20230512_145208_jpg.rf.b8ad2aec57651698bef6edfad1ced014.jpg
2_fovea,fold_9,1,1,1,0,0,20230512_151617_jpg.rf.f876cceb3568353e640a6506b3aa8b6a.jpg
2_fovea,fold_9,16,0,0,0,-16,0043_jpg.rf.af436235ce1f5e4c84b661d4b30ac97f.jpg
2_fovea,fold_9,6,1,1,0,-5,IMG_4102_JPG.rf.988b30b26acf51017cd5b3ff16762a2b.jpg
2_fovea,fold_9,5,0,0,0,-5,IMG_20230512_145425_638_jpg.rf.661f8dc69f407743144410705f4450c9.jpg
2_fovea,fold_9,14,0,0,0,-14,20230512_151015_jpg.rf.3c8da9af03482ee1020db88de8cd53f5.jpg
2_fovea,fold_9,6,0,0,0,-6,20230512_151814_jpg.rf.63e5823ef6a38da9206064b1975681af.jpg
2_fovea,fold_9,6,0,0,0,-6,20230512_151556_jpg.rf.e585c8603435630ba81c916c0f5e3ad0.jpg
2_fovea,fold_9,7,0,0,0,-7,20230512_150112_jpg.rf.91cd81f1887a38818d08e2f659a19d98.jpg
2_fovea,fold_9,6,0,0,0,-6,20230512_144948_jpg.rf.f0802f30adda8942f990e793b5836607.jpg
2_fovea,fold_9,1,0,0,0,-1,20230512_145029_jpg.rf.d7839e9fea72e8e69ba8fd36d0e4fb46.jpg
2_fovea,fold_9,18,0,0,0,-18,IMG_3904_JPG.rf.bd3a38163bc8779f0e934e0ae4ddadcf.jpg
2_fovea,fold_9,1,0,0,0,-1,IMG_20230512_153207_221_jpg.rf.1f2a32c755bbb2f6a4de873cb32a38fd.jpg
2_fovea,fold_9,6,0,0,0,-6,IMG_20230512_150226_jpg.rf.0f75578652c746be4186e389de366a0e.jpg
2_fovea,fold_9,2,0,0,0,-2,IMG_3906_JPG.rf.489fadb71a83983d81ed44a70d0060f4.jpg
2_fovea,fold_9,7,0,0,0,-7,20230512_150041_jpg.rf.77c6bf2c7e0b5d7af7cc6bad355e9df1.jpg
2_fovea,fold_9,1,0,0,0,-1,0230512_145030_jpg.rf.6c6efdb679aaba04919e4f2fbe75cc41.jpg
2_fovea,fold_9,5,0,0,0,-5,230512_150321_jpg.rf.623a3367577becef7953f663a60a519b.jpg
2_fovea,fold_9,5,0,0,0,-5,MG_20230512_145134_jpg.rf.23612ad15c705c682dff7447cb294722.jpg
2_fovea,fold_9,27,1,0,1,-26,20230512_153521_jpg.rf.91f440ee7bd1d39009cef4ad201c6fc3.jpg
2_fovea,fold_9,0,1,0,1,1,IMG_4213_JPG.rf.778fa8d9b6925e2bc9f653dd198513f2.jpg
2_fovea,fold_9,6,3,3,0,-3,20230512_152211_jpg.rf.f8ab5359b2be0312cf7788fc199a7cfb.jpg
2_fovea,fold_9,3,0,0,0,-3,20230512_151750_jpg.rf.d25aa4eadcd0f88bad307f1be9834da7.jpg
2_fovea,fold_9,14,1,1,0,-13,IMG_20230512_145200_jpg.rf.071fa9592bc47982ce5ace6be3fc1cac.jpg
2_fovea,fold_9,11,0,0,0,-11,20230512_150021_jpg.rf.e7014c35e8c40fcb7fa7884ea70952ae.jpg
2_fovea,fold_9,15,0,0,0,-15,IMG_20230512_150047_070_jpg.rf.473b1fece6373583075f5a81e7cd25b1.jpg
2_fovea,fold_9,12,7,7,0,-5,IMG_20230512_152350_jpg.rf.e5327c93655bbe8c35427b0ce8c7c897.jpg
2_fovea,fold_9,7,0,0,0,-7,20230512_153033_jpg.rf.02462baf8941d1800bd6cd7071ac2700.jpg
2_fovea,fold_9,5,0,0,0,-5,20230512_145350_jpg.rf.1ea30b4048e0f19948f3a1c49f936262.jpg
2_fovea,fold_9,20,0,0,0,-20,20230512_153245_jpg.rf.9c9fb8ddd3ba260eca53499188a58fd5.jpg
2_fovea,fold_9,2,0,0,0,-2,20230512_151451_jpg.rf.0a8434d6a9efa22ee048c8273b62b68d.jpg
2_fovea,fold_9,5,0,0,0,-5,20230512_151436_jpg.rf.554d34d9ea0ee09cf2c15f0b2df8ebb2.jpg
2_fovea,fold_9,6,0,0,0,-6,IMG_3910_JPG.rf.33d9bdf28a4dfeab746c5a00ebede622.jpg
2_fovea,fold_9,1,0,0,0,-1,20230512_145422_jpg.rf.855806965c417ddd5e1b836f01dc61f4.jpg
2_fovea,fold_9,18,0,0,0,-18,IMG_4182_JPG.rf.9c42af3692f7bbaef5a89c980112be66.jpg
2_fovea,fold_9,2,0,0,0,-2,20230512_151553_jpg.rf.eb27fb285f9f9e115b16ae58308b4a33.jpg
2_fovea,fold_9,1,1,1,0,0,IMG_20230512_151942_jpg.rf.44e3a3ca4b79e01e3532e938c985d467.jpg
2_fovea,fold_9,1,0,0,0,-1,20230512_145026_jpg.rf.dbca47de186a8c26308fd5d82af2ccef.jpg
2_fovea,fold_9,8,0,0,0,-8,IMG_20230512_151456_jpg.rf.85840748681315fe5ab4e0d0318d07ef.jpg
2_fovea,fold_9,5,0,0,0,-5,20230512_145129_jpg.rf.5f78acb483122a7da1a71444f23c5e85.jpg
2_fovea,fold_9,3,0,0,0,-3,IMG_4049_JPG.rf.69a02eacb4e8dea786daf7ac53eff115.jpg
2_fovea,fold_9,3,0,0,0,-3,20230512_151128_jpg.rf.a8a2c544627fbc40d82ac1408de83acf.jpg
2_fovea,fold_9,1,0,0,0,-1,0022_jpg.rf.392b7e000cd5e1b178fd42a324c62fa9.jpg
2_fovea,fold_9,17,2,1,1,-15,IMG_4214_JPG.rf.342cb36b8889ed055af6630becc0a92b.jpg
2_fovea,fold_9,4,0,0,0,-4,IMG_3992_JPG.rf.7e1e103b7399a2f459d53d6a310a7ee0.jpg
2_fovea,fold_9,23,0,0,0,-23,IMG_20230512_152955_591_jpg.rf.0aef108570178c062fc410980092f3ee.jpg
2_fovea,fold_9,32,2,0,2,-30,IMG_20230512_150325_jpg.rf.9a0b14f916539972a32ed40c795a77e2.jpg
2_fovea,fold_9,2,0,0,0,-2,20230512_150043_jpg.rf.c937683d3c7cefe87855391dceb56509.jpg
2_fovea,fold_9,3,0,0,0,-3,IMG_4038_JPG.rf.53f27c280fb9536f67b0f3bce749cded.jpg
2_fovea,fold_9,1,0,0,0,-1,IMG_4218_JPG.rf.776b234254cad41083ae7a7013512ded.jpg
2_fovea,fold_9,3,2,2,0,-1,20230512_152323_jpg.rf.f87e4ec47644402832bf9ed280233bd6.jpg
2_fovea,fold_9,5,0,0,0,-5,20230512_151434_jpg.rf.6e770d46c3e9773c996335b4220cab85.jpg
2_fovea,fold_9,10,0,0,0,-10,0230512_145012_jpg.rf.0f087c91d690727635837b56dc1725f3.jpg
2_fovea,fold_9,1,0,0,0,-1,20230512_151257_jpg.rf.0a6cd5b01b2f5eb142626849e1aa59dd.jpg
2_fovea,fold_9,5,4,4,0,-1,IMG_20230512_151930_jpg.rf.b1cb9853e8645a3ba38d93ab637f6627.jpg
2_fovea,fold_9,14,0,0,0,-14,20230512_151038-0-_jpg.rf.b58c6345da65332e25d3fdda064694ee.jpg
2_fovea,fold_9,1,0,0,0,-1,20230512_145221_jpg.rf.29bff38b4873d27c522654186744b290.jpg
2_fovea,fold_9,15,5,5,0,-10,IMG_20230512_152316_jpg.rf.7f4d2253d0ea3147244a7a36b4392e3c.jpg
2_fovea,fold_9,1,0,0,0,-1,20230512_145046_jpg.rf.43cb9d49dc86e3ae870df966e6b2b7b1.jpg
2_fovea,fold_9,6,1,0,1,-5,IMG_20230512_151246_jpg.rf.0cb0203d04b163b091b29c2f755a7f65.jpg
2_fovea,fold_9,8,0,0,0,-8,20230512_150900_jpg.rf.7c05ba2842680f1a240b6f0a28f08dad.jpg
2_fovea,fold_9,1,1,1,0,0,20230512_151614_jpg.rf.ceb493d7d9f840a198a0413f2b423ce2.jpg
2_fovea,fold_9,1,0,0,0,-1,IMG_20230512_151807_jpg.rf.c8207f2bdebe5ee316d9b9a0529d1efe.jpg
2_fovea,fold_9,3,0,0,0,-3,20230512_153403_jpg.rf.90c6c42ac826af51ce764bcff3b6923f.jpg
2_fovea,fold_9,4,0,0,0,-4,IMG_20230512_145038_jpg.rf.3da21846aa05a88c16affc46ab268cfc.jpg
2_fovea,fold_9,12,1,0,1,-11,IMG_20230512_151433_jpg.rf.d9b4366826ebd2bd7917e1cb46c50ed4.jpg
2_fovea,fold_9,4,0,0,0,-4,20230512_145336_jpg.rf.28de2a53875dce1e728e5a0c0cb97aad.jpg
2_fovea,fold_9,2,0,0,0,-2,20230512_145253_jpg.rf.c6fbf385d5f1b3ae20b0ef540f9e84b5.jpg
2_fovea,fold_9,19,7,6,1,-12,20230512_153250_jpg.rf.b3c0a5af0f8dd45ec4fe90ed8e62c274.jpg
2_fovea,fold_9,2,1,1,0,-1,20230512_151637-0-_jpg.rf.57d42a7eaecae72323f8868de4088574.jpg
2_fovea,fold_9,5,0,0,0,-5,IMG_3982_JPG.rf.084073c997ce2761c02b36ef237261da.jpg
2_fovea,fold_9,2,0,0,0,-2,20230512_145050_jpg.rf.ae125a7aa3a0b2c6f41bc879a36698ce.jpg
2_fovea,fold_9,10,3,3,0,-7,20230512_151905-0-_jpg.rf.270832f78fc4546ac9758205aad2a837.jpg
2_fovea,fold_9,2,0,0,0,-2,20230512_150048_jpg.rf.bdbae272f798a54cd79cfc08bd2da41e.jpg
2_fovea,fold_9,13,0,0,0,-13,20230512_145159_jpg.rf.a9f2125d1fdfa80946c0b272e36cb621.jpg
2_fovea,fold_9,2,0,0,0,-2,20230512_151541_jpg.rf.1a96f83831f9956a1c5cd8cb7987ee61.jpg
2_fovea,fold_9,1,0,0,0,-1,20230512_151118_jpg.rf.2bf6dd63d6a65371da02c372efde8ba3.jpg
2_fovea,fold_9,2,0,0,0,-2,IMG_3862_JPG.rf.a37466cc240bba5feaeef8019ddd0e55.jpg
2_fovea,fold_9,4,0,0,0,-4,IMG_3843_JPG.rf.3b04ef87c1af95cd756b57595eb39e72.jpg
2_fovea,fold_9,16,1,1,0,-15,IMG_20230512_145144_jpg.rf.4c14218fadac19f6b4d5270f23587de8.jpg
2_fovea,fold_9,2,0,0,0,-2,20230512_151759_jpg.rf.04ce83457ca436da1fc767b75f695b6b.jpg
2_fovea,fold_9,1,0,0,0,-1,IMG_20230512_145257_jpg.rf.453736b6f9bd9250f595d3afd851de1f.jpg
2_fovea,fold_9,2,0,0,0,-2,230512_150129_jpg.rf.10e62e193f0a96333642eeae2d068d57.jpg
2_fovea,fold_9,1,0,0,0,-1,IMG_3932_JPG.rf.42e9d2a10f9734e5a4bc91d0d9eb642c.jpg
2_fovea,fold_9,63,1,1,0,-62,0512_150200_jpg.rf.8539b7a73e953ce0ea7f67784fcb2b58.jpg
2_fovea,fold_9,6,0,0,0,-6,IMG_20230512_145254_217_jpg.rf.4e2eb97449efdb3bab4662c35a288482.jpg
2_fovea,fold_9,4,0,0,0,-4,20230512_150253_jpg.rf.a852fcb9c971bcf0f4b4b6c07b3a1e7e.jpg
2_fovea,fold_9,15,6,6,0,-9,IMG_20230512_151900_jpg.rf.fad29398cd9611cef06c98d97c2dc00c.jpg
2_fovea,fold_9,1,0,0,0,-1,IMG_3840_JPG.rf.263bceb78886d3833883706e095d5293.jpg
2_fovea,fold_9,5,0,0,0,-5,IMG_20230512_150955_jpg.rf.2011788cab5844089b8e6b7902ac846b.jpg
2_fovea,fold_9,2,0,0,0,-2,20230512_151440_jpg.rf.386c9f0ed80e964393660a1d9c01d9ed.jpg
2_fovea,fold_9,4,4,4,0,0,20230512_152247_jpg.rf.bdbffc243ed1383af5410f7bac53699a.jpg
2_fovea,fold_9,19,5,4,1,-14,20230512_152211_jpg.rf.c54aefeead1c1b68600e1ae65c10b527.jpg
2_fovea,fold_9,4,2,1,1,-2,20230512_152232_jpg.rf.01102a74dddfc813f9188dc90bff647f.jpg
2_fovea,fold_9,3,0,0,0,-3,IMG_20230512_151701_jpg.rf.0d3314dfd579b4e13828bb386bfee49b.jpg
2_fovea,fold_9,10,5,5,0,-5,IMG_20230512_152339_jpg.rf.4d50232667e59a45a8f02b1dc00c36ea.jpg
2_fovea,fold_9,5,2,1,1,-3,IMG_20230512_153347_022_jpg.rf.eca10caf5bcd60d00f0f197496dabd1c.jpg
2_fovea,fold_9,12,6,5,1,-6,IMG_20230512_152353_jpg.rf.74eba0461c089d0aea3691aee4afbac9.jpg
2_fovea,fold_9,2,0,0,0,-2,20230512_150825_jpg.rf.04725a59554eac4f344acef56d3fb6fe.jpg
2_fovea,fold_9,5,0,0,0,-5,20230512_151056_jpg.rf.3214ae92a59425896458690934fb5d39.jpg
2_fovea,fold_9,1,0,0,0,-1,230512_150046_jpg.rf.a453bfc60f25c0a831415acaf760061b.jpg
2_fovea,fold_9,6,0,0,0,-6,IMG_20230512_145419_jpg.rf.605cea1a83f727c0d545999a0d6e6e84.jpg
2_fovea,fold_9,24,0,0,0,-24,0512_150049_jpg.rf.4c2d31120db48096f79c8d147d016509.jpg
2_fovea,fold_9,1,0,0,0,-1,0052_jpg.rf.11b9f0f1317ccd80a627cd52e3e7c819.jpg
2_fovea,fold_9,4,1,0,1,-3,230512_150113_jpg.rf.491cf8e16672678e5500d8eb3e1bc404.jpg
2_fovea,fold_9,11,0,0,0,-11,20230512_145204_jpg.rf.c52942b0bcdcd04cafca718031f2ab26.jpg
2_fovea,fold_9,2,0,0,0,-2,IMG_20230512_150931_jpg.rf.2ce16e755fe6e9b894d7d449fafbd463.jpg
2_fovea,fold_9,1,0,0,0,-1,20230512_145348_jpg.rf.a9486de8293f423be4b7c903a6adf9d6.jpg
2_fovea,fold_9,1,1,1,0,0,20230512_151644_jpg.rf.3bb96898f1cf4f86f3720f45fe4a4ce1.jpg
2_fovea,fold_9,3,2,2,0,-1,IMG_4093_JPG.rf.ebedb6000fb84b714cc74fef511c31aa.jpg
2_fovea,fold_9,4,0,0,0,-4,20230512_145002_jpg.rf.97109db1b99cc660d69da24c9747f303.jpg
2_fovea,fold_9,2,1,1,0,-1,20230512_151640_jpg.rf.f22b10e3e5f15d07706b85eb0b969f91.jpg
2_fovea,fold_9,2,0,0,0,-2,20230512_151631_jpg.rf.4e69595c48be79bb26b1487f3e19266e.jpg
2_fovea,fold_9,6,2,2,0,-4,20230512_153330_jpg.rf.462ae2c6301c8971d155ebb9a3378c36.jpg
2_fovea,fold_9,8,0,0,0,-8,IMG_4189_JPG.rf.ef51bea3fc4ec3eb14a9abaa4902f277.jpg
2_fovea,fold_9,21,1,1,0,-20,20230512_150126_jpg.rf.fa9718948fbb766a50fee0608d280d14.jpg
2_fovea,fold_9,37,16,14,2,-21,IMG_20230512_153238_678_jpg.rf.9b33a9187212479d779bf15d553e8efc.jpg
2_fovea,fold_9,2,0,0,0,-2,IMG_4219_JPG.rf.81654d924a576c094f3f57b813e83fa9.jpg
2_fovea,fold_9,6,0,0,0,-6,IMG_20230512_153107_jpg.rf.1ec84b2b739232a85f9ad467ee8a214f.jpg
2_fovea,fold_10,14,3,2,1,-11,IMG_20230512_150109_804_jpg.rf.e638755720658c18627b68883d0270d6.jpg
2_fovea,fold_10,13,11,11,0,-2,IMG_4205_JPG.rf.e6945a0f8c8342f636251e46e904f729.jpg
2_fovea,fold_10,1,0,0,0,-1,IMG_20230512_145046_815_jpg.rf.bccba2de087b0c29681bdd4ff7c199f1.jpg
2_fovea,fold_10,12,9,8,1,-3,20230512_153030_jpg.rf.447a01796d662b57a717346a6885bdc7.jpg
2_fovea,fold_10,29,13,11,2,-16,20230512_153308_jpg.rf.1f2393c128a7608a2a6b40892e5c576d.jpg
2_fovea,fold_10,21,5,5,0,-16,20230512_150151_jpg.rf.73a61752872f6ef725371184031d1666.jpg
2_fovea,fold_10,1,1,1,0,0,20230512_151711_jpg.rf.10c1db788e52a7dfc81744f4936a3ef0.jpg
2_fovea,fold_10,5,6,4,2,1,20230512_152341_jpg.rf.67a7bff5a653064d0fbb2dfa8b1f90ce.jpg
2_fovea,fold_10,1,1,1,0,0,20230512_150750_jpg.rf.e86dd1819063fd640c2ba43c41a741f8.jpg
2_fovea,fold_10,10,4,4,0,-6,IMG_20230512_145121_jpg.rf.690688dd9055bfc063e326aa4fef07f4.jpg
2_fovea,fold_10,3,2,2,0,-1,20230512_152340_jpg.rf.cfcfb6148dee3cdf12d6d85f1d247895.jpg
2_fovea,fold_10,5,4,4,0,-1,20230512_152235_jpg.rf.08f40afdb24635f6dcfbb88615a2f9f7.jpg
2_fovea,fold_10,9,3,3,0,-6,20230512_152302_jpg.rf.6925e24fe61ef38107dc845cce1a2d60.jpg
2_fovea,fold_10,1,1,1,0,0,IMG_20230512_151207_jpg.rf.ae49ac5f1949da487c30a4f4ba31817b.jpg
2_fovea,fold_10,16,5,3,2,-11,20230512_150011_jpg.rf.1da3e5f3e295949ab4854def4bdbd922.jpg
2_fovea,fold_10,3,1,1,0,-2,IMG_20230512_145025_jpg.rf.c0282883e0ec5ffed07135f0bda0ecfa.jpg
2_fovea,fold_10,4,4,4,0,0,20230512_151843_jpg.rf.b93560c5fdb00199587ea962c11d4103.jpg
2_fovea,fold_10,4,1,1,0,-3,20230512_145326_jpg.rf.e57a46b969b04ee9d16c309181d71fe7.jpg
2_fovea,fold_10,1,0,0,0,-1,20230512_153428_jpg.rf.ebef48003f439c4f546df0dab6aff50b.jpg
2_fovea,fold_10,23,6,5,1,-17,IMG_20230512_150120_jpg.rf.4b23fdc5feb46ad8a31de385747c52bc.jpg
2_fovea,fold_10,4,4,4,0,0,IMG_3990_JPG.rf.7d3c75f1558f8f5fc9ac7eb6789e10dc.jpg
2_fovea,fold_10,8,3,2,1,-5,20230512_150819_jpg.rf.d1513f98969bc1b7ac4e870d3cdb41e6.jpg
2_fovea,fold_10,12,2,1,1,-10,20230512_151038_jpg.rf.6caba5860602aa931872edf19ec2b6c5.jpg
2_fovea,fold_10,1,0,0,0,-1,IMG_20230512_145146_354_jpg.rf.6de83b52b9e3abba9866d24be95f4c4d.jpg
2_fovea,fold_10,7,3,3,0,-4,IMG_4190_JPG.rf.7081f39db6690560b3a2bdd4cbc00d86.jpg
2_fovea,fold_10,3,2,2,0,-1,IMG_20230512_145252_021_jpg.rf.1779d92134a07ec7f57f4438113bb031.jpg
2_fovea,fold_10,12,7,7,0,-5,230512_150135_jpg.rf.cc24c1ff5e0e940d16df6a7b71d2eabd.jpg
2_fovea,fold_10,5,4,3,1,-1,IMG_20230512_151042_jpg.rf.15dee8949138ef80373228e81079c023.jpg
2_fovea,fold_10,6,3,2,1,-3,IMG_20230512_151950_jpg.rf.c8c0371384e1a2262fdd3d8a53e11fa3.jpg
2_fovea,fold_10,1,0,0,0,-1,IMG_20230512_151703_jpg.rf.28a7fdeaae4d54d7cf2de4be9ed4df40.jpg
2_fovea,fold_10,11,6,4,2,-5,20230512_150147_jpg.rf.55aa66e580136cb844b6c51dff5d3fed.jpg
2_fovea,fold_10,37,4,4,0,-33,20230512_150235_jpg.rf.4361e97cfeccf708272ffe4ece69dbfd.jpg
2_fovea,fold_10,2,1,1,0,-1,IMG_20230512_144940_500_jpg.rf.75e33e87c9ad9b74dd1e4b3091ba269f.jpg
2_fovea,fold_10,5,2,2,0,-3,20230512_145410_jpg.rf.56000063a0c914b346f9cd7261abac1e.jpg
2_fovea,fold_10,1,1,1,0,0,IMG_4033_JPG.rf.d1e341639e4e7d193425664e20325a4c.jpg
2_fovea,fold_10,14,3,2,1,-11,IMG_20230512_150125_134_jpg.rf.88679af4628e0ef4675fe385a333d31c.jpg
2_fovea,fold_10,13,11,11,0,-2,20230512_151904_jpg.rf.7f72f44e41b8a58e5db1391fa2b35a42.jpg
2_fovea,fold_10,2,1,1,0,-1,20230512_151841-0-_jpg.rf.601490af90bd9514d0d590298e1f0255.jpg
2_fovea,fold_10,5,2,2,0,-3,20230512_145357_jpg.rf.90422bd2b26f6dd0bd566293b4b30bb5.jpg
2_fovea,fold_10,9,5,5,0,-4,IMG_20230512_151951_jpg.rf.31e79520ea845227f969872a61796113.jpg
2_fovea,fold_10,1,1,1,0,0,20230512_151646_jpg.rf.6320d2328bf6de098fff781bcffac0cb.jpg
2_fovea,fold_10,20,9,9,0,-11,IMG_3903_JPG.rf.7c248f88ef915e14444c5c43dc048c82.jpg
2_fovea,fold_10,3,1,1,0,-2,IMG_20230512_151830_jpg.rf.c0f3338eb7af1f0e178971c38c7dec04.jpg
2_fovea,fold_10,9,1,1,0,-8,IMG_20230512_144958_jpg.rf.0a6117e6c2ebbfabe543484d7a8056db.jpg
2_fovea,fold_10,4,3,3,0,-1,IMG_4095_JPG.rf.58645f8fad94bdb38886e47695cfd8cd.jpg
2_fovea,fold_10,4,3,3,0,-1,20230512_152345_jpg.rf.2717f971fd14976a3492abb509e947cb.jpg
2_fovea,fold_10,2,2,1,1,0,IMG_3920_JPG.rf.24878eeb02230840f60014978ff530d7.jpg
2_fovea,fold_10,9,2,2,0,-7,IMG_20230512_150046_jpg.rf.6e840be1f4fa3a56d132b04b6e288480.jpg
2_fovea,fold_10,9,6,5,1,-3,IMG_20230512_145258_jpg.rf.a062df356e44019699d3c53596d3540e.jpg
2_fovea,fold_10,1,1,1,0,0,IMG_20230512_161348_jpg.rf.aea1bf3794b2d077c45245810c001a1c.jpg
2_fovea,fold_10,8,2,2,0,-6,230512_150139_jpg.rf.2d8a8d2ed426f1cb21935b033da8b2f6.jpg
2_fovea,fold_10,14,10,10,0,-4,IMG_20230512_151610_001_jpg.rf.88fda6a270dac232937c53d6188fa5a9.jpg
2_fovea,fold_10,1,0,0,0,-1,230512_145108_jpg.rf.cf20720f57cffcf1f9fa31cecfe67fbf.jpg
2_fovea,fold_10,1,0,0,0,-1,IMG_3857_JPG.rf.c98e2825881d870a7242c7271763f36b.jpg
2_fovea,fold_10,4,1,0,1,-3,20230512_151024_jpg.rf.a0cfadc35d426648ee3656824927c11e.jpg
2_fovea,fold_10,1,1,1,0,0,0036_jpg.rf.6d90090548975dc2e489ef2ff1546863.jpg
2_fovea,fold_10,2,1,1,0,-1,20230512_152306_jpg.rf.a7141e38fe1a72a82a763e55d71fd0b5.jpg
2_fovea,fold_10,15,4,4,0,-11,20230512_150018_jpg.rf.3bc690cd3af7d48b107dc3a68930fc2f.jpg
2_fovea,fold_10,7,3,2,1,-4,IMG_20230512_151112_jpg.rf.6600a13c525e7d830908b03b8a0d3526.jpg
2_fovea,fold_10,14,8,8,0,-6,0057_jpg.rf.850f7a1e0cc045be1a9326878338232a.jpg
2_fovea,fold_10,7,7,7,0,0,0051_jpg.rf.e81d23e22a72795f3bbc83a62bd65cae.jpg
2_fovea,fold_10,4,2,2,0,-2,0006_jpg.rf.ea818ccdacee9dd00131e372a19cf0d0.jpg
2_fovea,fold_10,22,8,5,3,-14,20230512_150013_jpg.rf.88f9a3a7e9a79d06352d99a9a40fcfb5.jpg
2_fovea,fold_10,1,0,0,0,-1,IMG_20230512_151605_jpg.rf.cd36cb9aab7833e1d827ed72719f9742.jpg
2_fovea,fold_10,7,0,0,0,-7,20230512_150940_jpg.rf.a642f28b441714d9d9e22de0ad22f124.jpg
2_fovea,fold_10,24,7,5,2,-17,0512_150306_jpg.rf.b16cedf3571182816f46e3a952d5c39a.jpg
2_fovea,fold_10,3,4,3,1,1,20230512_152308_jpg.rf.f4dc38f04cbc5fd664dec02e3ed16103.jpg
2_fovea,fold_10,2,2,2,0,0,IMG_20230512_151812_jpg.rf.86425b9d53f765e1b77d6eba211405fe.jpg
2_fovea,fold_10,12,7,7,0,-5,20230512_152316_jpg.rf.dd8d1d54a326eb9ed9a63bc5520eadad.jpg
2_fovea,fold_10,2,2,2,0,0,20230512_152213_jpg.rf.1125dc3c4a87888cb65b2d513aa9df85.jpg
2_fovea,fold_10,17,0,0,0,-17,IMG_20230512_150147_169_jpg.rf.df6bd6535b4bdd11e20a358e10a11c09.jpg
2_fovea,fold_10,10,8,8,0,-2,IMG_4100_JPG.rf.f55f9f2afb5f41daaa63474d6df30725.jpg
2_fovea,fold_10,23,14,10,4,-9,IMG_20230512_153004_jpg.rf.19c27a824e3c2f07149751bcaaa47c7f.jpg
2_fovea,fold_10,1,1,1,0,0,20230512_151648_jpg.rf.f5ddd2e522a504da5dc723bdc2dec390.jpg
2_fovea,fold_10,2,3,1,2,1,0005_jpg.rf.79044c26eeb52526a25a3f38e1aa840d.jpg
2_fovea,fold_10,4,0,0,0,-4,IMG_20230512_145001_113_jpg.rf.5ea2af9825ef6b6ebe2436d89dbe79ca.jpg
2_fovea,fold_10,1,0,0,0,-1,IMG_4183_JPG.rf.1c0ab4bee811c122c1ef5f9131477050.jpg
2_fovea,fold_10,2,1,0,1,-1,20230512_151124_jpg.rf.250cebbf32ee5a6ab788e62fd50ecf2c.jpg
2_fovea,fold_10,3,0,0,0,-3,IMG_4022_JPG.rf.e15de99fae6d1e74eb63284f3616a75f.jpg
2_fovea,fold_10,7,5,5,0,-2,20230512_152319_jpg.rf.abeccdd8fbdc8f18e24c3acdf6c07d48.jpg
2_fovea,fold_10,25,12,12,0,-13,IMG_3911_JPG.rf.1bb0ec60809450d49cc43c3d8a1265de.jpg
2_fovea,fold_10,6,1,1,0,-5,20230512_151418_jpg.rf.90e438577c310e46b8a21f2ae0b85242.jpg
2_fovea,fold_10,9,5,5,0,-4,20230512_153311_jpg.rf.3ecbca1f6ffb06d59119f6627139da8a.jpg
2_fovea,fold_10,5,3,2,1,-2,20230512_150206_jpg.rf.8ae1878e1b65e9920f1a99af4f941d9c.jpg
2_fovea,fold_10,3,0,0,0,-3,IMG_4389_JPG.rf.d64ad350bc28019aa4851039e73dfdfa.jpg
2_fovea,fold_10,10,2,1,1,-8,0512_150317_jpg.rf.a70fbe5816d46c9fa83979febbeb753f.jpg
2_fovea,fold_10,7,2,2,0,-5,20230512_145440_jpg.rf.faac237167337f22dcbfb3879916747e.jpg
2_fovea,fold_10,14,7,5,2,-7,20230512_150138_jpg.rf.baad1e97bbf234f37489ac66f024a808.jpg
2_fovea,fold_10,12,7,6,1,-5,20230512_150159_jpg.rf.15a7a075343358e808fef60d09b7b8c3.jpg
2_fovea,fold_10,2,0,0,0,-2,IMG_20230512_151004_jpg.rf.fa632ed53260b0c0873743bd4155a490.jpg
2_fovea,fold_10,6,4,4,0,-2,IMG_20230512_151929_jpg.rf.8916d2cec0ed6feba243725d4795cee6.jpg
2_fovea,fold_10,6,2,1,1,-4,20230512_150108_jpg.rf.114d86f5dc5d95e4469bf960bc7c0a4f.jpg
2_fovea,fold_10,10,7,5,2,-3,0014_jpg.rf.69fba8cc80a5714926e6841f224baffc.jpg
2_fovea,fold_10,1,1,1,0,0,IMG_20230512_145359_479_jpg.rf.6b65f34991508137d8d33789257462e4.jpg
2_fovea,fold_10,5,0,0,0,-5,MG_20230512_145100_jpg.rf.2fac7875b124670b96ab0a3b253f2e29.jpg
2_fovea,fold_10,6,4,3,1,-2,20230512_151747_jpg.rf.f2ca78e158d0f2965152169425291a5a.jpg
2_fovea,fold_10,9,3,3,0,-6,230512_150154_jpg.rf.6b065a843e8b776c3731c23f8a875399.jpg
2_fovea,fold_10,1,0,0,0,-1,20230512_145117_jpg.rf.1ad15540d0fbbd6bac016639ff1c07a3.jpg
2_fovea,fold_10,4,4,3,1,0,20230512_145248_jpg.rf.8a3953be78b4c9d70df1b12fd15d4939.jpg
2_fovea,fold_10,2,1,1,0,-1,IMG_3836_JPG.rf.434cd50ae74cfc4c9d1e3085a73a905b.jpg
2_fovea,fold_10,8,4,3,1,-4,20230512_150949_jpg.rf.81b6e460185cb992a26ccccb5e72b394.jpg
2_fovea,fold_10,11,10,10,0,-1,IMG_20230512_152452_jpg.rf.849169ae208c086f88f01686f87e3c82.jpg
2_fovea,fold_10,12,9,8,1,-3,IMG_aaaa_jpg.rf.6f8cea923b21b011dca38cdc115eaf80.jpg
2_fovea,fold_10,1,0,0,0,-1,IMG_20230512_145313_jpg.rf.3ae2ff3ddf2bb75af26203bf8cca362c.jpg
2_fovea,fold_10,14,7,7,0,-7,IMG_20230512_151605_536_jpg.rf.39cf087a8f42f961dca0c0caa4dfa17d.jpg
2_fovea,fold_10,8,4,4,0,-4,20230512_145342_jpg.rf.b956dcb9a2579c2e8f754353e1d00c75.jpg
2_fovea,fold_10,8,3,3,0,-5,IMG_4193_JPG.rf.ee7ebd7c653b26c381990c2e3f69556f.jpg
2_fovea,fold_10,5,1,1,0,-4,IMG_20230512_151457_jpg.rf.49e2e6a56131fab5a439e78b087a3b8a.jpg
2_fovea,fold_10,1,1,1,0,0,20230512_145224_jpg.rf.b8204cbb29051890879b714634f912b6.jpg
2_fovea,fold_10,11,7,5,2,-4,IMG_20230512_152257_409_jpg.rf.8463210402c73719c09f0b2210f7cfb4.jpg
2_fovea,fold_10,16,5,5,0,-11,20230512_152313_jpg.rf.cae2b30990ff4679b62bdf438fbd8044.jpg
2_fovea,fold_10,1,0,0,0,-1,0230512_145347_jpg.rf.58a6f73f43efb9705bb2978f49927337.jpg
2_fovea,fold_10,9,8,8,0,-1,0034_jpg.rf.d4c6d4e1816e57648e3dbb1782385073.jpg
2_fovea,fold_10,2,0,0,0,-2,IMG_20230512_151611_jpg.rf.b44877740f7dd0dc052351bbded2044b.jpg
2_fovea,fold_10,17,10,9,1,-7,230512_150149_jpg.rf.b74d07f3292d3144d25facf3dde243dc.jpg
2_fovea,fold_10,59,20,0,20,-39,IMG_20230512_153218_jpg.rf.cac514c0d5c15fe1628359a5bfa2dacb.jpg
2_fovea,fold_10,6,4,2,2,-2,IMG_20230512_145054_075_jpg.rf.5e98b15c8a4633098064286c64be239e.jpg
2_fovea,fold_10,5,0,0,0,-5,IMG_20230512_151259_jpg.rf.7b57c2547bbd877ef1243a2ab325c2fa.jpg
2_fovea,fold_10,70,7,5,2,-63,20230512_153220_jpg.rf.660dfd8464712797760cfa3b49fef4e7.jpg
2_fovea,fold_10,9,4,4,0,-5,IMG_4186_JPG.rf.c6b51e615ccecf25291d4d3bd703172a.jpg
2_fovea,fold_10,4,0,0,0,-4,20230512_144950_jpg.rf.b105c1ba7257a4da1b17c9f42de1770a.jpg
2_fovea,fold_10,9,5,5,0,-4,IMG_20230512_145304_jpg.rf.7de02525de42506dbd7eda7365fd0065.jpg
2_fovea,fold_10,4,2,2,0,-2,20230512_145209_jpg.rf.c73d398c69a90599525e2c2a8cb51f2c.jpg
2_fovea,fold_10,3,2,2,0,-1,20230512_151741_jpg.rf.989b1ddb73b99e41bd2bddfcf1c60e1d.jpg
2_fovea,fold_10,2,1,1,0,-1,20230512_152209_jpg.rf.c79a1a42b4846b485a9b00d575fb1626.jpg
2_fovea,fold_10,17,8,8,0,-9,20230512_152258_jpg.rf.485967412d3788c1a657a3be4d77671e.jpg
2_fovea,fold_10,2,2,2,0,0,IMG_20230512_151818_jpg.rf.593796b492f80d2ddd3e0449eec86414.jpg
2_fovea,fold_10,1,0,0,0,-1,20230512_145110_jpg.rf.02ac7002fe460313bbf3d2c9d99f8ba7.jpg
2_fovea,fold_10,4,2,2,0,-2,IMG_3907_JPG.rf.b1def63b2acf54c44c0c502aca5f4d44.jpg
2_fovea,fold_10,1,1,1,0,0,20230512_150722_jpg.rf.811e652f271c46d6a3e10299f1a6b7d9.jpg
2_fovea,fold_10,1,0,0,0,-1,20230512_145243_jpg.rf.6f06c25acca67180648bf428a474f0b3.jpg
2_fovea,fold_10,2,2,1,1,0,20230512_145053_jpg.rf.dd5c06f85a2f9673d635a3b60256df27.jpg
2_fovea,fold_10,1,1,1,0,0,IMG_20230512_151236_jpg.rf.697c89d65f7f53a2cf18544c923eb896.jpg
2_fovea,fold_10,1,1,1,0,0,0230512_145425_jpg.rf.f4fcff283a6f3d5ea4f0275a52a87728.jpg
2_fovea,fold_10,24,11,11,0,-13,0001_jpg.rf.0c630bace393ba8970fa7c3c8fd7c235.jpg
2_fovea,fold_10,8,9,8,1,1,20230512_152317_jpg.rf.fddebbf7fe2a035df51e17bb0c14e2b4.jpg
2_fovea,fold_10,9,1,1,0,-8,IMG_4209_JPG.rf.093053ef31116bcee7646b801c678d5b.jpg
2_fovea,fold_10,23,8,7,1,-15,20230512_150122_jpg.rf.cb6d477ccda3127b4d473101af503eb3.jpg
2_fovea,fold_10,4,4,3,1,0,20230512_152326_jpg.rf.8ca5737543dbfcb717b333d32cc18f8b.jpg
2_fovea,fold_10,1,1,0,1,0,20230512_145056_jpg.rf.2bbf028730f3b9804aa416234c6db613.jpg
2_fovea,fold_10,6,4,4,0,-2,0037_jpg.rf.e51421425c8718d498a1cc958bfeeb2b.jpg
2_fovea,fold_10,10,4,4,0,-6,IMG_20230512_153400_jpg.rf.5f42ce4759cb794127f4f23098e0ff58.jpg
2_fovea,fold_10,8,8,8,0,0,20230512_151848_jpg.rf.2c6000bd3b3f3ae44c8e672b08aec3b5.jpg
2_fovea,fold_10,23,0,0,0,-23,IMG_20230512_153450_jpg.rf.af0e93ea32d0b17c0b616de937189066.jpg
2_fovea,fold_10,3,1,1,0,-2,IMG_3921_JPG.rf.e8186af83ff3af27612213a05a7c5177.jpg
2_fovea,fold_10,10,7,6,1,-3,IMG_20230512_145056_jpg.rf.340c9781ae519c2a173e9014c5be4072.jpg
2_fovea,fold_10,5,1,0,1,-4,20230512_145001_jpg.rf.ac3499ee309bec2035194be16f5da378.jpg
2_fovea,fold_10,1,0,0,0,-1,20230512_145104_jpg.rf.a25f0f63e3b58e348bedb4aa97e67394.jpg
2_fovea,fold_10,38,6,2,4,-32,0512_150303_jpg.rf.54131a2e7501a146e0d64448ccb7d595.jpg
2_fovea,fold_10,1,0,0,0,-1,20230512_145308_jpg.rf.692ac823c338ea1cdf326339c51eb5b1.jpg
2_fovea,fold_10,7,5,4,1,-2,0060_jpg.rf.a0b1380ab0b6548c6335a9f12bb9f9f5.jpg
2_fovea,fold_10,1,1,1,0,0,IMG_20230512_150846_jpg.rf.f9a1c340f4f40ffecf79883a50c53a30.jpg
2_fovea,fold_10,11,10,9,1,-1,20230512_151902_jpg.rf.0d916693ef179e70195af9fd22402789.jpg
2_fovea,fold_10,13,1,0,1,-12,IMG_4211_JPG.rf.76ca0821ebf56f29d1009eb9ff45a384.jpg
2_fovea,fold_10,10,9,7,2,-1,IMG_20230512_153020_jpg.rf.e9080cc66a8631a1e9e4e610e61bc6a4.jpg
2_fovea,fold_10,14,6,5,1,-8,20230512_153059_jpg.rf.48d36662c46f21f6e2c61dbaa81b1253.jpg
2_fovea,fold_10,6,4,3,1,-2,IMG_20230512_145113_jpg.rf.0828a4e83c0458a5f8bc5967b29e1db1.jpg
2_fovea,fold_10,1,1,1,0,0,20230512_145418_jpg.rf.8af049af1c5b2eb413647f320a119a74.jpg
3_deformable_detr,fold_1,2,1,1,0,-1,20230512_153003_jpg.rf.3e11918b7e073ed9642c3d889f82a10b.jpg
3_deformable_detr,fold_1,3,3,3,0,0,20230512_152344_jpg.rf.9cdeba0a7faf9c91db6a1bec355cd79f.jpg
3_deformable_detr,fold_1,8,8,8,0,0,20230512_150202_jpg.rf.2d354a6afba7660a4bdb4422aacb0bf1.jpg
3_deformable_detr,fold_1,2,2,2,0,0,20230512_151842_jpg.rf.0400a2b89be930a6aee77dd6416cc317.jpg
3_deformable_detr,fold_1,1,1,1,0,0,20230512_153001_jpg.rf.9e1933e066ac83bf9fbd01b8def6158d.jpg
3_deformable_detr,fold_1,6,6,6,0,0,IMG_4052_JPG.rf.a484ba8b08f647c9d706f26a2c1bdd88.jpg
3_deformable_detr,fold_1,1,1,1,0,0,IMG_3933_JPG.rf.b0d6e8cf999e8234386ed5bb6107f61a.jpg
3_deformable_detr,fold_1,23,4,4,0,-19,20230512_153423_jpg.rf.199d17397bc75e4b3c997992a9469adb.jpg
3_deformable_detr,fold_1,1,1,0,1,0,230512_150115_jpg.rf.048aa47fa124320a4fa8a5c30506622b.jpg
3_deformable_detr,fold_1,8,5,5,0,-3,20230512_152239_jpg.rf.5270f7fe5715e9e4db1967390d36c76d.jpg
3_deformable_detr,fold_1,7,6,6,0,-1,IMG_20230512_152358_jpg.rf.14382fa8e1d185e8ecd9b6b625021b8f.jpg
3_deformable_detr,fold_1,1,1,1,0,0,20230512_151657_jpg.rf.ae916e776287bd8044bda6da1e1dec7e.jpg
3_deformable_detr,fold_1,2,1,1,0,-1,IMG_4202_JPG.rf.389eb0baa38b2b42b82e272dae53dd7b.jpg
3_deformable_detr,fold_1,10,12,5,7,2,20230512_150031_jpg.rf.5b7cf141f46aecb85b2c9e4f6977aa4c.jpg
3_deformable_detr,fold_1,4,6,4,2,2,IMG_20230512_151251_jpg.rf.13115516a78a5324e008f7864789fbec.jpg
3_deformable_detr,fold_1,17,7,5,2,-10,20230512_150005_jpg.rf.77d140d77f3f48953c783c2d50e6f910.jpg
3_deformable_detr,fold_1,1,0,0,0,-1,20230512_150058_jpg.rf.daa9ab4c09a0e2a557b1e8bb54702ecb.jpg
3_deformable_detr,fold_1,6,6,6,0,0,20230512_152201_jpg.rf.3c9e01b2433736fc6ee290b90dd42684.jpg
3_deformable_detr,fold_1,6,4,4,0,-2,IMG_20230512_151219_jpg.rf.6d76721a015ae20af4047ec2607a62e0.jpg
3_deformable_detr,fold_1,19,11,10,1,-8,IMG_20230512_150136_jpg.rf.004497d9e0b84ae3cd5c8e7e5e9f30d7.jpg
3_deformable_detr,fold_1,32,12,12,0,-20,0008_jpg.rf.94e89ad01289e8cfda380621151bf1bb.jpg
3_deformable_detr,fold_1,1,1,1,0,0,IMG_4027_JPG.rf.02fde7996d0a3e63cd8727ba35b98fbd.jpg
3_deformable_detr,fold_1,7,7,6,1,0,IMG_4051_JPG.rf.1f19a2adfb075e1a7c5d3d9567879ae2.jpg
3_deformable_detr,fold_1,3,2,2,0,-1,IMG_20230512_145126_jpg.rf.0493bac7dcca35f2a361df2325097b88.jpg
3_deformable_detr,fold_1,4,3,3,0,-1,0004_jpg.rf.7a14cc5ff08b5ee1437266474bc51865.jpg
3_deformable_detr,fold_1,1,1,1,0,0,20230512_151446_jpg.rf.801ee52ac482b80a6b7e2c7a7a896dc7.jpg
3_deformable_detr,fold_1,1,1,1,0,0,20230512_153217_jpg.rf.3d66bba80f697d614260fc56dd593486.jpg
3_deformable_detr,fold_1,23,9,4,5,-14,20230512_150312_jpg.rf.2040a566a6e8aa7d77563942d16e3907.jpg
3_deformable_detr,fold_1,4,3,3,0,-1,20230512_153409_jpg.rf.b9be0a0b5dc71b17d03a58db2af65fd3.jpg
3_deformable_detr,fold_1,1,1,1,0,0,20230512_145140_jpg.rf.3d71f74b4ed8a93a636f79ef1a9a7e9c.jpg
3_deformable_detr,fold_1,7,4,4,0,-3,0002_jpg.rf.d16d3de92655da222f9470322637f0a1.jpg
3_deformable_detr,fold_1,2,2,2,0,0,IMG_20230512_153111_jpg.rf.71fdfa6f08329e5d2412e86bf6870b02.jpg
3_deformable_detr,fold_1,3,1,1,0,-2,IMG_20230512_151306_jpg.rf.e4b348fae9b8d16d80a5be211e9e39a1.jpg
3_deformable_detr,fold_1,7,5,5,0,-2,20230512_150132_jpg.rf.b204b63d3e3f8ef2920b32f1e0b6ab50.jpg
3_deformable_detr,fold_1,3,4,3,1,1,IMG_20230512_151314_jpg.rf.231b8a97bc932aa622a2b27c80ee878b.jpg
3_deformable_detr,fold_1,1,1,1,0,0,20230512_145419_jpg.rf.cf9776dd6ff86988e3d4a8734ba6f15c.jpg
3_deformable_detr,fold_1,1,1,1,0,0,IMG_20230512_161355_jpg.rf.f1c1af37db10bfc139da92a922fa83a2.jpg
3_deformable_detr,fold_1,1,2,1,1,1,IMG_20230512_151815_jpg.rf.fad6e45cfa5e7c506e9fbad254cef9e0.jpg
3_deformable_detr,fold_1,6,5,4,1,-1,IMG_3922_JPG.rf.4fa3ab6d4b090dd6a9114495e5b5a468.jpg
3_deformable_detr,fold_1,37,11,8,3,-26,IMG_20230512_150214_jpg.rf.0a3e70748a25dbc7ca5305e84da8d3cd.jpg
3_deformable_detr,fold_1,5,5,5,0,0,20230512_152251_jpg.rf.ebcf28d3c9a35107daa9beb28ae3475b.jpg
3_deformable_detr,fold_1,2,2,1,1,0,20230512_151110_jpg.rf.53961421a4e7bd7511e281309a72a2c9.jpg
3_deformable_detr,fold_1,2,2,2,0,0,20230512_151630_jpg.rf.ecc81d9067cb1ce5be1c14f9a6d71d9d.jpg
3_deformable_detr,fold_1,11,3,2,1,-8,IMG_20230512_145044_jpg.rf.d79716a7705a23a496d5d4896dbcf506.jpg
3_deformable_detr,fold_1,1,1,1,0,0,20230512_145031_jpg.rf.0c829f489393188e9f1ecc0ff78d8324.jpg
3_deformable_detr,fold_1,1,1,1,0,0,20230512_151712_jpg.rf.c494c6b379e948f9f084efcd40c0619d.jpg
3_deformable_detr,fold_1,13,12,11,1,-1,20230512_153109_jpg.rf.930610a4b0e78acb8ed778e44b9d5922.jpg
3_deformable_detr,fold_1,4,5,4,1,1,IMG_20230512_151205_jpg.rf.2bbe055a56edab8e820150d32613da40.jpg
3_deformable_detr,fold_1,2,2,0,2,0,20230512_150059-0-_jpg.rf.641cecd96312dfe886a8bf287b5916db.jpg
3_deformable_detr,fold_1,2,2,1,1,0,20230512_145234_jpg.rf.d7e55e93d9f98a6de3d20ef7221babc8.jpg
3_deformable_detr,fold_1,4,4,3,1,0,IMG_20230512_145359_jpg.rf.c0fb243e34926596f7a71595884ae8c5.jpg
3_deformable_detr,fold_1,6,5,5,0,-1,20230512_145334_jpg.rf.0b72b785a7b59d3a4217025c7e5a2423.jpg
3_deformable_detr,fold_1,10,9,9,0,-1,20230512_152402_jpg.rf.2af7283a541e5a9a5150707a47c4be20.jpg
3_deformable_detr,fold_1,2,3,2,1,1,20230512_145352_jpg.rf.c846cb3c36e5363cfaa577a44b6913d8.jpg
3_deformable_detr,fold_1,23,14,13,1,-9,20230512_150226_jpg.rf.f79017b16f1532730f31cb325d6ab86e.jpg
3_deformable_detr,fold_1,1,1,1,0,0,20230512_153345-0-_jpg.rf.6e0b5b843ebfea1138cb759960e1bafc.jpg
3_deformable_detr,fold_1,2,1,1,0,-1,0036_jpg.rf.95bf6e3cde891a0e422157eafa8da143.jpg
3_deformable_detr,fold_1,1,1,1,0,0,20230512_150121_jpg.rf.b7f710edf2464cb4724d24c65bae04b4.jpg
3_deformable_detr,fold_1,1,1,1,0,0,20230512_150720_jpg.rf.a18892cc876f35236d2a20ba37b6efd8.jpg
3_deformable_detr,fold_1,13,9,8,1,-4,20230512_153007_jpg.rf.d3b0e4362c8dc7fde7b007165efdd07e.jpg
3_deformable_detr,fold_1,1,0,0,0,-1,20230512_144958_jpg.rf.bd51a27225a9ddf5ef21b54512e10b9b.jpg
3_deformable_detr,fold_1,2,3,2,1,1,20230512_151201_jpg.rf.003d9f32250e51b928c51a05b230f55a.jpg
3_deformable_detr,fold_1,5,1,0,1,-4,IMG_20230512_145247_597_jpg.rf.464f6c3eb3265be95f2f08e2d0bdd91a.jpg
3_deformable_detr,fold_1,8,6,6,0,-2,20230512_152159_jpg.rf.f9d372b7fdee9c83d543f19d83accc75.jpg
3_deformable_detr,fold_1,17,6,2,4,-11,IMG_20230512_150133_jpg.rf.e1213a79a5060e17585ebc484a3c63d6.jpg
3_deformable_detr,fold_1,4,3,2,1,-1,20230512_145007_jpg.rf.b9641853c4144bc1d5622b022182ed4b.jpg
3_deformable_detr,fold_1,1,3,1,2,2,IMG_20230512_145057_967_jpg.rf.680792c5520fea6605bcf774a290cd8f.jpg
3_deformable_detr,fold_1,2,1,1,0,-1,20230512_151633_jpg.rf.a660ff615450152ab9fbed4d02eeb6d7.jpg
3_deformable_detr,fold_1,8,8,7,1,0,IMG_4090_JPG.rf.677923e65dcfcc46588eee4c2c2c9e46.jpg
3_deformable_detr,fold_1,10,9,9,0,-1,20230512_152258_jpg.rf.2e43ef7a91920046b900730064da408d.jpg
3_deformable_detr,fold_1,18,15,15,0,-3,20230512_152402_jpg.rf.5f60c1b7e4703f63b61c50a74049302f.jpg
3_deformable_detr,fold_1,4,3,3,0,-1,20230512_151121_jpg.rf.d9f5fd5a912436d588c2e8a3681b8643.jpg
3_deformable_detr,fold_1,15,12,12,0,-3,20230512_152310_jpg.rf.22fd13a135de99870e2b9f19a9dbd566.jpg
3_deformable_detr,fold_1,15,13,13,0,-2,IMG_4206_JPG.rf.86dc764134fcaa91fd5246c96808ba7a.jpg
3_deformable_detr,fold_1,1,1,1,0,0,20230512_145233_jpg.rf.9e2d494cc8579c52d6794c0fb5af14b7.jpg
3_deformable_detr,fold_1,1,1,1,0,0,IMG_4014_JPG.rf.67af8816872a56054c245e272bdd23db.jpg
3_deformable_detr,fold_1,11,10,10,0,-1,IMG_20230512_151956_jpg.rf.accb7456b90404e99398a8475aa5f074.jpg
3_deformable_detr,fold_1,5,5,5,0,0,20230512_152221_jpg.rf.dfe82842e573d8a1a7ff0d4519256b1d.jpg
3_deformable_detr,fold_1,35,8,8,0,-27,0512_150052_jpg.rf.6838fe76e0e5f7752c388cea428a676b.jpg
3_deformable_detr,fold_1,3,4,3,1,1,IMG_20230512_150949_jpg.rf.0a7b1aca0bc2e95e7b33b4409d5f03e1.jpg
3_deformable_detr,fold_1,5,3,2,1,-2,20230512_145412_jpg.rf.9224a9f695664a7b936da6fb81af36c9.jpg
3_deformable_detr,fold_1,10,9,8,1,-1,20230512_151907_jpg.rf.8b3da1939d33aa65bfb85cb4ba33d685.jpg
3_deformable_detr,fold_1,1,1,1,0,0,20230512_151037_jpg.rf.57044d376bf29efab4142e6e059723d3.jpg
3_deformable_detr,fold_1,1,1,1,0,0,20230512_151510-0-_jpg.rf.8fdff95c003658062d05e4285948dcbb.jpg
3_deformable_detr,fold_1,10,9,8,1,-1,20230512_151857_jpg.rf.d5917286f02e07a5305d7b858c6244ec.jpg
3_deformable_detr,fold_1,2,2,2,0,0,IMG_20230512_151822_jpg.rf.cd5ee7cbb4e275377fc3e1ca11bd6a01.jpg
3_deformable_detr,fold_1,18,14,14,0,-4,20230512_152223_jpg.rf.7b4c9b6ebd76c6c1084f1453a97610d9.jpg
3_deformable_detr,fold_1,2,2,2,0,0,0015_jpg.rf.a767e21c0a0684765afe242b8052602a.jpg
3_deformable_detr,fold_1,2,1,0,1,-1,IMG_20230512_145027_jpg.rf.16a85daab3bfea64be4f44d4de24d8b4.jpg
3_deformable_detr,fold_1,2,2,1,1,0,IMG_20230512_145337_jpg.rf.04c6c7ecd50fc9cd76f28da038eea12a.jpg
3_deformable_detr,fold_1,4,3,3,0,-1,20230512_145119_jpg.rf.f0411939c238246ea7d83cb97f4b291a.jpg
3_deformable_detr,fold_1,1,1,1,0,0,20230512_151618_jpg.rf.9cfdd92f0dd263ec71adc25e0966b10d.jpg
3_deformable_detr,fold_1,21,19,16,3,-2,20230512_150123_jpg.rf.ca38530fba79c2eea723776f3cb9701e.jpg
3_deformable_detr,fold_1,8,8,7,1,0,IMG_20230512_151954_jpg.rf.1f74638dd64a022c7ddbc6b607ebb63f.jpg
3_deformable_detr,fold_1,2,2,2,0,0,20230512_153358_jpg.rf.000b91eaf995cb7029bac19a97ae0eab.jpg
3_deformable_detr,fold_1,3,2,2,0,-1,0030_jpg.rf.92e747a4b264c12a0f5bd7b7fff47c97.jpg
3_deformable_detr,fold_1,2,1,1,0,-1,IMG_3838_JPG.rf.6259d7b6f664061333ba70518ffa409a.jpg
3_deformable_detr,fold_1,47,37,36,1,-10,20230512_153205_jpg.rf.a397edfe98870b927aac7d426225215e.jpg
3_deformable_detr,fold_1,3,1,1,0,-2,20230512_151421_jpg.rf.32f90f849ffd68e483c8af1c30cd3e88.jpg
3_deformable_detr,fold_1,4,4,4,0,0,20230512_150228_jpg.rf.bdef78abc0510427f86904d310db4ffe.jpg
3_deformable_detr,fold_1,1,1,1,0,0,20230512_150729_jpg.rf.8d31acfa9500f54af8d12c1ddbddbd65.jpg
3_deformable_detr,fold_1,1,0,0,0,-1,IMG_4221_JPG.rf.c34edb7d27501d2bebad754740f2c36d.jpg
3_deformable_detr,fold_1,91,50,38,12,-41,20230512_153222_jpg.rf.02d4e5f1788464607b60d200b123696a.jpg
3_deformable_detr,fold_1,15,13,13,0,-2,20230512_152343_jpg.rf.b78ec2e1eb5a82ab22cb447b29e60a37.jpg
3_deformable_detr,fold_1,4,4,4,0,0,20230512_145420_jpg.rf.63f8530ad3e9147d791de1d4a62e2845.jpg
3_deformable_detr,fold_1,3,2,2,0,-1,IMG_20230512_145129_jpg.rf.7c57fcf634dd12adb9bd6bfb5ab72307.jpg
3_deformable_detr,fold_1,3,3,3,0,0,IMG_20230512_152950_jpg.rf.7b0419faa0e6c3e396abcf1d3db70ba2.jpg
3_deformable_detr,fold_1,7,7,6,1,0,IMG_20230512_145458_jpg.rf.0869453997d27a12e193c3576f5be50f.jpg
3_deformable_detr,fold_1,2,2,2,0,0,20230512_150320_jpg.rf.f00816162e753a50c482ccbb2723a8bb.jpg
3_deformable_detr,fold_1,2,2,2,0,0,20230512_151501-0-_jpg.rf.ac937acab812f79dd846ec10e9eb794f.jpg
3_deformable_detr,fold_1,4,4,4,0,0,IMG_20230512_151857_jpg.rf.f3b0a248067ce9c5df43e8eb1b7b8f48.jpg
3_deformable_detr,fold_1,1,0,0,0,-1,20230512_151507_jpg.rf.83b7b0f7341f0c68f2169ab2e25d50af.jpg
3_deformable_detr,fold_1,4,5,4,1,1,IMG_4098_JPG.rf.d05c322cd8fa2c89a0d093e8e91666a2.jpg
3_deformable_detr,fold_1,5,5,5,0,0,IMG_20230512_144938_jpg.rf.61fbc5c9c8be89bcb4b1529921428829.jpg
3_deformable_detr,fold_1,9,6,6,0,-3,20230512_152348_jpg.rf.9a9f308e6e3d3ff1b666f67b5196d238.jpg
3_deformable_detr,fold_1,2,1,1,0,-1,20230512_151131_jpg.rf.62d78c2e91ff2133e0623bbd8de03bda.jpg
3_deformable_detr,fold_1,1,1,1,0,0,IMG_20230512_150905_jpg.rf.498fdb5cdf1e78cfffa9005586c25d1b.jpg
3_deformable_detr,fold_1,1,1,1,0,0,20230512_145033_jpg.rf.5a4b7044f38311bf91bd61b2107f6208.jpg
3_deformable_detr,fold_1,2,1,1,0,-1,0002_jpg.rf.244244e268805e9279e2778f66f93c67.jpg
3_deformable_detr,fold_1,9,7,5,2,-2,IMG_20230512_145357_jpg.rf.65481eda27afaba20ecf66958bd1a415.jpg
3_deformable_detr,fold_1,40,25,23,2,-15,IMG_20230512_150251_jpg.rf.2318a91c9b0a0d0c74b337b923e9e074.jpg
3_deformable_detr,fold_1,4,2,2,0,-2,IMG_20230512_145134_jpg.rf.084766d54cd58d09cacfc92914a1a5c7.jpg
3_deformable_detr,fold_1,9,10,8,2,1,IMG_20230512_152000_jpg.rf.af9cbaac286010743e1eabfda3ff16fd.jpg
3_deformable_detr,fold_1,3,2,1,1,-1,20230512_145302_jpg.rf.52f6bff4360f5a174eb1a21d91490e2f.jpg
3_deformable_detr,fold_1,4,2,2,0,-2,0013_jpg.rf.46c0cfad5d61b22f1717205aab02e682.jpg
3_deformable_detr,fold_1,13,10,7,3,-3,20230512_152958_jpg.rf.43cafd5762e96ebdaf2638b5e2e5ede5.jpg
3_deformable_detr,fold_1,1,1,1,0,0,IMG_20230512_145002_jpg.rf.a16310bc3cbd1bce46d8e207260f6d2f.jpg
3_deformable_detr,fold_1,20,13,13,0,-7,20230512_150157_jpg.rf.8b6ad4dda7ad6b93ac57bd92f16dcdcd.jpg
3_deformable_detr,fold_1,6,1,1,0,-5,IMG_20230512_144908_684_jpg.rf.89a536225f1a283e12d5bb8970ee31cb.jpg
3_deformable_detr,fold_1,2,1,1,0,-1,20230512_151455_jpg.rf.eb853c4caca8daef122f54e54ffa44ce.jpg
3_deformable_detr,fold_1,3,4,3,1,1,IMG_20230512_151214_jpg.rf.885e6d5e144fd3b97b6ab96da191a928.jpg
3_deformable_detr,fold_1,2,2,2,0,0,20230512_151744_jpg.rf.b461e1fdf32cd5c1232cf11220a2bef4.jpg
3_deformable_detr,fold_1,7,6,5,1,-1,IMG_3868_JPG.rf.1770b3eda4aaec864f7cf0d27d04888b.jpg
3_deformable_detr,fold_1,7,6,6,0,-1,20230512_151845_jpg.rf.8dee8031c86ff6697d6d671e32b55f55.jpg
3_deformable_detr,fold_1,17,10,7,3,-7,20230512_150009_jpg.rf.5eaca93499ee2328bb5b204bc086fa0e.jpg
3_deformable_detr,fold_1,4,4,4,0,0,IMG_4055_JPG.rf.a1d3f9eab20829bc4aab9b5d5b3db316.jpg
3_deformable_detr,fold_1,3,3,3,0,0,20230512_145429_jpg.rf.df99f30a99cc1af30b8fe3054ff8d8af.jpg
3_deformable_detr,fold_1,3,3,3,0,0,IMG_20230512_150829_549_jpg.rf.017095633151bc8caa1cad24d2d1f6bd.jpg
3_deformable_detr,fold_1,10,5,5,0,-5,0230512_150206_jpg.rf.e404633a283ca64c43725aeb3181ac5b.jpg
3_deformable_detr,fold_1,1,1,1,0,0,20230512_145044_jpg.rf.2dd273c7dcfa2783f4fc1f356c3e0fe1.jpg
3_deformable_detr,fold_1,18,14,14,0,-4,IMG_20230512_153031_jpg.rf.5fce0e233ead5453574fecd0d970a691.jpg
3_deformable_detr,fold_1,3,2,2,0,-1,IMG_4197_JPG.rf.f240386fc9d9d286399404892833ad93.jpg
3_deformable_detr,fold_1,2,2,1,1,0,MG_20230512_145132_jpg.rf.f7010b407a0b401d833ccbcf5807b8c7.jpg
3_deformable_detr,fold_1,15,12,11,1,-3,20230512_151046_jpg.rf.8feca45b0b1694e2250d447c5e17a7e5.jpg
3_deformable_detr,fold_1,21,11,8,3,-10,20230512_153045_jpg.rf.8ee689d2bb2062ede3d6c1a97a93cb0b.jpg
3_deformable_detr,fold_1,2,2,2,0,0,0024_jpg.rf.d7ace9e90a7a9b7f0bac8fa590936bec.jpg
3_deformable_detr,fold_1,1,1,1,0,0,20230512_151452_jpg.rf.f764099c780fa1069a9d911e32493b58.jpg
3_deformable_detr,fold_1,2,2,2,0,0,0040_jpg.rf.510a2eea8b97902d00189cee85d647f2.jpg
3_deformable_detr,fold_1,14,9,9,0,-5,IMG_20230512_144941_jpg.rf.26b2e56c21b9d1f982031b1a6c82b0cf.jpg
3_deformable_detr,fold_1,6,5,5,0,-1,0230512_145304_jpg.rf.923a0f42aba114205181e2b5316865df.jpg
3_deformable_detr,fold_1,14,1,1,0,-13,20230512_153445_jpg.rf.a406add89c229073e8dc9da3e87a1125.jpg
3_deformable_detr,fold_1,11,9,9,0,-2,IMG_20230512_144945_690_jpg.rf.8f6c97bc8ba7a4170c6509fdaf6dcb51.jpg
3_deformable_detr,fold_1,3,4,3,1,1,20230512_150255_jpg.rf.06d14e4c4625afe9d0a55233a17ba81c.jpg
3_deformable_detr,fold_1,1,1,1,0,0,20230512_145220_jpg.rf.9fc82d7b84c8883df1efc1dd7d51252b.jpg
3_deformable_detr,fold_1,8,4,4,0,-4,IMG_20230512_151110_jpg.rf.43411da66d27f6993f2c94b13a408a1c.jpg
3_deformable_detr,fold_1,1,0,0,0,-1,IMG_20230512_151305_326_jpg.rf.11e52599cf79be602d4d4480bd5cddda.jpg
3_deformable_detr,fold_1,2,1,1,0,-1,0230512_145048_jpg.rf.17eaa837f3d144d8a30470f44f61f75d.jpg
3_deformable_detr,fold_2,11,9,8,1,-2,20230512_152307_jpg.rf.5ed444510318293300b04fc766ce4222.jpg
3_deformable_detr,fold_2,1,1,1,0,0,20230512_144953_jpg.rf.8283a702fcffd9d6223570436e1bf3fa.jpg
3_deformable_detr,fold_2,6,6,6,0,0,20230512_145403_jpg.rf.8df05cb3790b7b04d25d1e08e98dc443.jpg
3_deformable_detr,fold_2,5,5,5,0,0,20230512_145345_jpg.rf.04a7df632b86568b244790bc2612f409.jpg
3_deformable_detr,fold_2,1,1,1,0,0,IMG_20230512_151805_jpg.rf.394aa2e3fd7a17a935ec0df1f3258c2f.jpg
3_deformable_detr,fold_2,1,0,0,0,-1,20230512_151500_jpg.rf.e32b98c8b02b5d583e07193899344442.jpg
3_deformable_detr,fold_2,2,2,2,0,0,0230512_145313_jpg.rf.776dc937578790f899ad676b7712df5d.jpg
3_deformable_detr,fold_2,1,1,1,0,0,20230512_145047_jpg.rf.95f8311e427ec6f1226783bcfa8aaeb0.jpg
3_deformable_detr,fold_2,17,13,11,2,-4,IMG_20230512_152302_jpg.rf.e72dde5d8164d8312cbc60cf674ac1cc.jpg
3_deformable_detr,fold_2,3,1,0,1,-2,20230512_145143_jpg.rf.e512219fc0a6a155cdc8d6e5375509c0.jpg
3_deformable_detr,fold_2,17,9,8,1,-8,20230512_153128_jpg.rf.ea6f913ebe278f58559dcfc65c663e1e.jpg
3_deformable_detr,fold_2,1,2,1,1,1,20230512_151801_jpg.rf.2c3c8c1015e6fae6858f400374255844.jpg
3_deformable_detr,fold_2,2,0,0,0,-2,IMG_20230512_150319_jpg.rf.3ae187984f18f173dbb37b3a87dc2edc.jpg
3_deformable_detr,fold_2,2,2,2,0,0,IMG_20230512_145035_jpg.rf.e406d6ea6e2142bf078dc5712097970d.jpg
3_deformable_detr,fold_2,11,13,7,6,2,20230512_151045_jpg.rf.a6671c33872e0aa76aa195da177cfb2d.jpg
3_deformable_detr,fold_2,6,2,0,2,-4,20230512_153159_jpg.rf.d07176029cb6d818c3ec89f10bf105eb.jpg
3_deformable_detr,fold_2,2,0,0,0,-2,20230512_145258_jpg.rf.36afe6d426851a363b2a6a7d0c059a06.jpg
3_deformable_detr,fold_2,9,7,5,2,-2,0230512_145016_jpg.rf.c06fc10372ac7c1831d2d51452a8b3e8.jpg
3_deformable_detr,fold_2,5,5,5,0,0,20230512_151002_jpg.rf.948c61535288e6ba60980bb8fd2b67a6.jpg
3_deformable_detr,fold_2,5,2,2,0,-3,IMG_20230512_150036_jpg.rf.6e167fde12f866a555cb292420cc966c.jpg
3_deformable_detr,fold_2,21,16,14,2,-5,IMG_20230512_150108_jpg.rf.010507bacbd8da808ace5e119e09b182.jpg
3_deformable_detr,fold_2,1,1,1,0,0,IMG_20230512_151210_354_jpg.rf.8bd99e3d531a171119a6ce1f73298053.jpg
3_deformable_detr,fold_2,16,10,10,0,-6,0058_jpg.rf.0a179a6a2aa1a22cf6d0c2490fc3cca2.jpg
3_deformable_detr,fold_2,2,3,2,1,1,20230512_150805_jpg.rf.c936fd2cb76b51c90f6b1886c1d67b07.jpg
3_deformable_detr,fold_2,38,27,21,6,-11,0512_150128_jpg.rf.2af323c722a16ccc0c5aa34b5e501664.jpg
3_deformable_detr,fold_2,7,7,5,2,0,20230512_150107_jpg.rf.5e11723e84aa6da5755cf3c63cf34d7e.jpg
3_deformable_detr,fold_2,5,1,1,0,-4,IMG_20230512_152210_460_jpg.rf.ab8278e1877e151e4ae555c6237762a4.jpg
3_deformable_detr,fold_2,1,1,1,0,0,IMG_20230512_161352_jpg.rf.55bade867ee284f39237788ac06b0acc.jpg
3_deformable_detr,fold_2,1,1,1,0,0,IMG_3833_JPG.rf.abe8bed2e2a60f385c89c035ed2e7754.jpg
3_deformable_detr,fold_2,4,5,2,3,1,20230512_145400_jpg.rf.487d472b7875668199199822410b27fa.jpg
3_deformable_detr,fold_2,3,3,3,0,0,0006_jpg.rf.4286dc69c06dcdbaf0df817343256a21.jpg
3_deformable_detr,fold_2,4,3,3,0,-1,20230512_151752_jpg.rf.c6abd13d3824e552c45d2ae43cd156c3.jpg
3_deformable_detr,fold_2,6,5,5,0,-1,20230512_145358_jpg.rf.42f74f37b3baefb9f8cb08628d322a69.jpg
3_deformable_detr,fold_2,1,1,1,0,0,0230512_145420_jpg.rf.e077901cc39df12e7031754a04b4216f.jpg
3_deformable_detr,fold_2,2,2,2,0,0,20230512_151441_jpg.rf.01b614d64de666a58fed8b8feea9004a.jpg
3_deformable_detr,fold_2,12,11,6,5,-1,20230512_153315_jpg.rf.7906c060598957a1e622c50902191cc1.jpg
3_deformable_detr,fold_2,4,4,4,0,0,0025_jpg.rf.f5d46a7f5f498531cada47eed608a3e7.jpg
3_deformable_detr,fold_2,6,6,5,1,0,IMG_3832_JPG.rf.4a27d40741e9e24a57b4d4409e5bf699.jpg
3_deformable_detr,fold_2,4,4,4,0,0,IMG_20230512_145422_423_jpg.rf.a2f634b682eede423e27173c65e298dc.jpg
3_deformable_detr,fold_2,3,2,1,1,-1,IMG_20230512_145034_jpg.rf.b7070d4f3b8615f07e606e417094950b.jpg
3_deformable_detr,fold_2,6,4,4,0,-2,20230512_151810-0-_jpg.rf.5bab122233efd5d6e060c2de01ae9475.jpg
3_deformable_detr,fold_2,1,1,1,0,0,20230512_151649_jpg.rf.62f6a7ef7962197e1933352c3cf07e1d.jpg
3_deformable_detr,fold_2,5,4,2,2,-1,20230512_151315_jpg.rf.7d9aa1fa6aeea9c557900122bb89076d.jpg
3_deformable_detr,fold_2,1,0,0,0,-1,230512_150043_jpg.rf.997b92cbbb33f969daf86ff1c0a48495.jpg
3_deformable_detr,fold_2,18,12,10,2,-6,IMG_4215_JPG.rf.f586481a5ed49d1952135b51b94a258f.jpg
3_deformable_detr,fold_2,15,11,11,0,-4,IMG_20230512_152253_596_jpg.rf.e1455dadb47781b4e95ce4f0479c4643.jpg
3_deformable_detr,fold_2,18,7,5,2,-11,IMG_20230512_150056_181_jpg.rf.337f1b254575b10ba95ca7a5b1e7e5aa.jpg
3_deformable_detr,fold_2,13,8,7,1,-5,20230512_150029_jpg.rf.29ca99ad8a2b5956fdc7e21d1601c79f.jpg
3_deformable_detr,fold_2,1,1,1,0,0,20230512_145239_jpg.rf.0d14eff09fc5186a9eccb0c477759e6b.jpg
3_deformable_detr,fold_2,20,11,10,1,-9,20230512_153255_jpg.rf.72d8abd35f45fdaa52da9b99aa3daf48.jpg
3_deformable_detr,fold_2,24,21,16,5,-3,0106_jpg.rf.ea3d3d53b74e632d3112cfd4b25da4de.jpg
3_deformable_detr,fold_2,2,3,2,1,1,0230512_145006_jpg.rf.eb1d6247f79c4ed2e093c5fcaf73e407.jpg
3_deformable_detr,fold_2,4,4,2,2,0,IMG_20230512_145316_jpg.rf.250aaba6ef305223c5dec100c738233c.jpg
3_deformable_detr,fold_2,11,8,6,2,-3,20230512_145205_jpg.rf.8be964bf86f6306b95645b3e8b4177aa.jpg
3_deformable_detr,fold_2,2,1,1,0,-1,20230512_145125_jpg.rf.c0d2af11ce72a4bb0c259d23b2700862.jpg
3_deformable_detr,fold_2,5,4,4,0,-1,20230512_151810_jpg.rf.b4a391d3bd61afb0cff6f47e49a1736e.jpg
3_deformable_detr,fold_2,8,6,6,0,-2,IMG_20230512_151240_jpg.rf.21dc1955fc3611fdbde01fb2d3db23e3.jpg
3_deformable_detr,fold_2,1,3,1,2,2,IMG_20230512_151233_jpg.rf.75f4efffa9f2c8ddf8c60930c30caa50.jpg
3_deformable_detr,fold_2,2,2,2,0,0,20230512_145245_jpg.rf.23b906c05c2822f1a0f5a97d26511473.jpg
3_deformable_detr,fold_2,5,4,4,0,-1,20230512_145335-0-_jpg.rf.e11b1b03b49524f5174370062e01b4f7.jpg
3_deformable_detr,fold_2,25,16,13,3,-9,IMG_20230512_150137_686_jpg.rf.87a512bdf05b800f446ab29f4925d265.jpg
3_deformable_detr,fold_2,2,1,1,0,-1,IMG_3837_JPG.rf.6f942021a4fd687376ae5b9b4d970b40.jpg
3_deformable_detr,fold_2,17,10,9,1,-7,20230512_144951_jpg.rf.9ab67b54e372e2d5fcc0ba78e49718cf.jpg
3_deformable_detr,fold_2,1,0,0,0,-1,20230512_153216_jpg.rf.eb0c9677e99c15c65103ae3a612d52d8.jpg
3_deformable_detr,fold_2,16,15,14,1,-1,20230512_144957_jpg.rf.edf44bd7d8feadfc28a3389bd946b805.jpg
3_deformable_detr,fold_2,3,1,1,0,-2,IMG_20230512_145032_jpg.rf.d9c71446c077191b543ca5691d58f022.jpg
3_deformable_detr,fold_2,40,9,7,2,-31,20230512_150324_jpg.rf.3ff2950eb65ac5c31086e53bc4e56ed5.jpg
3_deformable_detr,fold_2,1,1,1,0,0,20230512_151651-0-_jpg.rf.b824f35100b3f7edb1d2a6095c5dfaa2.jpg
3_deformable_detr,fold_2,23,14,13,1,-9,20230512_153141_jpg.rf.613e5b5025183f2520937d9596cdd56a.jpg
3_deformable_detr,fold_2,1,2,0,2,1,IMG_3846_JPG.rf.6ac47067db06f4b0377dc758d0af3e6e.jpg
3_deformable_detr,fold_2,13,12,12,0,-1,IMG_20230512_145059_jpg.rf.ca7ed19e9dee72856eedaac64c143c22.jpg
3_deformable_detr,fold_2,7,7,6,1,0,20230512_150118_jpg.rf.995a1787a6672b3228e543351c485407.jpg
3_deformable_detr,fold_2,29,16,14,2,-13,20230512_150102_jpg.rf.992c8db88e8e711f38b63308f2f2ceb0.jpg
3_deformable_detr,fold_2,1,1,1,0,0,IMG_20230512_153419_jpg.rf.9224e0b2559139217bdba3afdc04378c.jpg
3_deformable_detr,fold_2,13,4,2,2,-9,20230512_153022_jpg.rf.863e7532bc45f9f8755c15b6a24dda83.jpg
3_deformable_detr,fold_2,59,9,8,1,-50,20230512_153358_jpg.rf.97d1a8ba190dcaf1d26753099c80dac6.jpg
3_deformable_detr,fold_2,3,4,2,2,1,20230512_145406_jpg.rf.b6c696ca3ffd7789f8655f344c1ccd98.jpg
3_deformable_detr,fold_2,3,3,3,0,0,IMG_4387_JPG.rf.3205816644d251fe12961d17cfe8b818.jpg
3_deformable_detr,fold_2,10,5,3,2,-5,20230512_150020_jpg.rf.6a0dfe027260521f3168f7985b48272f.jpg
3_deformable_detr,fold_2,1,1,1,0,0,0011_jpg.rf.ef78555de2ee0947227176b9c9b4319b.jpg
3_deformable_detr,fold_2,10,12,9,3,2,20230512_150229_jpg.rf.db8357bef31fe081f8e5059cfd0c9fb4.jpg
3_deformable_detr,fold_2,2,3,2,1,1,20230512_151743_jpg.rf.6203480990e7a828e8c8e3f743a0053b.jpg
3_deformable_detr,fold_2,6,6,3,3,0,20230512_145157_jpg.rf.459cfae5642460c5c30e67dd372cadcc.jpg
3_deformable_detr,fold_2,2,3,2,1,1,20230512_145122_jpg.rf.f302914da7ccad75fb2edfd9b9ec0efd.jpg
3_deformable_detr,fold_2,13,7,7,0,-6,IMG_20230512_145118_jpg.rf.d1ef05f6a7704db2945116a966e5bd70.jpg
3_deformable_detr,fold_2,6,0,0,0,-6,20230512_153037_jpg.rf.b93a210f722c0d5464f223e099ec3dce.jpg
3_deformable_detr,fold_2,3,2,2,0,-1,20230512_150758_jpg.rf.8a907872529b09fec41c34fbc4a3c85b.jpg
3_deformable_detr,fold_2,3,1,1,0,-2,20230512_145126_jpg.rf.76790ff28fba433b2868c3becc799204.jpg
3_deformable_detr,fold_2,111,40,35,5,-71,0105_jpg.rf.21f79c1f08ac725f3eafce77e52091e8.jpg
3_deformable_detr,fold_2,3,3,3,0,0,20230512_145438_jpg.rf.c1caee1e341cc9a711b6cf640a2a8509.jpg
3_deformable_detr,fold_2,4,3,2,1,-1,IMG_20230512_145346_jpg.rf.515d73a420cc0607f0a677c3ec22ea14.jpg
3_deformable_detr,fold_2,4,3,2,1,-1,20230512_145144_jpg.rf.f15cd7a8e403d35924c9a9953ceb0ed2.jpg
3_deformable_detr,fold_2,11,4,2,2,-7,20230512_150030_jpg.rf.6f76526d3409cadbfe960092b45d99ff.jpg
3_deformable_detr,fold_2,14,13,10,3,-1,20230512_151050_jpg.rf.bb1678e3a1546f2d4b401bf96df99936.jpg
3_deformable_detr,fold_2,1,1,1,0,0,230512_150038_jpg.rf.9ebbdcccc679c75c9dceb5b2e686d104.jpg
3_deformable_detr,fold_2,8,6,6,0,-2,20230512_151748_jpg.rf.fdcf266c293fa03554fecbec46885bcf.jpg
3_deformable_detr,fold_2,4,3,3,0,-1,20230512_145131_jpg.rf.05acfd31fb743167b9795df743ef22b4.jpg
3_deformable_detr,fold_2,5,9,5,4,4,IMG_20230512_150030_jpg.rf.eb7e32ee807e4ad675ec4b1f485d1194.jpg
3_deformable_detr,fold_2,3,3,3,0,0,20230512_151026-copia-1-_jpg.rf.25048c6b13b3d64d8a468f548967f5d4.jpg
3_deformable_detr,fold_2,1,1,1,0,0,IMG_4042_JPG.rf.3b0722af6ff7f5abfc5b80296e0e51a4.jpg
3_deformable_detr,fold_2,1,0,0,0,-1,0230512_145106_jpg.rf.f11d7922f45bb3e9056a0274e877bd6f.jpg
3_deformable_detr,fold_2,4,7,2,5,3,20230512_145152_jpg.rf.c078905785bf4f39e87ab4dbfeb67b79.jpg
3_deformable_detr,fold_2,2,1,1,0,-1,IMG_20230512_151751_jpg.rf.86507ee6252cc7d41c2fa99c5f84bbc9.jpg
3_deformable_detr,fold_2,8,9,6,3,1,20230512_145155_jpg.rf.483609701afa99b05a432395c2a1dc59.jpg
3_deformable_detr,fold_2,1,0,0,0,-1,20230512_151501_jpg.rf.16af334ffaad29022c4afa8eda4bbb5b.jpg
3_deformable_detr,fold_2,4,2,2,0,-2,20230512_150208_jpg.rf.5e82906cb9373103e9e98ed6a4338a1e.jpg
3_deformable_detr,fold_2,2,2,2,0,0,20230512_151704_jpg.rf.fd83532c35f591e140a380aa12cd8530.jpg
3_deformable_detr,fold_2,4,3,3,0,-1,0230512_145310_jpg.rf.58da36115ae6f33dda807758d87657c9.jpg
3_deformable_detr,fold_2,8,6,5,1,-2,20230512_145134_jpg.rf.5d0f231790df81ba4a0051d2b6752135.jpg
3_deformable_detr,fold_2,4,3,3,0,-1,20230512_150055_jpg.rf.4cc48b2b47552b6368afa5d3491ee008.jpg
3_deformable_detr,fold_2,19,16,13,3,-3,IMG_20230512_150053_jpg.rf.0df30dcd2353d3b9fb7a7df012361881.jpg
3_deformable_detr,fold_2,10,7,7,0,-3,20230512_152215_jpg.rf.a4d9425dfde22fcd54004debebaf80ce.jpg
3_deformable_detr,fold_2,6,5,5,0,-1,20230512_145408_jpg.rf.3d8eeed18535cb95a6e8d1931052f34c.jpg
3_deformable_detr,fold_2,8,5,5,0,-3,20230512_152941_jpg.rf.a2201e1690ef639f51bfe7ce95cec221.jpg
3_deformable_detr,fold_2,3,3,3,0,0,20230512_151306_jpg.rf.cfe45d7efb4a4c29beccc71f36871b48.jpg
3_deformable_detr,fold_2,1,2,1,1,1,IMG_20230512_151234_jpg.rf.b19f52712286d372282ee90e4f3a8c24.jpg
3_deformable_detr,fold_2,6,3,2,1,-3,IMG_20230512_145136_jpg.rf.a268e723779ce1a1a30472767d3788c0.jpg
3_deformable_detr,fold_2,4,2,1,1,-2,20230512_145405_jpg.rf.583b8e88a9d9542c857773d30f074199.jpg
3_deformable_detr,fold_2,1,1,1,0,0,20230512_151808_jpg.rf.88493c8cb7d1ddd67bcbdd48f290be76.jpg
3_deformable_detr,fold_2,2,7,2,5,5,IMG_20230512_151255_jpg.rf.085333bc247d4e08cfef9873bd98d250.jpg
3_deformable_detr,fold_2,14,9,7,2,-5,20230512_145200_jpg.rf.a6508f9b4a5dc4d2e37a648f6f58cad7.jpg
3_deformable_detr,fold_2,5,7,3,4,2,IMG_20230512_150153_jpg.rf.21455b2b84261cf0a3ce6dd9147d31c2.jpg
3_deformable_detr,fold_2,9,9,8,1,0,0230512_145438_jpg.rf.8d0faa32dac3b0a8d27ae1876a0db052.jpg
3_deformable_detr,fold_2,1,1,1,0,0,20230512_145023_jpg.rf.b2955fd5ab715016af10f2efa47feb0c.jpg
3_deformable_detr,fold_2,4,3,2,1,-1,IMG_3986_JPG.rf.5f1e1a04a780c294057b3aeb49ce1327.jpg
3_deformable_detr,fold_2,2,1,1,0,-1,20230512_151639_jpg.rf.2e5a4b318c40ab84158ba5ef4ab1ae75.jpg
3_deformable_detr,fold_2,2,2,2,0,0,0010_jpg.rf.5d4cbd2e216fb4306b05f3a979d801a6.jpg
3_deformable_detr,fold_2,61,8,7,1,-53,20230512_153154_jpg.rf.8e0789e24006a0265466d9bf9fdd2d5d.jpg
3_deformable_detr,fold_2,3,0,0,0,-3,IMG_3866_JPG.rf.9976a97a1422b88843b54c8cfe8f8cef.jpg
3_deformable_detr,fold_2,2,2,2,0,0,20230512_145123_jpg.rf.7c684cfce69e0678a5f37aceb8e58703.jpg
3_deformable_detr,fold_2,2,1,1,0,-1,20230512_151634_jpg.rf.4af8920897c95556710f5d66b8848580.jpg
3_deformable_detr,fold_2,1,1,1,0,0,20230512_151253_jpg.rf.b5e989a50a5c70e0f8911ebb246c4bd9.jpg
3_deformable_detr,fold_2,6,8,6,2,2,20230512_153108_jpg.rf.d3d27e961d217f62f45c29eec6d6c2ed.jpg
3_deformable_detr,fold_2,31,19,14,5,-12,0512_150045_jpg.rf.097128a0f4dc3739d053c017dd7fd643.jpg
3_deformable_detr,fold_2,2,2,2,0,0,20230512_145217_jpg.rf.8b4c9e235361be21ec1ef0addc99dc7a.jpg
3_deformable_detr,fold_2,13,11,7,4,-2,20230512_153057_jpg.rf.4d29da76e8c70adbe3707715c3333882.jpg
3_deformable_detr,fold_2,1,1,1,0,0,20230512_145040_jpg.rf.c652c89ab18a37e582fa39fe9f7abdc6.jpg
3_deformable_detr,fold_2,10,9,9,0,-1,IMG_20230512_145100_jpg.rf.e7b035adf2c640d6a600846236b01b19.jpg
3_deformable_detr,fold_2,1,1,1,0,0,20230512_151458_jpg.rf.44033d4e267440e0172a403e2c9b2c2f.jpg
3_deformable_detr,fold_2,1,1,1,0,0,IMG_4039_JPG.rf.3f78f739ca76cba4136559eee15bdd94.jpg
3_deformable_detr,fold_2,15,10,9,1,-5,IMG_20230512_150039_1_jpg.rf.ffd13d7440dc972309a1f58f33063648.jpg
3_deformable_detr,fold_2,2,2,1,1,0,0230512_145340_jpg.rf.beb3f9c554344398d6f6007f748edd63.jpg
3_deformable_detr,fold_2,8,7,7,0,-1,IMG_4188_JPG.rf.2b1e9cc2bc82b3d05861cab7bdbfb235.jpg
3_deformable_detr,fold_2,4,5,3,2,1,IMG_20230512_145231_804_jpg.rf.35d239e095afd813f22e568b66281c10.jpg
3_deformable_detr,fold_2,8,9,8,1,1,20230512_152333_jpg.rf.901f79538b04a75cfd995edb99dba147.jpg
3_deformable_detr,fold_2,1,0,0,0,-1,IMG_20230512_151122_744_jpg.rf.0203c58a683248c6ba3e7ca2baa5ee22.jpg
3_deformable_detr,fold_2,9,8,7,1,-1,20230512_152403_jpg.rf.21f06ac205b62518bb4ac1c1d05a2bce.jpg
3_deformable_detr,fold_2,21,11,9,2,-10,20230512_150012_jpg.rf.5bc4d2f31a26aab541fdbeb4a437985a.jpg
3_deformable_detr,fold_2,8,5,5,0,-3,20230512_150920_jpg.rf.5224cc7eab4f53f93bdec2d81bba5f0e.jpg
3_deformable_detr,fold_2,7,7,7,0,0,20230512_145404_jpg.rf.91d448b69a976705a98b28002a84c842.jpg
3_deformable_detr,fold_2,1,2,1,1,1,0003_jpg.rf.bf7cde9cd5a6dc0cc2ee160ef4121efe.jpg
3_deformable_detr,fold_2,7,7,7,0,0,IMG_20230512_145054_jpg.rf.b241c4cdeabfff0793bff4970cd95da2.jpg
3_deformable_detr,fold_2,1,1,1,0,0,20230512_145032-0-_jpg.rf.dc8b664d3fb1425d1783c11f8bcb0068.jpg
3_deformable_detr,fold_2,2,2,2,0,0,20230512_145316-0-_jpg.rf.6c2d352bf056f852f59df415c04c3b73.jpg
3_deformable_detr,fold_2,6,4,4,0,-2,IMG_4037_JPG.rf.c2e2f236825c2dff84efbeb902eeb29d.jpg
3_deformable_detr,fold_2,2,0,0,0,-2,IMG_3916_JPG.rf.250aee83d82e083052118d5322edb81e.jpg
3_deformable_detr,fold_2,3,3,2,1,0,20230512_150045_jpg.rf.56868f65f25cf730ad8340c6a67caa9b.jpg
3_deformable_detr,fold_3,3,1,1,0,-2,20230512_145409_jpg.rf.d09685c8c603cbe9e1a20305c3a191ef.jpg
3_deformable_detr,fold_3,6,6,5,1,0,20230512_150944_jpg.rf.eaecb1ecef20585ed9293d182792536f.jpg
3_deformable_detr,fold_3,9,8,6,2,-1,IMG_20230512_152206_244_jpg.rf.39d59820f61b06056f549a4d3442ac7b.jpg
3_deformable_detr,fold_3,5,3,3,0,-2,20230512_151749_jpg.rf.05c1da9e8ad61457f7836f667088adf9.jpg
3_deformable_detr,fold_3,5,5,5,0,0,0004_jpg.rf.851243b8e41e3a1bd722c5b177c9bf93.jpg
3_deformable_detr,fold_3,1,1,1,0,0,20230512_151806_jpg.rf.26383849e96ac2c96291e0c7409e44d2.jpg
3_deformable_detr,fold_3,1,1,1,0,0,0012_jpg.rf.48d09ce5c069b09d1c9d6cf497ff9a97.jpg
3_deformable_detr,fold_3,5,4,4,0,-1,20230512_151026_jpg.rf.d30352bb19624c98cae22d002974b61a.jpg
3_deformable_detr,fold_3,9,7,6,1,-2,20230512_151855_jpg.rf.e3fa630bb03de4788e09724f320ec036.jpg
3_deformable_detr,fold_3,2,2,2,0,0,20230512_145316_jpg.rf.496d4ed779e1450c242495fa46e36987.jpg
3_deformable_detr,fold_3,4,5,4,1,1,20230512_153116_jpg.rf.cdd42e1383bc6c130d47f65e21bcc4e6.jpg
3_deformable_detr,fold_3,5,5,4,1,0,20230512_145437_jpg.rf.0909c9ccb332356410c1a52743b7c7bf.jpg
3_deformable_detr,fold_3,4,2,1,1,-2,20230512_153139_jpg.rf.c012da59f33e990f927df57e0a6a7f6c.jpg
3_deformable_detr,fold_3,3,2,2,0,-1,0031_jpg.rf.895d9050f9dc5640677a308629b20ad8.jpg
3_deformable_detr,fold_3,21,18,16,2,-3,IMG_20230512_152944_jpg.rf.cda9c2160b066ef7e220cf96a991f737.jpg
3_deformable_detr,fold_3,8,8,7,1,0,IMG_4187_JPG.rf.f301f6508b0e93d82808ac4e2f80dab0.jpg
3_deformable_detr,fold_3,1,1,1,0,0,230512_150212_jpg.rf.3e63a63731d99962cf04897093c61c0e.jpg
3_deformable_detr,fold_3,3,2,1,1,-1,20230512_150056_jpg.rf.c9ae963578e609418dc9e533e5a26adf.jpg
3_deformable_detr,fold_3,7,6,6,0,-1,IMG_20230512_153337_765_jpg.rf.f1a04e6d77f25605da1438e3829fd581.jpg
3_deformable_detr,fold_3,10,25,1,24,15,0200_jpg.rf.72e8b4790e76291a0c9e6877dd61eef5.jpg
3_deformable_detr,fold_3,4,4,3,1,0,IMG_20230512_151438_jpg.rf.ff747d9ae06e7829a2e860bb43baf295.jpg
3_deformable_detr,fold_3,1,1,1,0,0,IMG_20230512_145007_395_jpg.rf.b8b6b70654f786328e3fe2f85e949a6f.jpg
3_deformable_detr,fold_3,1,2,1,1,1,0014_jpg.rf.edb35667570fa3a23afcb19d179ea59d.jpg
3_deformable_detr,fold_3,2,1,1,0,-1,20230512_151640_jpg.rf.4b7574d0b6f05544e5a43a5be4589a6f.jpg
3_deformable_detr,fold_3,1,1,1,0,0,20230512_151616_jpg.rf.73b54fe227f3ac8f3da41b5fba2b170a.jpg
3_deformable_detr,fold_3,43,16,13,3,-27,IMG_20230512_150354_jpg.rf.1ed97bfbf8670ca6750d76619dac51ef.jpg
3_deformable_detr,fold_3,1,0,0,0,-1,20230512_145009_jpg.rf.9f8f641e028bed4b2706301af0fb27ee.jpg
3_deformable_detr,fold_3,3,5,3,2,2,20230512_152204_jpg.rf.b0b665cf50c6b54094f4fe1a4a01ecce.jpg
3_deformable_detr,fold_3,4,3,2,1,-1,20230512_145348-0-_jpg.rf.a616aa6a3ced888f83d2044dbd9ec726.jpg
3_deformable_detr,fold_3,9,6,6,0,-3,IMG_20230512_145301_jpg.rf.71b506460c51cef84cbbfdc651695e13.jpg
3_deformable_detr,fold_3,9,7,5,2,-2,20230512_145156_jpg.rf.85e178453eba594f6ce65cebf40de3fb.jpg
3_deformable_detr,fold_3,3,3,3,0,0,20230512_150025_jpg.rf.0bef8a6273605277f912993bceb28c2c.jpg
3_deformable_detr,fold_3,4,4,4,0,0,20230512_145130_jpg.rf.51678843234545aa7f95a07feefbe048.jpg
3_deformable_detr,fold_3,1,2,1,1,1,0230512_145124_jpg.rf.24447141d50bf7957914c622cb19bbc6.jpg
3_deformable_detr,fold_3,1,1,1,0,0,20230512_151656_jpg.rf.581bfb229dea559f67a2aa2ac578db62.jpg
3_deformable_detr,fold_3,2,2,2,0,0,IMG_20230512_145127_jpg.rf.d2db7f78af8d459d1ccab501da8c6fcd.jpg
3_deformable_detr,fold_3,3,3,2,1,0,IMG_20230512_145110_jpg.rf.d1d01bf0ca4a3344a6bf7d4b94e63c96.jpg
3_deformable_detr,fold_3,2,1,1,0,-1,230512_150052_jpg.rf.495fe344c6875f2116d1ef5a0bd92daf.jpg
3_deformable_detr,fold_3,3,1,1,0,-2,IMG_3934_JPG.rf.1b359ac7d45ac33c7623f668cb9731d0.jpg
3_deformable_detr,fold_3,8,11,6,5,3,IMG_20230512_150231_jpg.rf.764af7adf374d2dee3739d99e3a0d56a.jpg
3_deformable_detr,fold_3,7,5,5,0,-2,IMG_20230512_145110_246_jpg.rf.153877ddf43d3d76a37f64fb0aa5f617.jpg
3_deformable_detr,fold_3,15,7,6,1,-8,20230512_150106_jpg.rf.3025eeb24b28ae43f2ad27872636bbbf.jpg
3_deformable_detr,fold_3,1,1,1,0,0,20230512_151113_jpg.rf.b6cd4222d666bbace543a8c77d865f35.jpg
3_deformable_detr,fold_3,2,2,2,0,0,20230512_151756_jpg.rf.6e05ac20e235330456b0b0d06c00138c.jpg
3_deformable_detr,fold_3,1,1,1,0,0,20230512_151035_jpg.rf.103e19cb70bac5049a33c63e773d1a79.jpg
3_deformable_detr,fold_3,6,6,4,2,0,230512_145340_jpg.rf.9fdd58e2d10ba1375e278a07b95c337c.jpg
3_deformable_detr,fold_3,12,7,6,1,-5,20230512_145203_jpg.rf.35ba545e195d0af402a018f91a322dab.jpg
3_deformable_detr,fold_3,11,10,8,2,-1,IMG_20230512_153029_jpg.rf.80e951915c88eafeea885e5fb27b45e8.jpg
3_deformable_detr,fold_3,2,0,0,0,-2,0230512_145130_jpg.rf.faddf96f4d26a63f9284354dd447afd4.jpg
3_deformable_detr,fold_3,13,7,7,0,-6,20230512_145238_jpg.rf.b85535f8851b826fe2e42e26692f5635.jpg
3_deformable_detr,fold_3,9,5,5,0,-4,20230512_153316_jpg.rf.24b77c461257ba1bd947e731de450708.jpg
3_deformable_detr,fold_3,27,11,10,1,-16,20230512_150125_jpg.rf.d10c3232f4247c5514953cf92c7083c5.jpg
3_deformable_detr,fold_3,3,3,2,1,0,20230512_151438_jpg.rf.9d2b9be770df6ec4ba79d984fe00b8b4.jpg
3_deformable_detr,fold_3,50,27,25,2,-23,0512_150210_jpg.rf.a172e8c839e22e596b7db396b08d63d1.jpg
3_deformable_detr,fold_3,17,15,10,5,-2,20230512_150321_jpg.rf.a5e551cbda2cf857d53bcbd4d60b92c5.jpg
3_deformable_detr,fold_3,1,0,0,0,-1,20230512_151213_jpg.rf.419a445cd8b3392ce737e6b1c6cb0d88.jpg
3_deformable_detr,fold_3,7,8,7,1,1,IMG_20230512_152958_116_jpg.rf.12bbdfc4e9ae5914029f9e97d0fcd224.jpg
3_deformable_detr,fold_3,8,3,2,1,-5,0230512_145231_jpg.rf.f02c6f94b7286a6b59a1c8b2423f5ba8.jpg
3_deformable_detr,fold_3,20,17,16,1,-3,20230512_152944_jpg.rf.3c5b2edc21ab50f9893441607f43f699.jpg
3_deformable_detr,fold_3,10,11,10,1,1,20230512_152328_jpg.rf.9afc7b5536cb56c41fedd9c22fd78fe4.jpg
3_deformable_detr,fold_3,1,1,1,0,0,20230512_151448_jpg.rf.83cf709cf0b2547d212be3a377779599.jpg
3_deformable_detr,fold_3,4,5,1,4,1,20230512_145151_jpg.rf.1c7cdb8ed83d156aba9a1e8e94becd21.jpg
3_deformable_detr,fold_3,2,2,1,1,0,0230512_145009_jpg.rf.027a2f31eb1269ab45f13bf35444b96c.jpg
3_deformable_detr,fold_3,24,11,11,0,-13,20230512_153310_jpg.rf.4207c4421e3464536cb4bd47453058d2.jpg
3_deformable_detr,fold_3,1,0,0,0,-1,20230512_145103_jpg.rf.62604473c5e590c815e5d908b8d354a0.jpg
3_deformable_detr,fold_3,2,2,1,1,0,IMG_20230512_145351_839_jpg.rf.676aa37e025296713a6e39f90d91aa3b.jpg
3_deformable_detr,fold_3,4,4,4,0,0,20230512_152301-0-_jpg.rf.1afa46256fa26afe6cd36253d167878e.jpg
3_deformable_detr,fold_3,5,5,4,1,0,IMG_20230512_145310_230_jpg.rf.a3b7f15bfc867ece22ea5c289b0d4b74.jpg
3_deformable_detr,fold_3,12,7,6,1,-5,20230512_150153_jpg.rf.330fb945dbe64ad88c012d6c611ab4e9.jpg
3_deformable_detr,fold_3,9,12,9,3,3,20230512_152315_jpg.rf.e5aebd25c65f9475f8256b49c71ff68a.jpg
3_deformable_detr,fold_3,1,1,1,0,0,20230512_151304_jpg.rf.820f387501b1325203f72b034ae1ff0a.jpg
3_deformable_detr,fold_3,5,1,1,0,-4,IMG_3842_JPG.rf.4a4a46be5bc0098c5e1314e61ddc11de.jpg
3_deformable_detr,fold_3,1,1,1,0,0,20230512_145219_jpg.rf.0755ac5ed17a2444b92a33aaea06d7a3.jpg
3_deformable_detr,fold_3,16,8,8,0,-8,20230512_150148_jpg.rf.0d501896a72c41b99bfcd956b0436fb3.jpg
3_deformable_detr,fold_3,5,2,2,0,-3,IMG_20230512_145011_556_jpg.rf.00fbb204260504401d5042a1e1cd5b8d.jpg
3_deformable_detr,fold_3,1,0,0,0,-1,IMG_20230512_145336_167_jpg.rf.b667487bd924e740ebac74f50e1e463d.jpg
3_deformable_detr,fold_3,11,12,10,2,1,20230512_150201_jpg.rf.c4784605e4e8290a39a5a8546b8daf34.jpg
3_deformable_detr,fold_3,14,12,12,0,-2,0056_jpg.rf.de05042e164d7742536e2b31f92d3670.jpg
3_deformable_detr,fold_3,1,1,1,0,0,0034_jpg.rf.32acf93f344bd74d2605e49ed3db9e0e.jpg
3_deformable_detr,fold_3,9,3,1,2,-6,0230512_150100_jpg.rf.bac5d1418079223e898fdae8b34c9b0d.jpg
3_deformable_detr,fold_3,2,0,0,0,-2,IMG_3983_JPG.rf.9148c9d4463c4afaf34c762d4c53ead6.jpg
3_deformable_detr,fold_3,13,12,6,6,-1,20230512_150105_jpg.rf.9bb4f73900fecf656a093f8eac337860.jpg
3_deformable_detr,fold_3,4,1,1,0,-3,20230512_145124_jpg.rf.b61b648c127689b8eeb3a43495c3df3e.jpg
3_deformable_detr,fold_3,16,15,14,1,-1,IMG_20230512_152416_jpg.rf.924528612413e225894a24fc2dec0a36.jpg
3_deformable_detr,fold_3,1,2,1,1,1,20230512_152207_jpg.rf.61fece27ba33f3c6fc069a211008dab5.jpg
3_deformable_detr,fold_3,23,7,7,0,-16,_20230512_150225_jpg.rf.9718d11f60b7e396ae6928ae7f14c90b.jpg
3_deformable_detr,fold_3,19,14,11,3,-5,20230512_150239_jpg.rf.e13a84d4d7ec0f7e070c7ccb4fb737b3.jpg
3_deformable_detr,fold_3,4,4,4,0,0,20230512_152346_jpg.rf.a8c2948d3e9aa465d912f3465556eb90.jpg
3_deformable_detr,fold_3,6,6,6,0,0,20230512_150818_jpg.rf.58c0f3208c48520ddc0588916be6397c.jpg
3_deformable_detr,fold_3,1,1,1,0,0,IMG_20230512_150843_jpg.rf.3c9dacc8aa8ae98bcec98a6b950df819.jpg
3_deformable_detr,fold_3,1,1,0,1,0,IMG_3839_JPG.rf.2b8f533bc337b2b41e4aa08d82c895f0.jpg
3_deformable_detr,fold_3,13,3,2,1,-10,IMG_20230512_150401_jpg.rf.0f4c64f7dd592050ecd9a38797714f40.jpg
3_deformable_detr,fold_3,4,3,1,2,-1,0008_jpg.rf.3fe730c41fdc7b3704f6885ae667338f.jpg
3_deformable_detr,fold_3,7,5,5,0,-2,IMG_20230512_150236_jpg.rf.b127381341df0777f6b90c3d6193ab5f.jpg
3_deformable_detr,fold_3,13,9,9,0,-4,20230512_153104_jpg.rf.e6b0a044d9369e49df9c83ed02c5f924.jpg
3_deformable_detr,fold_3,1,1,1,0,0,20230512_151446_jpg.rf.e46015a969282d2959dba6262188eb21.jpg
3_deformable_detr,fold_3,1,1,1,0,0,IMG_4046_JPG.rf.5365cbd02513c386b454d943407c56e0.jpg
3_deformable_detr,fold_3,7,8,6,2,1,IMG_20230512_150841_155_jpg.rf.8f074ff9aa19c6cf12ce37edaace8c77.jpg
3_deformable_detr,fold_3,3,2,2,0,-1,20230512_145122-0-_jpg.rf.7f7266ca36660b1ab4d0a4f2a704a54e.jpg
3_deformable_detr,fold_3,3,3,3,0,0,20230512_151620_jpg.rf.ced9071f82dc586dd5ac71f5fae00dc4.jpg
3_deformable_detr,fold_3,1,1,1,0,0,20230512_151655_jpg.rf.1681dccfc685ad40e584cad62c4f6b8e.jpg
3_deformable_detr,fold_3,8,3,3,0,-5,0230512_145235_jpg.rf.20bb212232c9b2421611218796835da2.jpg
3_deformable_detr,fold_3,13,11,8,3,-2,20230512_151008_jpg.rf.0cd6367e8494296811c3d1a88e22360b.jpg
3_deformable_detr,fold_3,12,11,11,0,-1,IMG_20230512_152352_jpg.rf.2c7ab0d8791aacf1c20aa134ddf7f9ed.jpg
3_deformable_detr,fold_3,2,1,1,0,-1,IMG_20230512_151034_jpg.rf.d8d2ab03b8a59931929429b4bc8c7106.jpg
3_deformable_detr,fold_3,12,6,2,4,-6,IMG_20230512_150124_jpg.rf.fef0579e7a6b4c283294de15512f524a.jpg
3_deformable_detr,fold_3,7,6,6,0,-1,20230512_150027_jpg.rf.787439d34fc22269c3ab90e55ea595ed.jpg
3_deformable_detr,fold_3,3,3,3,0,0,20230512_151627_jpg.rf.9dc28340fd04ffea8cf28dd5e51283d6.jpg
3_deformable_detr,fold_3,4,4,3,1,0,IMG_20230512_151218_jpg.rf.10b21ddd648ad67d1f264e8b99ead4d4.jpg
3_deformable_detr,fold_3,37,21,20,1,-16,IMG_20230512_150249_jpg.rf.61bc4fbd0c49a88a29443f72cc742e3b.jpg
3_deformable_detr,fold_3,6,3,2,1,-3,20230512_150023_jpg.rf.06c0ade806a1d3e688bc144ef13dbaf8.jpg
3_deformable_detr,fold_3,8,7,6,1,-1,20230512_150210_jpg.rf.e4435f297c285583a73370f97d9cef80.jpg
3_deformable_detr,fold_3,8,7,7,0,-1,IMG_4089_JPG.rf.7967cd5700ba2e9b62aa13ecaa3a28b1.jpg
3_deformable_detr,fold_3,0,6,0,6,6,0031_jpg.rf.00b387ba75b602a79b19e9003038b8ea.jpg
3_deformable_detr,fold_3,3,2,2,0,-1,IMG_4196_JPG.rf.66adce382a697aad33bcbc7ab8814677.jpg
3_deformable_detr,fold_3,26,8,5,3,-18,0512_150111_jpg.rf.d4cf10c518eff125048b590e0a4605cb.jpg
3_deformable_detr,fold_3,2,2,2,0,0,IMG_20230512_151827_jpg.rf.e428f11ebc690c01de13c493aaf89f10.jpg
3_deformable_detr,fold_3,4,1,1,0,-3,0009_jpg.rf.14ae6cb384f301625cca9baa804d99e2.jpg
3_deformable_detr,fold_3,6,5,5,0,-1,IMG_20230512_145423_jpg.rf.f32325604574f1dc3efee2c645d2272b.jpg
3_deformable_detr,fold_3,8,1,1,0,-7,20230512_150140_jpg.rf.b2c7162d38d1696ac9436b4c5de3c5bd.jpg
3_deformable_detr,fold_3,3,4,3,1,1,20230512_145132_jpg.rf.b2c282982621d398e0a5b6f181a8e8c1.jpg
3_deformable_detr,fold_3,18,16,14,2,-2,20230512_153054_jpg.rf.acae07a63d6f22a0dc7fca55cf6b2d89.jpg
3_deformable_detr,fold_3,5,4,4,0,-1,0005_jpg.rf.619937b06bbe7d217806b697a9eaf55e.jpg
3_deformable_detr,fold_3,2,0,0,0,-2,230512_150120_jpg.rf.1f7889194211bdac4259fdcd65e2af46.jpg
3_deformable_detr,fold_3,17,16,11,5,-1,IMG_20230512_150215_jpg.rf.9b54f4c34af6ee37c5ada817e2111c19.jpg
3_deformable_detr,fold_3,3,1,1,0,-2,20230512_145242_jpg.rf.88c3024b1c64b0b6b0db5dddea0bbe0e.jpg
3_deformable_detr,fold_3,17,13,12,1,-4,0230512_145032_jpg.rf.e9aeb44392fbee708cc4bb450582bc0f.jpg
3_deformable_detr,fold_3,1,0,0,0,-1,0001_jpg.rf.a9b41d3e1ed49082f175c1d3de0b732e.jpg
3_deformable_detr,fold_3,19,17,14,3,-2,IMG_20230512_150300_jpg.rf.4a9882ab0ad5a15acf150bad52ccf7d8.jpg
3_deformable_detr,fold_3,26,16,15,1,-10,IMG_20230512_150103_353_jpg.rf.eaad90385ad647d1df922a626623f903.jpg
3_deformable_detr,fold_3,7,5,5,0,-2,20230512_150022_jpg.rf.5a680d2814abd10e92a1f6ddf628a4b0.jpg
3_deformable_detr,fold_3,2,1,1,0,-1,0015_jpg.rf.1f8e46b5b78af1818a40afacf5a7fe1f.jpg
3_deformable_detr,fold_3,4,2,1,1,-2,IMG_20230512_144918_793_jpg.rf.fe7a52b8285a2a10f29948f41ac02b51.jpg
3_deformable_detr,fold_3,3,3,2,1,0,20230512_145233_jpg.rf.8a9f06089b7122f3b71b6b1b537d6310.jpg
3_deformable_detr,fold_3,1,1,1,0,0,20230512_151802_jpg.rf.9a715b86b471f00ddc7bd3a521537317.jpg
3_deformable_detr,fold_3,18,15,15,0,-3,20230512_153055_jpg.rf.0b63692f9c79fad5834fab15740f4292.jpg
3_deformable_detr,fold_3,2,3,2,1,1,20230512_151739_jpg.rf.fecdc818de88f0d7b449820f099a729b.jpg
3_deformable_detr,fold_3,4,1,0,1,-3,20230512_150313_jpg.rf.7d2a23518189f8dfc49022c0bb08346b.jpg
3_deformable_detr,fold_3,6,8,6,2,2,20230512_153401_jpg.rf.1ded42782d8fd0ae0793add50267e0f5.jpg
3_deformable_detr,fold_3,3,2,2,0,-1,20230512_152321_jpg.rf.b0515ed603d5d83688c8ee2dfedeaa66.jpg
3_deformable_detr,fold_3,1,1,0,1,0,20230512_151233_jpg.rf.57d77820fe4dbc49f59fbae1adba2530.jpg
3_deformable_detr,fold_3,8,7,7,0,-1,IMG_20230512_145010_jpg.rf.ba751af01c38c7678521f2c4ac49568d.jpg
3_deformable_detr,fold_3,11,5,4,1,-6,20230512_150957_jpg.rf.2c85fc69db682fcfa08ad10362437bf3.jpg
3_deformable_detr,fold_3,2,1,1,0,-1,0026_jpg.rf.10b0037e1af1fddb19365505a0710c5e.jpg
3_deformable_detr,fold_3,1,1,1,0,0,0230512_145119_jpg.rf.a6362e13240d8879ce6e61258d8292ff.jpg
3_deformable_detr,fold_3,12,6,5,1,-6,IMG_20230512_152237_316_jpg.rf.d5f18e3c135f2f386671e759efda8b69.jpg
3_deformable_detr,fold_3,13,16,12,4,3,20230512_152314_jpg.rf.6c3a181a30741b0f98140ba02a523656.jpg
3_deformable_detr,fold_3,21,13,10,3,-8,IMG_20230512_150127_jpg.rf.93acf533bedd75541341479d4df15bde.jpg
3_deformable_detr,fold_3,10,9,9,0,-1,IMG_4194_JPG.rf.4cdca480fa2d46704cadc5840d0238b9.jpg
3_deformable_detr,fold_3,2,2,2,0,0,20230512_145425_jpg.rf.8c9689378836a9437ec8ca49c37064b8.jpg
3_deformable_detr,fold_3,9,2,2,0,-7,20230512_150034_jpg.rf.d8c7b9720feb16c5a52d002b7d3fdbec.jpg
3_deformable_detr,fold_3,2,2,2,0,0,20230512_151800_jpg.rf.60975505aa8c8066f47f273831b23407.jpg
3_deformable_detr,fold_3,15,14,14,0,-1,IMG_20230512_152327_jpg.rf.9a4db2d219a086a344f3eb954ba715b9.jpg
3_deformable_detr,fold_3,8,8,8,0,0,20230512_153038_jpg.rf.263cbf9b4c15ef94a433b3b4d9c52ad6.jpg
3_deformable_detr,fold_3,2,2,2,0,0,20230512_151740_jpg.rf.bfe7cb62c2579413cf5790e5fdbe33bc.jpg
3_deformable_detr,fold_3,3,2,2,0,-1,20230512_151622_jpg.rf.99d95c55959b0e321e3679e87f923922.jpg
3_deformable_detr,fold_3,1,1,1,0,0,0007_jpg.rf.2f8d48ecd0ea275fbd9f39696545a7de.jpg
3_deformable_detr,fold_4,8,6,5,1,-2,20230512_152304_jpg.rf.af417071e5055ff7a21c7e5c8a36b6b4.jpg
3_deformable_detr,fold_4,2,1,1,0,-1,IMG_4032_JPG.rf.24900b5575b9992102af280f6bba47e6.jpg
3_deformable_detr,fold_4,2,2,2,0,0,0230512_145348_jpg.rf.cdc212bd3fb2bf4f176382d869092c48.jpg
3_deformable_detr,fold_4,3,3,3,0,0,20230512_151623_jpg.rf.72bb569548154b9cacef8ad44ea34cbb.jpg
3_deformable_detr,fold_4,16,5,4,1,-11,20230512_150033_jpg.rf.187d7f8b3b10fd4c55a59ca829ef7fc8.jpg
3_deformable_detr,fold_4,5,5,5,0,0,20230512_151847_jpg.rf.bd70f9e3dff9227488b4ca7adbf77b50.jpg
3_deformable_detr,fold_4,17,13,13,0,-4,0230512_145037_jpg.rf.043bbe5a69ebdbfca0307a4e11b0ac63.jpg
3_deformable_detr,fold_4,35,14,12,2,-21,20230512_150150_jpg.rf.7c6e4ba9b7c81892495bdb947e71e7bc.jpg
3_deformable_detr,fold_4,12,13,10,3,1,20230512_151910_jpg.rf.83e74c185917f56390fb7c632f1ddbb8.jpg
3_deformable_detr,fold_4,13,12,10,2,-1,IMG_20230512_153056_jpg.rf.ce869252548200602c656449cd5652e5.jpg
3_deformable_detr,fold_4,6,6,6,0,0,20230512_152218_jpg.rf.93c255ace7ac5cb6c518b519f276c38a.jpg
3_deformable_detr,fold_4,1,1,1,0,0,IMG_20230512_150858_jpg.rf.0c886d7a0228ac541d46c5461d00eaa9.jpg
3_deformable_detr,fold_4,8,5,5,0,-3,IMG_20230512_153026_jpg.rf.8b55b13a2be603023efcf36910819c5c.jpg
3_deformable_detr,fold_4,20,17,16,1,-3,IMG_20230512_162026_jpg.rf.5b2e0930b83dcdad9e4b2c7dc2220ad8.jpg
3_deformable_detr,fold_4,3,1,1,0,-2,20230512_152203_jpg.rf.f37f9576053c5dda9448b82302e0a353.jpg
3_deformable_detr,fold_4,7,7,7,0,0,20230512_150912_jpg.rf.18152396c31db59c1819409ba319c0aa.jpg
3_deformable_detr,fold_4,1,1,1,0,0,20230512_151104_jpg.rf.68db94fa29d48c9461b06ea1012225cb.jpg
3_deformable_detr,fold_4,9,6,6,0,-3,IMG_4184_JPG.rf.c3ce659fb0267eb11d28871cd003f680.jpg
3_deformable_detr,fold_4,8,8,8,0,0,IMG_20230512_152244_576_jpg.rf.97d6ebe9005d26f9e1a4c40801745b3f.jpg
3_deformable_detr,fold_4,6,5,4,1,-1,IMG_20230512_144951_654_jpg.rf.73864ab361d6a49bef8ae0582378dcd8.jpg
3_deformable_detr,fold_4,4,3,3,0,-1,20230512_152245_jpg.rf.ad9c9eed13ca805362ff37a6409c22f1.jpg
3_deformable_detr,fold_4,7,5,4,1,-2,0230512_145259_jpg.rf.a81f0fe30e13f9985ea29fbb8c3ca4bb.jpg
3_deformable_detr,fold_4,1,1,1,0,0,20230512_151444_jpg.rf.d7d4a6ea41d6e0b978df16189a7ef0b7.jpg
3_deformable_detr,fold_4,3,3,2,1,0,IMG_20230512_145249_jpg.rf.3fc3e8c98a6aad287c04adaf81f76d80.jpg
3_deformable_detr,fold_4,13,11,10,1,-2,20230512_152301_jpg.rf.13169aad5cc03cf2c0524d6515d1d94b.jpg
3_deformable_detr,fold_4,8,6,5,1,-2,20230512_150133_jpg.rf.959f58c55ea7f14e5d45aefc1a142e65.jpg
3_deformable_detr,fold_4,5,2,1,1,-3,IMG_20230512_145102_470_jpg.rf.a4be99517dd9cf481f2fb0f577967e6e.jpg
3_deformable_detr,fold_4,16,13,13,0,-3,IMG_3905_JPG.rf.442064c53f4baafe2a90c8d4533175cf.jpg
3_deformable_detr,fold_4,3,3,3,0,0,20230512_151752-0-_jpg.rf.adde6111e2c01f49d300871eeeeaf43b.jpg
3_deformable_detr,fold_4,15,13,13,0,-2,IMG_20230512_153244_jpg.rf.fd36ed68885d906d1bfe0772308714e1.jpg
3_deformable_detr,fold_4,45,21,16,5,-24,IMG_20230512_150252_jpg.rf.91876ddbae7daf47c170e3510196d23c.jpg
3_deformable_detr,fold_4,15,15,9,6,0,0230512_144954_jpg.rf.9e07b2d4ee27051f0fa96e46105520b2.jpg
3_deformable_detr,fold_4,9,7,7,0,-2,20230512_151010_jpg.rf.ff0a6fa0a1930269ecf709bdd00cc6b8.jpg
3_deformable_detr,fold_4,1,1,0,1,0,20230512_145011_jpg.rf.85e961b884fe88c3056ad6c5a04daafb.jpg
3_deformable_detr,fold_4,1,1,1,0,0,20230512_151659_jpg.rf.d533f433ef4f94da44e6019d93e2f69d.jpg
3_deformable_detr,fold_4,6,2,2,0,-4,20230512_144945_jpg.rf.49417903dca45c5adf0a0717d2a3dda5.jpg
3_deformable_detr,fold_4,6,4,3,1,-2,20230512_152305_jpg.rf.b263e7fe5ca0aa0ae073ef44c4d6ad63.jpg
3_deformable_detr,fold_4,2,2,2,0,0,20230512_152256_jpg.rf.414a0a8bdcc3eb0a766f8a87f6a30f22.jpg
3_deformable_detr,fold_4,5,6,4,2,1,20230512_151844_jpg.rf.b9cd7c0869b5dcad46ed7aa755549a1d.jpg
3_deformable_detr,fold_4,12,10,7,3,-2,20230512_145238-0-_jpg.rf.a0bc376d8aa6c21ae201e90cd541ddca.jpg
3_deformable_detr,fold_4,11,11,10,1,0,IMG_20230512_152349_jpg.rf.76f8813a71224f65490c6d1d4faea02e.jpg
3_deformable_detr,fold_4,8,7,5,2,-1,20230512_145210_jpg.rf.6800be488a1a4beab14cab796974b7e7.jpg
3_deformable_detr,fold_4,38,23,19,4,-15,IMG_20230512_150114_jpg.rf.d5fd8310f61f94bfde93cace46c477bb.jpg
3_deformable_detr,fold_4,2,2,1,1,0,IMG_20230512_151102_245_jpg.rf.2d98a1d78cce88aad42bfe628f8ebe8d.jpg
3_deformable_detr,fold_4,13,11,10,1,-2,IMG_20230512_151332_jpg.rf.58fb5690cf39dcfb9f524a2ffc7cd6b2.jpg
3_deformable_detr,fold_4,4,4,2,2,0,20230512_145359_jpg.rf.538caafcbceeeab2a7c4cb9e58bb1e6a.jpg
3_deformable_detr,fold_4,4,2,2,0,-2,0230512_145436_jpg.rf.68d4283942702699c181b1c4e2b81a95.jpg
3_deformable_detr,fold_4,1,1,0,1,0,0012_jpg.rf.5fee49c3e98f9b2a75823078d85768de.jpg
3_deformable_detr,fold_4,7,4,4,0,-3,20230512_150040-0-_jpg.rf.c74af3340e71a4f4d5a1fc4d5da8ffe5.jpg
3_deformable_detr,fold_4,8,7,6,1,-1,IMG_20230512_150239_jpg.rf.0eb9dc459dd6d692fc26252cf2107fd0.jpg
3_deformable_detr,fold_4,1,0,0,0,-1,0230512_145052_jpg.rf.f17d7b98aa9a0360c0acc806b326b6a7.jpg
3_deformable_detr,fold_4,13,11,11,0,-2,IMG_20230512_152453_jpg.rf.1723f10503a3e6db7fbceca5913e5ee1.jpg
3_deformable_detr,fold_4,15,16,15,1,1,0044_jpg.rf.a0660e380e16b315347f5e8999d870df.jpg
3_deformable_detr,fold_4,1,1,1,0,0,20230512_145416_jpg.rf.85e0cfe06b91ae56be79ec72f5f2166f.jpg
3_deformable_detr,fold_4,8,8,7,1,0,20230512_145343_jpg.rf.e8b4ce21c1272def811c108b7b1604e1.jpg
3_deformable_detr,fold_4,45,21,19,2,-24,0512_150205_jpg.rf.698866d107ebfcc4f94fd99f31b35b02.jpg
3_deformable_detr,fold_4,2,4,2,2,2,IMG_20230512_151308_jpg.rf.9eafa4b376d2b0b24c2d76c7cefacf05.jpg
3_deformable_detr,fold_4,53,24,21,3,-29,0512_150120_jpg.rf.1a423f81d04e2ea199fda4f8950d5ec2.jpg
3_deformable_detr,fold_4,1,1,1,0,0,20230512_145323_jpg.rf.42fec2bfece6489ae531e4112d227ded.jpg
3_deformable_detr,fold_4,2,3,2,1,1,IMG_20230512_151304_jpg.rf.bdf70f382af5e54ed70fa1fa32041649.jpg
3_deformable_detr,fold_4,1,0,0,0,-1,20230512_153306_jpg.rf.d458260a195df2ca8597a9690a8bc292.jpg
3_deformable_detr,fold_4,10,10,10,0,0,20230512_151858_jpg.rf.3e2b4dbf1ece4e9a00109cbeb8dc13dd.jpg
3_deformable_detr,fold_4,6,6,5,1,0,IMG_20230512_151212_jpg.rf.f922d49a1e43e214462b88c675a0f36c.jpg
3_deformable_detr,fold_4,24,16,14,2,-8,20230512_153019_jpg.rf.6b11b011a1b75c2eb51c302864a6ea12.jpg
3_deformable_detr,fold_4,16,13,12,1,-3,20230512_150111_jpg.rf.3f08c8521cd7c859a80b7ba2d1856e75.jpg
3_deformable_detr,fold_4,1,1,1,0,0,20230512_151650_jpg.rf.18be50d732782b5b8fb5f6c6db59cc14.jpg
3_deformable_detr,fold_4,4,1,1,0,-3,20230512_144940_jpg.rf.47a23c7f63536b38b08e8f2722741d17.jpg
3_deformable_detr,fold_4,11,10,9,1,-1,0054_jpg.rf.5df028d18381f316e9ed0d97adbbfbc0.jpg
3_deformable_detr,fold_4,5,1,1,0,-4,IMG_4217_JPG.rf.b26704f0c46f7b6c0d25d7f2aa4eac49.jpg
3_deformable_detr,fold_4,4,3,3,0,-1,20230512_145352-0-_jpg.rf.bd97ac0cb6ee49b575c0ecff7f91e2a1.jpg
3_deformable_detr,fold_4,1,1,1,0,0,IMG_3856_JPG.rf.4cd3bfac67d223cd7bd1b1efd3b24a09.jpg
3_deformable_detr,fold_4,20,14,14,0,-6,IMG_20230512_152344_jpg.rf.fd23ba06eae998d14ce833db2c7d2195.jpg
3_deformable_detr,fold_4,17,10,8,2,-7,IMG_20230512_150217_jpg.rf.59ee9b06cb5a58b718b0ff7c76a2573f.jpg
3_deformable_detr,fold_4,1,1,1,0,0,20230512_151654-0-_jpg.rf.21ff99bb21484d784b641bc49d9310ea.jpg
3_deformable_detr,fold_4,13,14,13,1,1,IMG_20230512_151617_084_jpg.rf.864b3ce525fdd2abc7cc1f20bd6005c7.jpg
3_deformable_detr,fold_4,5,6,5,1,1,230512_150030_jpg.rf.35a4005da91e89204ecd28ce53e7d8ee.jpg
3_deformable_detr,fold_4,6,5,5,0,-1,20230512_150037_jpg.rf.a47f7ce797194722a66a03263aee18ea.jpg
3_deformable_detr,fold_4,5,4,4,0,-1,IMG_20230512_150051_jpg.rf.66c8214813ef8f830b3612827d4de766.jpg
3_deformable_detr,fold_4,14,11,11,0,-3,20230512_152949_jpg.rf.67f9765f971d32daf7623088e0781422.jpg
3_deformable_detr,fold_4,2,1,1,0,-1,20230512_150046_jpg.rf.a3f3b22b2918be1f870eb4ccdaab79d1.jpg
3_deformable_detr,fold_4,7,1,1,0,-6,IMG_20230512_150112_1_jpg.rf.bf75baa207583c375190da53145a7679.jpg
3_deformable_detr,fold_4,15,11,10,1,-4,IMG_20230512_153023_jpg.rf.317d3bbb9dbd87e5a653c2851476e12f.jpg
3_deformable_detr,fold_4,5,3,3,0,-2,IMG_3847_JPG.rf.7ed87b14fc0af6892da29e4861a20db2.jpg
3_deformable_detr,fold_4,3,0,0,0,-3,0003_jpg.rf.808f042f9b4d2044e82ecf546085a2b3.jpg
3_deformable_detr,fold_4,16,12,12,0,-4,20230512_151042_jpg.rf.668f39eb72d209648acafdc48e653b94.jpg
3_deformable_detr,fold_4,7,6,6,0,-1,20230512_151549_jpg.rf.f43c366ab902f205b42b2d3ece3e5840.jpg
3_deformable_detr,fold_4,6,6,6,0,0,20230512_145344_jpg.rf.3bb4caede9892124f0b05d554bde4f37.jpg
3_deformable_detr,fold_4,1,1,0,1,0,20230512_145106_jpg.rf.f8f6fb5e7680b51b521aeb38bd04b4d4.jpg
3_deformable_detr,fold_4,4,2,2,0,-2,IMG_4056_JPG.rf.26cf10e8b88a0d85256d77231719fa6f.jpg
3_deformable_detr,fold_4,25,9,8,1,-16,0512_150105_jpg.rf.bf34c202007f5f0e97f15dd34c8af9ec.jpg
3_deformable_detr,fold_4,1,0,0,0,-1,20230512_145259_jpg.rf.4e068952a2cfa65232622575f2c5e59f.jpg
3_deformable_detr,fold_4,8,9,5,4,1,IMG_20230512_150233_jpg.rf.fda528f9aab7dbc67a541c09b3ad100a.jpg
3_deformable_detr,fold_4,23,11,3,8,-12,IMG_20230512_150117_559_jpg.rf.acc98bc013000372fc9482efda238776.jpg
3_deformable_detr,fold_4,20,13,11,2,-7,IMG_20230512_150227_jpg.rf.c50986ec06debff70d855a963ab1652a.jpg
3_deformable_detr,fold_4,1,1,1,0,0,20230512_145254_jpg.rf.9747b881733bcadb9a2575a7adfaf75f.jpg
3_deformable_detr,fold_4,7,5,5,0,-2,20230512_151550_jpg.rf.c44e1e4b7281907db5e481f675bb38ec.jpg
3_deformable_detr,fold_4,9,9,9,0,0,20230512_152300_jpg.rf.ca2bad1620eeb8a9708c24c8c2a6140e.jpg
3_deformable_detr,fold_4,1,1,1,0,0,20230512_151454_jpg.rf.2edeb7ad32e74ab446183c1ed2a6a8db.jpg
3_deformable_detr,fold_4,2,1,1,0,-1,20230512_151458_jpg.rf.e6aebc1a203d13c8d455292cbf8efbd5.jpg
3_deformable_detr,fold_4,2,2,2,0,0,20230512_151804_jpg.rf.85f9cab4d985c7a3ab655e9e58f37592.jpg
3_deformable_detr,fold_4,4,2,2,0,-2,20230512_150056-0-_jpg.rf.726ba341e3872665ea20101a9121709b.jpg
3_deformable_detr,fold_4,1,1,1,0,0,20230512_151710-0-_jpg.rf.d1c6ce2dc1214885b420fa5cf5b548eb.jpg
3_deformable_detr,fold_4,7,7,7,0,0,0035_jpg.rf.88b59c904d75a54342b73641b3751f03.jpg
3_deformable_detr,fold_4,3,4,2,2,1,20230512_150207_jpg.rf.2636d37c60105f9dc29244105d586763.jpg
3_deformable_detr,fold_4,11,5,4,1,-6,20230512_153529_jpg.rf.9da097c550c92828a111a560d7417f19.jpg
3_deformable_detr,fold_4,2,2,1,1,0,20230512_145142_jpg.rf.4c1baf7188f9de7e345b9d556ae04487.jpg
3_deformable_detr,fold_4,1,1,1,0,0,0021_jpg.rf.f361beb31a38d69ae7d5b1ba99586d9f.jpg
3_deformable_detr,fold_4,1,0,0,0,-1,IMG_20230512_145308_jpg.rf.60b7e140102953684517e9840c3f84fd.jpg
3_deformable_detr,fold_4,1,1,1,0,0,20230512_145115_jpg.rf.559191d80ad4506d081542afe21569dc.jpg
3_deformable_detr,fold_4,8,8,8,0,0,20230512_151848-0-_jpg.rf.4c259cab53877565769f8e42eb6a0530.jpg
3_deformable_detr,fold_4,2,2,2,0,0,IMG_20230512_153102_jpg.rf.358691eda0f0c7c79eb866b582696397.jpg
3_deformable_detr,fold_4,3,4,3,1,1,IMG_20230512_150935_625_jpg.rf.cff6166bfeadb181c727209a263dcaff.jpg
3_deformable_detr,fold_4,3,5,2,3,2,IMG_3985_JPG.rf.5c7d7114a15a375a31c89b82a6710707.jpg
3_deformable_detr,fold_4,2,2,2,0,0,20230512_151632_jpg.rf.fb7428039c06580293185bb9fd642dff.jpg
3_deformable_detr,fold_4,2,2,2,0,0,IMG_20230512_151628_jpg.rf.0963b2196e508f701f2dc60946b1db1f.jpg
3_deformable_detr,fold_4,1,1,1,0,0,0230512_145319_jpg.rf.7d5ab2070daeed5a15f73e243edac4bd.jpg
3_deformable_detr,fold_4,5,4,4,0,-1,IMG_3914_JPG.rf.ca20ceecff09da300344c1920873e12b.jpg
3_deformable_detr,fold_4,3,1,1,0,-2,IMG_4036_JPG.rf.c2b46ca616106cdb334a1b0aac2c914c.jpg
3_deformable_detr,fold_4,2,2,2,0,0,0230512_145122_jpg.rf.d772ceaa3f11800d1db3d3fc009b64fa.jpg
3_deformable_detr,fold_4,22,18,18,0,-4,20230512_153049_jpg.rf.523c3f6b00af1f2e03d5832e7dd51cae.jpg
3_deformable_detr,fold_4,3,3,3,0,0,IMG_20230512_151832_jpg.rf.b82753ef867011bf9f3989f4130320b7.jpg
3_deformable_detr,fold_4,1,1,1,0,0,20230512_151710_jpg.rf.e2a5628c7930faedb74febbd18a15ccd.jpg
3_deformable_detr,fold_4,5,5,5,0,0,IMG_4185_JPG.rf.6ef6b7a942afe064f7a7a9e4939729df.jpg
3_deformable_detr,fold_4,0,12,0,12,12,20230512_151901_jpg.rf.b378a9d5c3045cf87dd1529a7b516a3a.jpg
3_deformable_detr,fold_4,0,26,0,26,26,0512_150124_jpg.rf.7253b200930360a6b66d16035d62353c.jpg
3_deformable_detr,fold_4,3,3,3,0,0,IMG_4195_JPG.rf.0d03c7bef40b40141ba8fa902afc3944.jpg
3_deformable_detr,fold_4,4,3,3,0,-1,20230512_151029_jpg.rf.aa4b3114b5545da90c2fa92150f01f70.jpg
3_deformable_detr,fold_4,20,8,8,0,-12,20230512_153247_jpg.rf.78c6c0964c07caf937b2079e23dcd922.jpg
3_deformable_detr,fold_4,7,7,7,0,0,IMG_20230512_153040_jpg.rf.3179cdcfc75730df90bea9e4cbaf0f49.jpg
3_deformable_detr,fold_4,10,9,6,3,-1,IMG_20230512_145141_jpg.rf.c065d756b2e91f8933ac0a39ecf7c61c.jpg
3_deformable_detr,fold_4,3,3,2,1,0,IMG_20230512_145333_jpg.rf.4bf3129c20f06bdb19d22b037e743535.jpg
3_deformable_detr,fold_4,3,3,3,0,0,20230512_151621_jpg.rf.1cbfdf5023fe1c36f7e1875304467d87.jpg
3_deformable_detr,fold_4,4,4,3,1,0,IMG_20230512_145030_jpg.rf.a2c5e550d29709fcbbe253d3a17faa45.jpg
3_deformable_detr,fold_4,5,5,5,0,0,20230512_152223_jpg.rf.f6e3e9cd94a0f7908edd48a70c791781.jpg
3_deformable_detr,fold_4,17,8,8,0,-9,IMG_20230512_152350_jpg.rf.4fb06c58b682b06360ed9fa33472ca3f.jpg
3_deformable_detr,fold_4,16,12,11,1,-4,20230512_150149_jpg.rf.5f8b1bb241d961acb2fc7ceb62fbcbe5.jpg
3_deformable_detr,fold_4,7,9,7,2,2,20230512_152306_jpg.rf.20aa1ef8f2026e47d56210676e93fca7.jpg
3_deformable_detr,fold_4,21,18,15,3,-3,20230512_144930_jpg.rf.f3caeeb846d5d4f624e9885bcb85d864.jpg
3_deformable_detr,fold_4,14,12,9,3,-2,IMG_20230512_153017_077_jpg.rf.70df56b8159d336a40a3fab054edb7c4.jpg
3_deformable_detr,fold_4,6,3,3,0,-3,IMG_20230512_144916_143_jpg.rf.00ee144f83892f61d5178b7edacdc535.jpg
3_deformable_detr,fold_4,1,1,1,0,0,0018_jpg.rf.ca81692f06f9a1e7e06b1042d8cbe236.jpg
3_deformable_detr,fold_4,7,7,7,0,0,20230512_152242_jpg.rf.4dee3224c614312f3bd59fc772965ff5.jpg
3_deformable_detr,fold_4,9,2,2,0,-7,IMG_20230512_150043_1_jpg.rf.5e7eb6e74c9c826c0209bc26685279a3.jpg
3_deformable_detr,fold_4,1,0,0,0,-1,0230512_145013_jpg.rf.14bb403c31ebd5a9f4be760858d91e7c.jpg
3_deformable_detr,fold_4,1,1,1,0,0,IMG_4044_JPG.rf.e22068c91df69c24b01d3bb4f484ccf9.jpg
3_deformable_detr,fold_4,9,2,0,2,-7,IMG_20230512_150125_jpg.rf.bdb9638a94f4957f29777b278afdfb54.jpg
3_deformable_detr,fold_4,17,12,12,0,-5,20230512_152946_jpg.rf.00fa418fbf2242a22bd020d8133a24ee.jpg
3_deformable_detr,fold_4,19,9,8,1,-10,IMG_20230512_150131_jpg.rf.325767bc75099b22d288f353f1a8fbe2.jpg
3_deformable_detr,fold_4,16,17,15,2,1,20230512_151041_jpg.rf.0b792381ac6bb324435dd5a7b43616cf.jpg
3_deformable_detr,fold_4,2,2,2,0,0,20230512_151443_jpg.rf.7d2dfd53f11811d0c3a7fe9e184ef15f.jpg
3_deformable_detr,fold_4,13,13,13,0,0,20230512_153243_jpg.rf.a8672f75e3195db775772b68bce054bf.jpg
3_deformable_detr,fold_4,7,7,5,2,0,IMG_3912_JPG.rf.6558238f753c37ffb70dd8d3bcee5e9f.jpg
3_deformable_detr,fold_4,13,8,7,1,-5,IMG_20230512_151318_682_jpg.rf.cdeb9703323a496f0e9620a04f4ec09d.jpg
3_deformable_detr,fold_4,1,1,1,0,0,0038_jpg.rf.d0b487b5b7af9ce9d50c875d519b9707.jpg
3_deformable_detr,fold_4,13,7,7,0,-6,20230512_150015_jpg.rf.5089b7d402f3ce99da9541171299577e.jpg
3_deformable_detr,fold_4,13,9,8,1,-4,20230512_153332_jpg.rf.f6c943fc1dfba3d62a21eb08ecf60b8c.jpg
3_deformable_detr,fold_4,7,7,7,0,0,20230512_152247_jpg.rf.df7d569b56aaba2e6bf5fc59ec8f414c.jpg
3_deformable_detr,fold_5,23,15,10,5,-8,IMG_20230512_150248_jpg.rf.11fd0431dfaace4800d3f2d4912bd780.jpg
3_deformable_detr,fold_5,9,8,8,0,-1,20230512_150203_jpg.rf.d7cdb618f9cc06830ca3fad4137b7cac.jpg
3_deformable_detr,fold_5,13,7,7,0,-6,IMG_20230512_145048_jpg.rf.2f0c31d1a5ff8b461878196ebf8c11df.jpg
3_deformable_detr,fold_5,3,2,2,0,-1,20230512_145350-0-_jpg.rf.ccf3d3aca429fe2887c17c60d55a358a.jpg
3_deformable_detr,fold_5,14,11,9,2,-3,IMG_20230512_153052_jpg.rf.8577be081284ea5d1672c21d4fd9f288.jpg
3_deformable_detr,fold_5,2,2,2,0,0,20230512_151628_jpg.rf.fdfad9f330381519b41b6c69eeae4609.jpg
3_deformable_detr,fold_5,4,4,3,1,0,20230512_150906_jpg.rf.b4718b9b84d49303d6b0fb5e035fe49b.jpg
3_deformable_detr,fold_5,2,2,2,0,0,IMG_20230512_151744_jpg.rf.1d579e4bc8e6391207029a3d59c821a9.jpg
3_deformable_detr,fold_5,2,2,1,1,0,0013_jpg.rf.55b646371565f20bce0f6ce403646502.jpg
3_deformable_detr,fold_5,16,8,4,4,-8,20230512_145021_jpg.rf.57a18381e0e233f1d4d97199a9263ed4.jpg
3_deformable_detr,fold_5,4,4,4,0,0,20230512_152325_jpg.rf.b754896fe384db191f35564d52272327.jpg
3_deformable_detr,fold_5,3,2,2,0,-1,IMG_20230512_151247_jpg.rf.33589b240751a2f02c7a7c51bafafe59.jpg
3_deformable_detr,fold_5,3,3,3,0,0,20230512_151624_jpg.rf.339fa34d1377a1b59daa0460f8896c47.jpg
3_deformable_detr,fold_5,7,7,4,3,0,IMG_20230512_145013_jpg.rf.23ebd19f18a23ba18f9bde6b91f93cbd.jpg
3_deformable_detr,fold_5,5,4,3,1,-1,20230512_153327_jpg.rf.07e6f7dfffed230d78bc971f5cdb9b9f.jpg
3_deformable_detr,fold_5,1,1,1,0,0,20230512_151652_jpg.rf.42dfca221b4b4fbaf828e370670fd031.jpg
3_deformable_detr,fold_5,13,11,8,3,-2,20230512_151021-copia-1-_jpg.rf.abdeaa1b054ea3b58658807cca9089ae.jpg
3_deformable_detr,fold_5,2,2,2,0,0,IMG_20230512_151820_jpg.rf.2fe30b8ed1d8e20bac353cf3379cdcce.jpg
3_deformable_detr,fold_5,9,9,6,3,0,IMG_20230512_151055_jpg.rf.4509eabdb200535ad64add0b786d59a4.jpg
3_deformable_detr,fold_5,3,3,2,1,0,20230512_150026_jpg.rf.33fe35571137ce16bd8c3bd383b8db8f.jpg
3_deformable_detr,fold_5,4,2,2,0,-2,0005_jpg.rf.024cc60176c5f8a007eca0cbdacb4691.jpg
3_deformable_detr,fold_5,17,16,15,1,-1,20230512_151040_jpg.rf.87640fb95b74f117e81bcca0c41f76af.jpg
3_deformable_detr,fold_5,11,10,6,4,-1,20230512_152314_jpg.rf.0becd9c30d5157c4b2a582e3fa4b759a.jpg
3_deformable_detr,fold_5,11,6,6,0,-5,20230512_151853_jpg.rf.b5af18c1578fd0fbb73f9427792d45c0.jpg
3_deformable_detr,fold_5,1,1,1,0,0,20230512_150249_jpg.rf.78e9f249c2e4a31b39a078b7266ac51a.jpg
3_deformable_detr,fold_5,22,14,8,6,-8,20230512_150104_jpg.rf.291e8ff0d311863c8ac10188b0cb1b28.jpg
3_deformable_detr,fold_5,3,3,2,1,0,20230512_145232_jpg.rf.f26463ccf279cd604dca1dded979fa14.jpg
3_deformable_detr,fold_5,10,2,1,1,-8,20230512_153454_jpg.rf.a2384c87b34aeaa97bbbbd20e8b1d56b.jpg
3_deformable_detr,fold_5,1,1,0,1,0,20230512_151017_jpg.rf.c588fa9199c6dffdb1179f7f483c865f.jpg
3_deformable_detr,fold_5,17,15,11,4,-2,20230512_150146_jpg.rf.e84fc4cf33f8326d64d02b7ed8cafce4.jpg
3_deformable_detr,fold_5,6,5,4,1,-1,IMG_3850_JPG.rf.7f7105ed07be37f94ee73db7da91b99e.jpg
3_deformable_detr,fold_5,1,0,0,0,-1,20230512_145114_jpg.rf.38c9c923c79af5172bfb7315ee2859bb.jpg
3_deformable_detr,fold_5,1,1,0,1,0,20230512_152332_jpg.rf.4836b4b24c985755468de47d12fd4fa5.jpg
3_deformable_detr,fold_5,6,7,6,1,1,20230512_151136_jpg.rf.a8aef98dbb4c86bffec8ae4287c1dc6e.jpg
3_deformable_detr,fold_5,5,5,5,0,0,IMG_20230512_152359_jpg.rf.a5ab36a1dd0fd3e5088b4ed61c7990eb.jpg
3_deformable_detr,fold_5,17,14,14,0,-3,IMG_4208_JPG.rf.8f59289e526ec56a405f244ebaa1a95a.jpg
3_deformable_detr,fold_5,1,1,1,0,0,20230512_151208_jpg.rf.0f6b66ca4ada91b2974b5945e2b92069.jpg
3_deformable_detr,fold_5,3,2,2,0,-1,20230512_151839_jpg.rf.7e5100e585fd816285691f17e14cfcdb.jpg
3_deformable_detr,fold_5,4,3,3,0,-1,IMG_3919_JPG.rf.9a5b0afd3da0db473f842046c5113690.jpg
3_deformable_detr,fold_5,8,3,2,1,-5,20230512_145241_jpg.rf.455691f27dd7da4e6c25ba615f3f2620.jpg
3_deformable_detr,fold_5,2,2,2,0,0,0230512_145355_jpg.rf.c17e94a0f80c4c06f2a620a85826ebcc.jpg
3_deformable_detr,fold_5,1,1,1,0,0,20230512_151504_jpg.rf.c79fb008568aeb31342688eb80ad9a49.jpg
3_deformable_detr,fold_5,2,2,2,0,0,0029_jpg.rf.e9d3f2a53d6d73564cd418ea60fbbd61.jpg
3_deformable_detr,fold_5,2,2,2,0,0,20230512_151133_jpg.rf.a96da38b573a4da364c3f36aaf0c460d.jpg
3_deformable_detr,fold_5,2,2,2,0,0,IMG_20230512_151814_jpg.rf.d8d7b03e58abeca643b8f9e71acfd81a.jpg
3_deformable_detr,fold_5,1,1,1,0,0,20230512_151010_jpg.rf.a46c76d923129f16810ff21ca0937475.jpg
3_deformable_detr,fold_5,2,2,2,0,0,0032_jpg.rf.ac745db746452e37d39279a2c8ecd454.jpg
3_deformable_detr,fold_5,8,7,7,0,-1,20230512_151510_jpg.rf.b27f217e8ec95c059fa149f7f8f03d2b.jpg
3_deformable_detr,fold_5,3,2,2,0,-1,IMG_20230512_151228_jpg.rf.1e509a8a9a3464432051f5ec53cc611c.jpg
3_deformable_detr,fold_5,15,13,13,0,-2,0045_jpg.rf.b8baabd840c67f80f92a3844015afe9b.jpg
3_deformable_detr,fold_5,13,11,11,0,-2,20230512_151047_jpg.rf.3fb94f0bd6175b2f1306a1aac0027216.jpg
3_deformable_detr,fold_5,12,7,7,0,-5,IMG_20230512_150922_jpg.rf.e1a7736e96dfcd7e2b06e2f5c94a3cc1.jpg
3_deformable_detr,fold_5,1,3,1,2,2,0010_jpg.rf.d1d93d099773f36e90b527f8611d128c.jpg
3_deformable_detr,fold_5,68,14,14,0,-54,IMG_20230512_153133_jpg.rf.b54f10d107857a0eb7fbb7943b030152.jpg
3_deformable_detr,fold_5,1,3,1,2,2,IMG_20230512_151445_jpg.rf.853f3efcb5076d2d7bac2e663f2804bd.jpg
3_deformable_detr,fold_5,1,1,1,0,0,IMG_20230512_151214_161_jpg.rf.057ee941cfb105e5fd41f7e4342f657a.jpg
3_deformable_detr,fold_5,1,1,1,0,0,230512_150310_jpg.rf.25af60211cc7ea70d0a37dae89d778ae.jpg
3_deformable_detr,fold_5,11,12,10,2,1,IMG_20230512_151958_jpg.rf.c0c5a182cd6f5f4319120803cadd4e15.jpg
3_deformable_detr,fold_5,7,6,2,4,-1,230512_150020_jpg.rf.3321ea3a69f605601bbe1180e33c4372.jpg
3_deformable_detr,fold_5,2,2,2,0,0,20230512_151705_jpg.rf.5d4aace27e10d6b9f9dcd14c2eb80876.jpg
3_deformable_detr,fold_5,10,10,8,2,0,IMG_20230512_151057_jpg.rf.34b51a9edb1d08b21feec0712493ad44.jpg
3_deformable_detr,fold_5,4,4,4,0,0,20230512_151746_jpg.rf.28bbdba7c34f11ae2fa3b6c62e25edcc.jpg
3_deformable_detr,fold_5,12,9,8,1,-3,20230512_145147_jpg.rf.8cbc9f87bfc771396f02c8e27231d7ee.jpg
3_deformable_detr,fold_5,5,6,5,1,1,IMG_20230512_152233_631_jpg.rf.5a6ed894f5cd8513bac1f0dfbdeb7bf3.jpg
3_deformable_detr,fold_5,1,1,1,0,0,20230512_145424_jpg.rf.fdacfd117c87835a809a784e9019c683.jpg
3_deformable_detr,fold_5,1,1,1,0,0,20230512_145347_jpg.rf.d1edf1d3992c10216d75faac6523aed9.jpg
3_deformable_detr,fold_5,7,6,5,1,-1,IMG_20230512_145116_jpg.rf.89714791069678114dd234188f4e153e.jpg
3_deformable_detr,fold_5,5,5,5,0,0,20230512_152308_jpg.rf.f4e8f4ca110dded8e5b00937a84760be.jpg
3_deformable_detr,fold_5,11,3,2,1,-8,IMG_4212_JPG.rf.93840a5a997c2230b8ec5404df51506e.jpg
3_deformable_detr,fold_5,22,11,10,1,-11,20230512_150120_jpg.rf.e2c884c6c431ae355dbe5eae448fe9fe.jpg
3_deformable_detr,fold_5,1,1,1,0,0,0035_jpg.rf.8f80b9113851faa3ce22f7a4237e063b.jpg
3_deformable_detr,fold_5,1,0,0,0,-1,IMG_4020_JPG.rf.bc2697c76c5828734e1ac848245c5a5b.jpg
3_deformable_detr,fold_5,6,7,6,1,1,IMG_20230512_151224_jpg.rf.f07ca2ca5270e16cfa2d0b808d60cc7f.jpg
3_deformable_detr,fold_5,14,12,8,4,-2,20230512_152357_jpg.rf.6852fe96763037ed9985128c109b3ce2.jpg
3_deformable_detr,fold_5,21,14,14,0,-7,IMG_20230512_150344_jpg.rf.21eb7b1441ddc9b2740cc4367709590f.jpg
3_deformable_detr,fold_5,2,1,0,1,-1,20230512_145054_jpg.rf.3d4529e01dd37f4f80ba26154a898555.jpg
3_deformable_detr,fold_5,7,7,7,0,0,20230512_152258_jpg.rf.7636714c888f4e6cbf70120b64064d40.jpg
3_deformable_detr,fold_5,2,2,2,0,0,20230512_151841_jpg.rf.9dd3a6bca715d1085cb1da5cae6efd0f.jpg
3_deformable_detr,fold_5,19,8,6,2,-11,20230512_150051_jpg.rf.c03c04498642818f22eb4115246bdb27.jpg
3_deformable_detr,fold_5,2,3,2,1,1,20230512_151635_jpg.rf.ee2ff8efc5aaa53fea09028b60c05e75.jpg
3_deformable_detr,fold_5,24,7,4,3,-17,IMG_20230512_150107_368_jpg.rf.841def69669689958248c77fd74c6ef5.jpg
3_deformable_detr,fold_5,1,1,1,0,0,20230512_151647_jpg.rf.367411ded71931545e2f1f2799cebf0b.jpg
3_deformable_detr,fold_5,2,2,1,1,0,20230512_151223_jpg.rf.6a7ba0efceb9c41d056eee7ad9219353.jpg
3_deformable_detr,fold_5,4,1,1,0,-3,20230512_145213_jpg.rf.166b2f375e79324c95dc48c23bef06fa.jpg
3_deformable_detr,fold_5,2,0,0,0,-2,IMG_3844_JPG.rf.8a9213642776490b8b621595f6183af2.jpg
3_deformable_detr,fold_5,14,7,6,1,-7,20230512_145202_jpg.rf.fc0b0601e248df8d80e9bb9ba998d0e7.jpg
3_deformable_detr,fold_5,26,11,10,1,-15,0512_150040_jpg.rf.f8c148cb1d657923d62ef9d7c2a4e8c4.jpg
3_deformable_detr,fold_5,9,8,8,0,-1,20230512_153259_jpg.rf.893deba08433f5f85baa0becc85071b1.jpg
3_deformable_detr,fold_5,1,1,1,0,0,IMG_20230512_150840_jpg.rf.3e9980cbe445c9f1025d481e7a7a5710.jpg
3_deformable_detr,fold_5,17,14,12,2,-3,20230512_151049_jpg.rf.7faee580bbaad04f4aee5a6edf72e5b5.jpg
3_deformable_detr,fold_5,43,12,12,0,-31,0512_150100_jpg.rf.9eaed3be83ecba8e3e4efbdc882c1fa5.jpg
3_deformable_detr,fold_5,2,1,1,0,-1,230512_150026_jpg.rf.633ed1e3a24d8c7ecacc82788de5c3b8.jpg
3_deformable_detr,fold_5,3,0,0,0,-3,IMG_20230512_153013_jpg.rf.93712b9e1c24432fd87372997521847c.jpg
3_deformable_detr,fold_5,2,1,1,0,-1,0017_jpg.rf.c3653cc70e103964ca9e6a3e85f3f694.jpg
3_deformable_detr,fold_5,5,5,5,0,0,20230512_151508_jpg.rf.00e90b7105d608decd85f3e850e1f875.jpg
3_deformable_detr,fold_5,8,5,4,1,-3,IMG_20230512_150939_jpg.rf.d5260c01e2cabb005d119333eda4e87d.jpg
3_deformable_detr,fold_5,2,1,1,0,-1,IMG_4021_JPG.rf.7556e49a1eda27532dfb6cc32c974482.jpg
3_deformable_detr,fold_5,5,5,5,0,0,20230512_152302_jpg.rf.016780b8da4c66843b955300975f2747.jpg
3_deformable_detr,fold_5,34,14,10,4,-20,IMG_20230512_150128_453_jpg.rf.081da15c5e562b5ce7f42ab95339a34a.jpg
3_deformable_detr,fold_5,1,1,1,0,0,0027_jpg.rf.041bc0af55a373703357342785fa3667.jpg
3_deformable_detr,fold_5,1,1,1,0,0,20230512_150050_jpg.rf.c95631863834d93e37ddc2fda8829ab4.jpg
3_deformable_detr,fold_5,10,8,8,0,-2,IMG_20230512_153016_jpg.rf.c257848a0cea9445774e7172a68a0d16.jpg
3_deformable_detr,fold_5,21,16,16,0,-5,20230512_152409_jpg.rf.5d8e7c06336544573f46c12fe04ef26b.jpg
3_deformable_detr,fold_5,4,2,2,0,-2,IMG_20230512_151230_jpg.rf.77eaf1e461982f94562c61c5de9e3444.jpg
3_deformable_detr,fold_5,3,3,3,0,0,IMG_4192_JPG.rf.915fc04cdd59b40454fa22fea6dcf2f7.jpg
3_deformable_detr,fold_5,1,1,1,0,0,20230512_145226_jpg.rf.d01dc6c5e4859db13d337281014a74b1.jpg
3_deformable_detr,fold_5,1,1,1,0,0,20230512_151100_jpg.rf.8c5db2f9786fe5fedf170c30766e11a8.jpg
3_deformable_detr,fold_5,11,9,9,0,-2,20230512_151912_jpg.rf.2dfbdab89b348f4eda01f5edbb8bf596.jpg
3_deformable_detr,fold_5,8,8,7,1,0,20230512_145439_jpg.rf.21c5c0c901e6a327a75c7f0dc4eafc1c.jpg
3_deformable_detr,fold_5,1,1,1,0,0,IMG_20230512_151206_373_jpg.rf.25070077bf672ae36c15ea6e22fdc049.jpg
3_deformable_detr,fold_5,1,1,1,0,0,20230512_145257_jpg.rf.f1c0c8bd862cb12f380ae5d7949e68a2.jpg
3_deformable_detr,fold_5,5,5,4,1,0,IMG_20230512_153021_jpg.rf.c74db55af384c855422ee71d8c0c24a2.jpg
3_deformable_detr,fold_5,20,14,13,1,-6,IMG_20230512_152355_jpg.rf.1ee2ad035e7125aadb708f8b70abd231.jpg
3_deformable_detr,fold_5,3,6,2,4,3,20230512_152249_jpg.rf.9209f7c7b47e7778a14dc41949d8882b.jpg
3_deformable_detr,fold_5,1,1,0,1,0,20230512_151230_jpg.rf.ab81eae29bf9052e3dd989b36b3a00cd.jpg
3_deformable_detr,fold_5,3,3,3,0,0,IMG_3915_JPG.rf.83d4afabcacf1fe7976e4f01a8b55687.jpg
3_deformable_detr,fold_5,2,2,1,1,0,IMG_3913_JPG.rf.23307ea91d746d228b58a6db32ff0bca.jpg
3_deformable_detr,fold_5,10,7,5,2,-3,IMG_20230512_145140_jpg.rf.a089bf5c311c725d73e925fe2d7d4c66.jpg
3_deformable_detr,fold_5,10,6,6,0,-4,20230512_151859_jpg.rf.820ed98fb886601f4f15717490003a3e.jpg
3_deformable_detr,fold_5,3,3,3,0,0,20230512_152225_jpg.rf.889528313caa94497bf581fc9b6ec204.jpg
3_deformable_detr,fold_5,7,6,6,0,-1,20230512_145340_jpg.rf.962ef85b90f87307d46df866e8b6be07.jpg
3_deformable_detr,fold_5,1,1,1,0,0,IMG_4397_JPG.rf.ff87fb693a34984f9e818a3a3a1a79b3.jpg
3_deformable_detr,fold_5,11,11,11,0,0,20230512_151903_jpg.rf.e84304253d71e06ad8473e1be6aa7582.jpg
3_deformable_detr,fold_5,16,11,8,3,-5,IMG_20230512_150056_jpg.rf.65358cd23942ee92bc5024b41d26500a.jpg
3_deformable_detr,fold_5,29,11,11,0,-18,0512_150057_jpg.rf.c228357b2bf9bb499210e8c8c7afa45b.jpg
3_deformable_detr,fold_5,2,1,1,0,-1,20230512_153435_jpg.rf.52f71510b3fa5d1e5d0f6e2468cab216.jpg
3_deformable_detr,fold_5,16,5,4,1,-11,IMG_20230512_145123_jpg.rf.1bbba4202dcb5637d1840db017c11671.jpg
3_deformable_detr,fold_5,1,0,0,0,-1,20230512_153421_jpg.rf.4cb37bb0380a93d519214becab03862c.jpg
3_deformable_detr,fold_5,16,8,6,2,-8,20230512_144939_jpg.rf.32f704ff01b8b91ab11ac16462053c96.jpg
3_deformable_detr,fold_5,1,2,1,1,1,20230512_151453_jpg.rf.fc89aea08c4953e972d355bc593bd6ae.jpg
3_deformable_detr,fold_5,1,1,1,0,0,IMG_4019_JPG.rf.13ea285b754475b580f840ba9fc99608.jpg
3_deformable_detr,fold_5,5,5,5,0,0,20230512_152320_jpg.rf.373cf359be94c413709d04995faada1e.jpg
3_deformable_detr,fold_5,1,0,0,0,-1,IMG_20230512_145029_jpg.rf.7bf65ac7d5d4f934ebfd179e7ad97968.jpg
3_deformable_detr,fold_5,2,2,2,0,0,0049_jpg.rf.d9e63c2316d02b96968a7dd44061b337.jpg
3_deformable_detr,fold_5,1,0,0,0,-1,230512_150124_jpg.rf.a1dce64e321706af2f260a6b933ae5d1.jpg
3_deformable_detr,fold_5,1,1,1,0,0,20230512_145108_jpg.rf.cfa16a281bcee146efbf5aac473021a3.jpg
3_deformable_detr,fold_5,3,3,2,1,0,20230512_145127_jpg.rf.2e6c583887c26feb5d54542c0b963ea1.jpg
3_deformable_detr,fold_5,7,7,7,0,0,IMG_20230512_151451_jpg.rf.2218d423d5bccf8392a803b3052b5d3b.jpg
3_deformable_detr,fold_5,5,4,3,1,-1,0230512_145345_jpg.rf.349c9a4b5a46e8d3477462f4e4215cba.jpg
3_deformable_detr,fold_5,11,9,9,0,-2,20230512_151908_jpg.rf.b315ad5e28b7bf0551708d4ea9d3dd39.jpg
3_deformable_detr,fold_5,12,5,5,0,-7,20230512_152237_jpg.rf.808fe6741a783c4fa83bfabf79676eac.jpg
3_deformable_detr,fold_5,1,1,1,0,0,20230512_151806-0-_jpg.rf.ee8c0cb2ceb0752fb58a7e8380a489b8.jpg
3_deformable_detr,fold_5,5,4,4,0,-1,20230512_152311_jpg.rf.5e824954dc303eba4a13e80481374d92.jpg
3_deformable_detr,fold_5,5,4,3,1,-1,IMG_20230512_151619_jpg.rf.602d997ec01411a318e031faecec475a.jpg
3_deformable_detr,fold_5,8,8,7,1,0,20230512_150205_jpg.rf.af4ff5234c4e2039ba4aa43dfef61137.jpg
3_deformable_detr,fold_5,1,1,1,0,0,20230512_151641_jpg.rf.9d3677c71aedef7846514f40d39cc285.jpg
3_deformable_detr,fold_5,1,1,1,0,0,IMG_4396_JPG.rf.a6ca21b5c9e64200051d628058fac8d3.jpg
3_deformable_detr,fold_5,4,4,3,1,0,IMG_20230512_151255_jpg.rf.7a344a314dbceac482eaa7344270d575.jpg
3_deformable_detr,fold_5,3,3,2,1,0,20230512_145413_jpg.rf.d92c86a64c63fad8780cddf8f9af65d7.jpg
3_deformable_detr,fold_5,15,16,12,4,1,IMG_20230512_153000_904_jpg.rf.0910e6a7b929687a7f2cb7d8110febe6.jpg
3_deformable_detr,fold_5,3,3,3,0,0,IMG_3864_JPG.rf.0b9655ea20ce691d9f9006c6ab150d3c.jpg
3_deformable_detr,fold_5,10,9,8,1,-1,230512_145026_jpg.rf.f23932c58f897cb3d0594cc7af5c44f4.jpg
3_deformable_detr,fold_5,6,4,2,2,-2,230512_150021_jpg.rf.9f8dde8cf7d3e52b983f2e1dee1f56d6.jpg
3_deformable_detr,fold_5,21,16,15,1,-5,20230512_152319_jpg.rf.3d825a3794a8b316d78f9af2806a7c6c.jpg
3_deformable_detr,fold_5,1,1,1,0,0,20230512_152353_jpg.rf.ed8431bc0af772a21f7e6f7b52b33d4e.jpg
3_deformable_detr,fold_5,10,10,10,0,0,20230512_151345_jpg.rf.4dd52a96ef715b94641151e55cadac59.jpg
3_deformable_detr,fold_5,6,6,6,0,0,20230512_145401_jpg.rf.44167fa74f8667ec2ab9d47632567ba8.jpg
3_deformable_detr,fold_6,1,1,1,0,0,IMG_3918_JPG.rf.73a732415980a079e2ee9f088f0b902b.jpg
3_deformable_detr,fold_6,3,1,0,1,-2,20230512_150304_jpg.rf.42997b281c38f2d2e1caa252c8202466.jpg
3_deformable_detr,fold_6,1,0,0,0,-1,20230512_145018_jpg.rf.6120633e9f3b01a0322386f7107b3216.jpg
3_deformable_detr,fold_6,2,2,2,0,0,IMG_20230512_151746_jpg.rf.e11cc2bdd754b8c380d4b2f51b494333.jpg
3_deformable_detr,fold_6,1,0,0,0,-1,IMG_3859_JPG.rf.217ab58b1022e7dbdcc07a4a48bdf055.jpg
3_deformable_detr,fold_6,3,3,3,0,0,20230512_151142_jpg.rf.959c44ca45dfd6e8f7458240928724a4.jpg
3_deformable_detr,fold_6,7,10,7,3,3,IMG_20230512_153034_jpg.rf.d2546314233e70df166dd444373fe566.jpg
3_deformable_detr,fold_6,39,13,12,1,-26,20230512_150259_jpg.rf.640d17e1a5cec14371d2ef32c74c215b.jpg
3_deformable_detr,fold_6,1,1,1,0,0,20230512_151613-0-_jpg.rf.d6f5456bcfe941a2766b34ca25d6e64c.jpg
3_deformable_detr,fold_6,1,0,0,0,-1,20230512_151247_jpg.rf.559bbd96f04ed0b61011356b33038efb.jpg
3_deformable_detr,fold_6,12,11,11,0,-1,20230512_151901-0-_jpg.rf.23717847adee37125505701d84f8b2c4.jpg
3_deformable_detr,fold_6,2,2,1,1,0,0230512_145403_jpg.rf.86e849309856a70f7343d14e0be80d1f.jpg
3_deformable_detr,fold_6,18,12,11,1,-6,20230512_150212-0-_jpg.rf.42aaa169dabc6e224af1ad2603fa77d9.jpg
3_deformable_detr,fold_6,1,1,1,0,0,IMG_20230512_150958_jpg.rf.806f513ed04cbf893c8a805d028e17a5.jpg
3_deformable_detr,fold_6,6,3,3,0,-3,IMG_20230512_150849_517_jpg.rf.8292597aeb2edd9ad9a8634d1e6ce325.jpg
3_deformable_detr,fold_6,5,6,4,2,1,20230512_153406_jpg.rf.5fd9ed7f498c063bbe363af58bf64afe.jpg
3_deformable_detr,fold_6,1,1,1,0,0,20230512_145139_jpg.rf.1ccaa55656a3b72abb079fcaca9ebd91.jpg
3_deformable_detr,fold_6,9,5,4,1,-4,20230512_145207_jpg.rf.d6520c0b52ca9d11cbdb08e7fcad7279.jpg
3_deformable_detr,fold_6,1,1,1,0,0,20230512_151709_jpg.rf.67e1deefca206f50f10d35552ae2213f.jpg
3_deformable_detr,fold_6,9,7,7,0,-2,20230512_152229_jpg.rf.f718118201e6c3b0a3b3d89958725c05.jpg
3_deformable_detr,fold_6,18,10,9,1,-8,20230512_151030_jpg.rf.99cd8001fdf2562bbd43c3e28ec3bc18.jpg
3_deformable_detr,fold_6,1,1,1,0,0,0016_jpg.rf.2a262f7303067736073549486906cc43.jpg
3_deformable_detr,fold_6,1,1,1,0,0,20230512_151651_jpg.rf.d9eebb8d47a3a2ecc2b5ab5fce867c62.jpg
3_deformable_detr,fold_6,3,4,3,1,1,IMG_20230512_151216_jpg.rf.212dba7457c89d85163142d3417d011a.jpg
3_deformable_detr,fold_6,2,1,1,0,-1,20230512_151754_jpg.rf.54ba86e6a384ea604ca2e9b48b6baaf5.jpg
3_deformable_detr,fold_6,7,6,4,2,-1,MG_20230512_145052_jpg.rf.e48facc3a59ffc87c5c20e1e858d782f.jpg
3_deformable_detr,fold_6,1,1,1,0,0,20230512_145105_jpg.rf.773b834198bf17c51531470842565757.jpg
3_deformable_detr,fold_6,2,0,0,0,-2,20230512_150310_jpg.rf.1c8474c411cc1309fdcb6f4f05ad76e7.jpg
3_deformable_detr,fold_6,11,4,4,0,-7,IMG_20230512_151242_jpg.rf.46afd180ee87359123f370468c16ecd9.jpg
3_deformable_detr,fold_6,7,7,6,1,0,IMG_20230512_150822_610_jpg.rf.202648ab81c8a246ef6e9d92f76fc793.jpg
3_deformable_detr,fold_6,13,12,11,1,-1,0230512_150158_jpg.rf.87404c9e49a82e56c7dade7c3898effc.jpg
3_deformable_detr,fold_6,3,1,1,0,-2,20230512_145214_jpg.rf.7dff106d138e1a8492bda9d8a939f1df.jpg
3_deformable_detr,fold_6,12,7,7,0,-5,20230512_150028_jpg.rf.af876dc827626d5f87a6fe1e271ef879.jpg
3_deformable_detr,fold_6,10,9,8,1,-1,20230512_150924_jpg.rf.e5426caf129241e7f71edfd6460ffb7b.jpg
3_deformable_detr,fold_6,36,21,19,2,-15,IMG_20230512_150302_jpg.rf.9b111acf170d8c1671212ec46ca5f96b.jpg
3_deformable_detr,fold_6,2,1,1,0,-1,IMG_3855_JPG.rf.3c07d7a3a717987d18e4881f741f0109.jpg
3_deformable_detr,fold_6,42,19,14,5,-23,0002_jpg.rf.e28c19f2eeb804b4f3db5cb8a9b96722.jpg
3_deformable_detr,fold_6,2,2,2,0,0,20230512_151519_jpg.rf.a798ec75f634d9c0b2099d74e6391b2f.jpg
3_deformable_detr,fold_6,1,1,1,0,0,20230512_145231_jpg.rf.5067ec9a11eb10e94f1992fa7b9fdca9.jpg
3_deformable_detr,fold_6,6,4,4,0,-2,20230512_151813_jpg.rf.8e04e5f09260558a80ad8ed222a6842d.jpg
3_deformable_detr,fold_6,17,16,16,0,-1,0039_jpg.rf.24da2dcb61a34ae88e4e3ae85334ec49.jpg
3_deformable_detr,fold_6,2,1,1,0,-1,IMG_4016_JPG.rf.57796edbcc20ef6bb7930ae2c9b790e7.jpg
3_deformable_detr,fold_6,9,6,5,1,-3,0230512_150107_jpg.rf.255ebb7bf873cd1fb62870dd946c636b.jpg
3_deformable_detr,fold_6,1,1,1,0,0,IMG_4045_JPG.rf.5fd568888c253fc15e61ef0e6a600736.jpg
3_deformable_detr,fold_6,2,2,2,0,0,20230512_151706_jpg.rf.a1ec45640c8ceaf421bdd396abbff09a.jpg
3_deformable_detr,fold_6,5,4,3,1,-1,IMG_20230512_150931_075_jpg.rf.e33516383d2c37617b8a3623da6f46df.jpg
3_deformable_detr,fold_6,2,2,2,0,0,20230512_150045-0-_jpg.rf.e0a79a709ca27bbd1ddee5f8a4336ea8.jpg
3_deformable_detr,fold_6,5,5,5,0,0,20230512_152227_jpg.rf.0537631b05bb432698dc401e82e41cdd.jpg
3_deformable_detr,fold_6,6,5,5,0,-1,20230512_151547_jpg.rf.11083d91d633eac77747e3332d593385.jpg
3_deformable_detr,fold_6,12,9,7,2,-3,20230512_151043_jpg.rf.3411f895e2985588186e8495e99b2a5d.jpg
3_deformable_detr,fold_6,2,2,2,0,0,20230512_150754_jpg.rf.25cdffe09e3da5825e5287e9707d28b7.jpg
3_deformable_detr,fold_6,2,2,2,0,0,20230512_150054_jpg.rf.d397e2f4f89585ae423d36316b68e0d3.jpg
3_deformable_detr,fold_6,1,1,1,0,0,20230512_151658_jpg.rf.64accf87df1b759e733862bd5826d73c.jpg
3_deformable_detr,fold_6,9,5,5,0,-4,20230512_150251_jpg.rf.5e1c1bb0e6397c87b2959920705bf3e4.jpg
3_deformable_detr,fold_6,1,1,0,1,0,20230512_145027_jpg.rf.ec568ee157ffdc70fa125022bd4e2226.jpg
3_deformable_detr,fold_6,24,23,17,6,-1,IMG_3929_JPG.rf.a2180d03c20d1cfeece3cc8d116bef58.jpg
3_deformable_detr,fold_6,6,4,4,0,-2,IMG_20230512_145356_jpg.rf.aade91e03425891ebb1e7913c596a6bb.jpg
3_deformable_detr,fold_6,4,2,2,0,-2,20230512_151320_jpg.rf.000a402e9a61ca254ddb3eb836b8d52e.jpg
3_deformable_detr,fold_6,1,2,1,1,1,20230512_150053_jpg.rf.088308ae98c13a53c0cd09a0c5d7873d.jpg
3_deformable_detr,fold_6,2,2,2,0,0,IMG_4030_JPG.rf.d581bcd4c0908b4512a05d8d538db640.jpg
3_deformable_detr,fold_6,2,1,1,0,-1,20230512_145101_jpg.rf.2e2ab39bfad17ac6cf7a40fbca0233b7.jpg
3_deformable_detr,fold_6,11,7,7,0,-4,20230512_151319_jpg.rf.95cf4d71c19232b1c36b69b6329abdb6.jpg
3_deformable_detr,fold_6,1,1,1,0,0,20230512_145222_jpg.rf.dc5b10230a198c45f4f849d8bea6cf45.jpg
3_deformable_detr,fold_6,13,12,12,0,-1,0003_jpg.rf.a4014333632a8045d62b2480bccb288b.jpg
3_deformable_detr,fold_6,21,14,13,1,-7,IMG_20230512_150346_jpg.rf.5eb42adbd89cd335587264e87d4a07ea.jpg
3_deformable_detr,fold_6,2,2,2,0,0,20230512_151742_jpg.rf.734b217dddc054e2dbb00d9964713986.jpg
3_deformable_detr,fold_6,1,1,0,1,0,20230512_145328_jpg.rf.dcfa7faebf8b77528401b336abf6eaad.jpg
3_deformable_detr,fold_6,5,5,4,1,0,20230512_145335_jpg.rf.896d2a48efad0e17923f2fec260761b0.jpg
3_deformable_detr,fold_6,4,3,3,0,-1,IMG_4386_JPG.rf.642872f82064187dff74f15b1ff0a923.jpg
3_deformable_detr,fold_6,2,1,0,1,-1,20230512_150049_jpg.rf.e1512981920c32d09de9c291359753fd.jpg
3_deformable_detr,fold_6,2,1,0,1,-1,IMG_3848_JPG.rf.6bccac66dae879c76b4ff16dd5be0243.jpg
3_deformable_detr,fold_6,4,2,2,0,-2,0230512_145343_jpg.rf.fcd20fb05b55e0279971dbad416be7a2.jpg
3_deformable_detr,fold_6,5,2,2,0,-3,IMG_4092_JPG.rf.3e9ac49e2c6b51adac2c75ecdf6ebc5b.jpg
3_deformable_detr,fold_6,5,6,2,4,1,20230512_150110_jpg.rf.36e77e8ab39d8ce0cccdd59c9e84ceca.jpg
3_deformable_detr,fold_6,2,2,2,0,0,IMG_20230512_150928_jpg.rf.713e71e29e1ae02d5cdba88b3134bae9.jpg
3_deformable_detr,fold_6,3,1,1,0,-2,230512_150127_jpg.rf.85daac8693c9a5866ff2f7839d81d2e8.jpg
3_deformable_detr,fold_6,2,3,2,1,1,20230512_145048_jpg.rf.6202c446935381c48cf520aa5c6640f6.jpg
3_deformable_detr,fold_6,16,1,0,1,-15,IMG_3930_JPG.rf.7a6e996e69e203ed4aa5de3126a2d2ee.jpg
3_deformable_detr,fold_6,10,10,9,1,0,20230512_152223_jpg.rf.9ee2de301ef5a2a10d57b30f309a7d84.jpg
3_deformable_detr,fold_6,7,5,5,0,-2,IMG_4057_JPG.rf.62dc219aee41c1e1eeb47a2bd511e5f0.jpg
3_deformable_detr,fold_6,29,9,9,0,-20,0512_150154_jpg.rf.6ab493c468717275a5b2b74420a88180.jpg
3_deformable_detr,fold_6,13,11,9,2,-2,IMG_20230512_153036_jpg.rf.92b3c0599c74bfff25f17f2e97011b27.jpg
3_deformable_detr,fold_6,4,5,4,1,1,0230512_145357_jpg.rf.bb3b0c47d3344c5f0714c51d50f9eab8.jpg
3_deformable_detr,fold_6,6,6,6,0,0,20230512_145337_jpg.rf.eb0881ecd757c868e839b7663c8ec930.jpg
3_deformable_detr,fold_6,1,0,0,0,-1,230512_150306_jpg.rf.57428899933c6b401506a61768585669.jpg
3_deformable_detr,fold_6,3,2,2,0,-1,20230512_151543_jpg.rf.10d24602404882d9cc93169ca45912de.jpg
3_deformable_detr,fold_6,101,17,15,2,-84,0108_jpg.rf.e585b32f135131ce6476b6962a9dbad4.jpg
3_deformable_detr,fold_6,18,15,14,1,-3,20230512_152242_jpg.rf.db9cf140b85724a386050e2debe57fa2.jpg
3_deformable_detr,fold_6,8,9,7,2,1,20230512_145153_jpg.rf.31de3120042ffe1cc96af5b129c48c8d.jpg
3_deformable_detr,fold_6,2,2,2,0,0,20230512_151240_jpg.rf.d86e0b8b1457d5a8b4c4c2db8c1e9b84.jpg
3_deformable_detr,fold_6,2,2,2,0,0,20230512_145338_jpg.rf.210a3a3cfad0b0ee89036fcc677c1076.jpg
3_deformable_detr,fold_6,4,4,4,0,0,IMG_4094_JPG.rf.fc1f6e86b3b032266a05b3508e461113.jpg
3_deformable_detr,fold_6,2,2,2,0,0,IMG_20230512_151944_jpg.rf.d5aeefc60fa0f36a43c0496ef0aef803.jpg
3_deformable_detr,fold_6,3,3,3,0,0,20230512_145339_jpg.rf.bf7369afe55b64f770770e2bc84385eb.jpg
3_deformable_detr,fold_6,18,12,12,0,-6,IMG_20230512_152305_jpg.rf.12f543505870e65321b9087ee0584124.jpg
3_deformable_detr,fold_6,2,2,1,1,0,IMG_4025_JPG.rf.8d3de7ea571de848fc149e176c6897c3.jpg
3_deformable_detr,fold_6,1,1,1,0,0,20230512_151505-0-_jpg.rf.55f9872a1224dfaeaf8fca6da2616e98.jpg
3_deformable_detr,fold_6,20,8,6,2,-12,IMG_20230512_150212_422_jpg.rf.e76cd69c3a527a0ab898b69fef489876.jpg
3_deformable_detr,fold_6,6,5,4,1,-1,20230512_150139_jpg.rf.84eb5a1f5ed3efe7d09bc7dd51a476e8.jpg
3_deformable_detr,fold_6,2,1,1,0,-1,20230512_145013_jpg.rf.5b923d696845fee91efca209fb16b8b7.jpg
3_deformable_detr,fold_6,2,2,2,0,0,20230512_153004_jpg.rf.362642eaeb26a8549f4da1202eebd478.jpg
3_deformable_detr,fold_6,15,10,9,1,-5,20230512_153313_jpg.rf.77943aee7a7bf04a3db49e3f4dc00814.jpg
3_deformable_detr,fold_6,1,1,1,0,0,20230512_153355_jpg.rf.8223bc454d4e607609c33d5982f02df2.jpg
3_deformable_detr,fold_6,11,4,4,0,-7,20230512_151544_jpg.rf.3baf349b8c061da5ae2bbe4333bd3506.jpg
3_deformable_detr,fold_6,4,5,4,1,1,IMG_20230512_151443_jpg.rf.72eb3bb7a6af81a16f5db60357cc4e37.jpg
3_deformable_detr,fold_6,18,14,14,0,-4,IMG_20230512_152317_jpg.rf.7f9c7624fac8ec2441ebdd0d2ba16ec5.jpg
3_deformable_detr,fold_6,3,2,2,0,-1,IMG_20230512_145132_jpg.rf.d215e294ca9ff5ec89558b9b78083b48.jpg
3_deformable_detr,fold_6,2,2,2,0,0,0230512_145400_jpg.rf.2839dc03d44af92c89a92bc7b644ab85.jpg
3_deformable_detr,fold_6,1,1,1,0,0,20230512_150224_jpg.rf.f64a4cfe331fa0a225b85de2782b4b40.jpg
3_deformable_detr,fold_6,1,2,1,1,1,IMG_20230512_151810_jpg.rf.82616c1ceb56e348dbbddc1a08161690.jpg
3_deformable_detr,fold_6,1,1,1,0,0,20230512_145333_jpg.rf.afbd586b0c1d9f54c3d3ea178568eb9d.jpg
3_deformable_detr,fold_6,5,3,2,1,-2,230512_150144_jpg.rf.17c847f6562b5ceb1d19a0239be452dc.jpg
3_deformable_detr,fold_6,5,5,3,2,0,20230512_153523_jpg.rf.94e20d7417dcd4856650e05b3a708e35.jpg
3_deformable_detr,fold_6,17,12,12,0,-5,IMG_20230512_152414_jpg.rf.2a84950ae556ac2909c0e739dbdb963e.jpg
3_deformable_detr,fold_6,7,7,7,0,0,IMG_4101_JPG.rf.8c4f8e4e10187eb9df93264151a1ed8d.jpg
3_deformable_detr,fold_6,4,1,0,1,-3,230512_145050_jpg.rf.c9c628742a57d86b1f31849454a8559b.jpg
3_deformable_detr,fold_6,2,2,2,0,0,20230512_151702_jpg.rf.0456f0fe756386f89c4b23d655ea901b.jpg
3_deformable_detr,fold_6,13,7,4,3,-6,20230512_150113_jpg.rf.3a5a13ac96bac5c0e6e2c49bc83c904b.jpg
3_deformable_detr,fold_6,11,11,7,4,0,20230512_151044_jpg.rf.bd2efab172db3bb0ca6ce2ff37f6a8ca.jpg
3_deformable_detr,fold_6,3,2,2,0,-1,20230512_145339-0-_jpg.rf.fea54fcbceb00e71f078268b9b40d178.jpg
3_deformable_detr,fold_6,1,0,0,0,-1,20230512_150234_jpg.rf.f07768807cd91c66efa0a831a47227f2.jpg
3_deformable_detr,fold_6,1,1,1,0,0,20230512_152328_jpg.rf.2ee5fc7202b8e73c23dedf7899bfd23d.jpg
3_deformable_detr,fold_6,1,1,1,0,0,20230512_150736_jpg.rf.86dffaa733e76af31361da63d1f9c5be.jpg
3_deformable_detr,fold_6,1,1,1,0,0,IMG_20230512_151152_632_jpg.rf.e78de54f18056ed239e1e53f8b27b606.jpg
3_deformable_detr,fold_6,1,1,1,0,0,IMG_20230512_145000_jpg.rf.08a86ebaadb5647031d884039f76ad3d.jpg
3_deformable_detr,fold_6,5,5,5,0,0,MG_20230512_145246_jpg.rf.c35a60cd9e1280159604c5915a9e199e.jpg
3_deformable_detr,fold_6,1,1,1,0,0,20230512_151222_jpg.rf.77904cc81033fc2ad3a414b07b9c1b2e.jpg
3_deformable_detr,fold_6,14,10,8,2,-4,IMG_20230512_145147_jpg.rf.8cac9a120dccf5b1ce92992c1c714c4d.jpg
3_deformable_detr,fold_6,18,7,7,0,-11,0201_jpg.rf.517ca1ec56a693f7c628bd07b5acdfc2.jpg
3_deformable_detr,fold_6,1,1,1,0,0,20230512_151615_jpg.rf.3d0f727d5e2b61ba73995558758dffb3.jpg
3_deformable_detr,fold_6,6,6,6,0,0,IMG_4097_JPG.rf.4f85a4c675f81cdca11f141abb8d7c2d.jpg
3_deformable_detr,fold_6,2,3,2,1,1,20230512_151705-0-_jpg.rf.3ca3d09e046dc693a1fb88dca9ebaa3b.jpg
3_deformable_detr,fold_6,2,1,0,1,-1,20230512_153408_jpg.rf.b5d7a9cb1b0260613799e2d57092c4ec.jpg
3_deformable_detr,fold_6,1,3,1,2,2,IMG_20230512_151127_629_jpg.rf.f41df076266191a6a8a7eca7b189e061.jpg
3_deformable_detr,fold_6,1,1,1,0,0,0028_jpg.rf.2103488effe87e7c2da4cf07f6ed7f75.jpg
3_deformable_detr,fold_6,4,3,3,0,-1,IMG_4054_JPG.rf.c3d803491fea4d419a745a606ab372e6.jpg
3_deformable_detr,fold_6,6,5,5,0,-1,0061_jpg.rf.9c87cf09deaf73a61f5ac233c2bdb702.jpg
3_deformable_detr,fold_6,1,1,1,0,0,20230512_145032_jpg.rf.a2eb942256aef666c2ddc91b6c22b7a5.jpg
3_deformable_detr,fold_6,1,1,1,0,0,20230512_145138_jpg.rf.04549600bf4eee12b13c6119d3c35a78.jpg
3_deformable_detr,fold_6,3,3,2,1,0,20230512_150019_jpg.rf.3831013b1b3289f609c139cb5b3ee2d0.jpg
3_deformable_detr,fold_6,5,3,3,0,-2,IMG_20230512_151248_jpg.rf.fd83e7f5d0f84675cb06da482f588b3b.jpg
3_deformable_detr,fold_6,1,1,1,0,0,20230512_150810_jpg.rf.ca47a1fafa212b60e926b93e5eb8674b.jpg
3_deformable_detr,fold_6,5,4,3,1,-1,20230512_145436_jpg.rf.f86063716cf890f2f2412ed2bc009f84.jpg
3_deformable_detr,fold_6,12,7,4,3,-5,20230512_150103_jpg.rf.7c63165e8e1129a671cb603fa47109d8.jpg
3_deformable_detr,fold_6,1,1,1,0,0,0019_jpg.rf.f929e8c0a480b1ec40d48ffa32427490.jpg
3_deformable_detr,fold_6,15,9,8,1,-6,20230512_151327_jpg.rf.d5fc64b9888dff7235c7da7317d07fc0.jpg
3_deformable_detr,fold_6,15,10,9,1,-5,20230512_145239_jpg.rf.36d4ca0350293c4011bd19f94bc7867d.jpg
3_deformable_detr,fold_6,9,9,8,1,0,IMG_20230512_151048_jpg.rf.c92aa7d50112ca96c1f3bdd418f74d1c.jpg
3_deformable_detr,fold_6,1,2,1,1,1,IMG_3917_JPG.rf.7696994544924bd6d81ad9d1ace3f843.jpg
3_deformable_detr,fold_6,5,5,5,0,0,20230512_150057_jpg.rf.8739eeb8744698e06d085991ee1483d5.jpg
3_deformable_detr,fold_6,7,8,7,1,1,IMG_20230512_151223_jpg.rf.af08f6dc665fcecd42728873d339f65f.jpg
3_deformable_detr,fold_6,9,8,7,1,-1,IMG_20230512_145259_jpg.rf.655fa0eaa10935cb21a8b2452c556c92.jpg
3_deformable_detr,fold_6,2,0,0,0,-2,IMG_20230512_145024_jpg.rf.48184e0191f6dc0deaabedad53f15496.jpg
3_deformable_detr,fold_6,13,11,9,2,-2,IMG_20230512_152228_454_jpg.rf.41bea2902570b7445e0f1ec3abc4a012.jpg
3_deformable_detr,fold_6,3,1,1,0,-2,230512_150042_jpg.rf.333656aaee32bab812e48513c9f469d1.jpg
3_deformable_detr,fold_6,2,1,1,0,-1,20230512_145431_jpg.rf.026561e5d2d5a23868267be144014c1a.jpg
3_deformable_detr,fold_6,2,1,1,0,-1,IMG_4029_JPG.rf.5a655364af1d770d5e464fd022215d30.jpg
3_deformable_detr,fold_7,12,10,10,0,-2,IMG_20230512_152242_316_jpg.rf.640eb728992e501ad35261a525ddcd6f.jpg
3_deformable_detr,fold_7,21,9,8,1,-12,20230512_153312_jpg.rf.9bc8be12c2f1c3b853b5dd7ce2de2445.jpg
3_deformable_detr,fold_7,1,1,1,0,0,IMG_4043_JPG.rf.3fd3ae2706b1bd88e07090f3f20fe829.jpg
3_deformable_detr,fold_7,1,1,1,0,0,20230512_145250_jpg.rf.effdab3112b728049f9a595e68cc1fbe.jpg
3_deformable_detr,fold_7,2,2,1,1,0,IMG_3845_JPG.rf.99db8c1cc5267eb444c95ebe84cd88ba.jpg
3_deformable_detr,fold_7,2,2,2,0,0,20230512_151759-0-_jpg.rf.9397d17b6e9b50b8b3327c1f6e7e4e13.jpg
3_deformable_detr,fold_7,23,13,13,0,-10,20230512_153047_jpg.rf.c2e7222d0e6d439a279014b9de708707.jpg
3_deformable_detr,fold_7,1,1,1,0,0,IMG_20230512_144936_jpg.rf.02a75ef0c1666837558e6b5e99086463.jpg
3_deformable_detr,fold_7,4,3,3,0,-1,IMG_20230512_145250_052_jpg.rf.22501a15b7ee521908502f0562f1943b.jpg
3_deformable_detr,fold_7,1,0,0,0,-1,IMG_20230512_151943_jpg.rf.245470432c5353d43170f1aa8d72aa47.jpg
3_deformable_detr,fold_7,15,13,10,3,-2,20230512_152312_jpg.rf.27e0a448e297ab33c52fb903a0a61757.jpg
3_deformable_detr,fold_7,22,11,9,2,-11,IMG_20230512_150103_jpg.rf.0a6f19ce6332956f8b29791a9f2bfd27.jpg
3_deformable_detr,fold_7,18,3,3,0,-15,20230512_150003_jpg.rf.4bee1a84712696acd3c6434f86ac8310.jpg
3_deformable_detr,fold_7,3,5,3,2,2,20230512_150158_jpg.rf.38b8f697e558e1ec0f9c87c946a7c86d.jpg
3_deformable_detr,fold_7,3,3,3,0,0,20230512_145319_jpg.rf.cd5fadb6c5fddffa67d73b8b37272f64.jpg
3_deformable_detr,fold_7,30,4,4,0,-26,20230512_150004_jpg.rf.495dbb753fb5fd527e14101c52213803.jpg
3_deformable_detr,fold_7,1,1,1,0,0,20230512_151613_jpg.rf.e0b45cee6190ca8866233157c4462548.jpg
3_deformable_detr,fold_7,0,34,0,34,34,IMG_20230512_150254_jpg.rf.a5c0f01d411bde413dbb553e6557c16f.jpg
3_deformable_detr,fold_7,2,1,0,1,-1,IMG_20230512_145306_094_jpg.rf.09cc5cc7fd6ffa704dffb84466385562.jpg
3_deformable_detr,fold_7,16,14,13,1,-2,20230512_152241_jpg.rf.9b0739a668aaaecd1a1d3e7bf8b2688f.jpg
3_deformable_detr,fold_7,1,1,1,0,0,20230512_145417_jpg.rf.db3be61a74c7e02c4d1054b72f46745b.jpg
3_deformable_detr,fold_7,7,6,6,0,-1,20230512_151546_jpg.rf.650e7a29638d0dabdf27fcfefcab07cb.jpg
3_deformable_detr,fold_7,3,4,3,1,1,20230512_152322_jpg.rf.53fd89be056ce49374a18ace4aa4f447.jpg
3_deformable_detr,fold_7,2,2,2,0,0,20230512_150824_jpg.rf.9590430380cde837c5b86f877c2bf080.jpg
3_deformable_detr,fold_7,1,0,0,0,-1,20230512_151604_jpg.rf.39e93e2b60bed55a4fb26d60d17f81ce.jpg
3_deformable_detr,fold_7,6,7,6,1,1,20230512_152250_jpg.rf.0c23d9c9105722daa1a62bbed8129065.jpg
3_deformable_detr,fold_7,10,8,8,0,-2,20230512_153314_jpg.rf.fdc2e0650616a2e23fae79ddbc6b98bb.jpg
3_deformable_detr,fold_7,1,1,1,0,0,20230512_151540_jpg.rf.6fc0f7a0e69e619bbef3fea84a825105.jpg
3_deformable_detr,fold_7,9,6,1,5,-3,IMG_20230512_150115_jpg.rf.93d6ec31991ffdb896e9bf82280f1f99.jpg
3_deformable_detr,fold_7,19,9,8,1,-10,20230512_150010_jpg.rf.620f860344c0524a1ea0d2095e555387.jpg
3_deformable_detr,fold_7,1,1,1,0,0,0230512_145318_jpg.rf.98f8a12ed2e48f7e62edcc542f5a7a3b.jpg
3_deformable_detr,fold_7,9,7,7,0,-2,20230512_151513_jpg.rf.9ba62843997a0b42cb30d66d35cfe761.jpg
3_deformable_detr,fold_7,2,2,2,0,0,20230512_145051_jpg.rf.603261488d01ac12c49ce95447252a07.jpg
3_deformable_detr,fold_7,3,3,2,1,0,20230512_151745_jpg.rf.26e57cd112d09282bbedc612b9e3bddc.jpg
3_deformable_detr,fold_7,29,22,18,4,-7,IMG_20230512_150104_jpg.rf.d5cb8950b8524a6e8b69b37121f816be.jpg
3_deformable_detr,fold_7,11,10,9,1,-1,IMG_20230512_151854_jpg.rf.96120163430ff0d69f2a3b4c65cf13be.jpg
3_deformable_detr,fold_7,1,1,1,0,0,20230512_151443_jpg.rf.02c0d1f9196b0a7db17357b113fa32ed.jpg
3_deformable_detr,fold_7,4,4,4,0,0,0059_jpg.rf.9ac56781472ffe9dda122b176baf1512.jpg
3_deformable_detr,fold_7,8,7,7,0,-1,IMG_20230512_145441_jpg.rf.6b7c2d8bfc0ced9198b112d0d6ade7e2.jpg
3_deformable_detr,fold_7,11,7,5,2,-4,20230512_145235_jpg.rf.7588a0153c1b25a775a82b15cb976f2d.jpg
3_deformable_detr,fold_7,1,1,1,0,0,IMG_20230512_151147_269_jpg.rf.6170f9ba05705d7d45cbb1c21073f67c.jpg
3_deformable_detr,fold_7,3,2,1,1,-1,20230512_150145_jpg.rf.8935abf1c95d41b2b953913a4d6f31f7.jpg
3_deformable_detr,fold_7,14,10,9,1,-4,IMG_20230512_152216_096_jpg.rf.adf03897848531ce89d004439a8fa974.jpg
3_deformable_detr,fold_7,13,11,6,5,-2,IMG_20230512_150128_jpg.rf.4b6044488f522150e791a223d8868723.jpg
3_deformable_detr,fold_7,15,14,12,2,-1,20230512_151529_jpg.rf.13e844f081c4efeefda4af063187f6d3.jpg
3_deformable_detr,fold_7,1,1,1,0,0,20230512_151036_jpg.rf.f3b838a0faab4c3495dd44281c87539d.jpg
3_deformable_detr,fold_7,1,2,1,1,1,IMG_20230512_150926_jpg.rf.592b75864e594302b259312be28a0792.jpg
3_deformable_detr,fold_7,6,3,2,1,-3,IMG_20230512_150317_jpg.rf.ac25b1898213749cb0686c2bc3130301.jpg
3_deformable_detr,fold_7,4,2,2,0,-2,0004_jpg.rf.cad1f4f7c2a5a911d6d1cdfa5f75d055.jpg
3_deformable_detr,fold_7,6,2,2,0,-4,20230512_150135_jpg.rf.d4fd2dcfb498280a8309f6f9fbf3b816.jpg
3_deformable_detr,fold_7,11,7,7,0,-4,IMG_20230512_151556_798_jpg.rf.64e451fae797a84c7394203ef45fb0a5.jpg
3_deformable_detr,fold_7,13,11,8,3,-2,IMG_20230512_152158_858_jpg.rf.1a8b5fd8c9168917604cd153b5720b1d.jpg
3_deformable_detr,fold_7,37,16,14,2,-21,0512_150144_jpg.rf.eb6f48f566e7b2e533d3c169bb9783b0.jpg
3_deformable_detr,fold_7,1,1,1,0,0,20230512_151643_jpg.rf.cd8dd51a7f1332798879f4e5d7e928f6.jpg
3_deformable_detr,fold_7,3,0,0,0,-3,20230512_150301_jpg.rf.9f5a1e2491eb0f23ad2976622defdd66.jpg
3_deformable_detr,fold_7,1,2,1,1,1,20230512_145434_jpg.rf.c6e724cc40d69fabc8ce6dc7f102385b.jpg
3_deformable_detr,fold_7,3,2,2,0,-1,0230512_145050_jpg.rf.2803b267b643801d5d6b63fa2d927f37.jpg
3_deformable_detr,fold_7,1,1,1,0,0,IMG_20230512_144948_jpg.rf.982c926a32fe1a245ffd566259fcb9bb.jpg
3_deformable_detr,fold_7,6,5,5,0,-1,20230512_152308_jpg.rf.bfaaf2477f56005e5db4ac2d8a0dd0a7.jpg
3_deformable_detr,fold_7,1,0,0,0,-1,20230512_144954_jpg.rf.b91c4aef38ae9c4f6e5c0bcc155cdbb9.jpg
3_deformable_detr,fold_7,2,0,0,0,-2,20230512_145012_jpg.rf.7e7325fc33c5f9d9c92a4f4f8c48bd73.jpg
3_deformable_detr,fold_7,3,3,3,0,0,20230512_151626_jpg.rf.ce9aac74e8994e1b51e9f517df6a0830.jpg
3_deformable_detr,fold_7,6,5,4,1,-1,IMG_20230512_145241_jpg.rf.298cf145f167e685da520bffba4d53a8.jpg
3_deformable_detr,fold_7,4,3,3,0,-1,20230512_151307_jpg.rf.21fca3895ba4bf60b18eb9cd32d76ed9.jpg
3_deformable_detr,fold_7,8,5,1,4,-3,20230512_150035_jpg.rf.590e7ece3e6e94d92163049b218f2085.jpg
3_deformable_detr,fold_7,11,7,6,1,-4,20230512_144943_jpg.rf.6e882f14ce6985046782f1fb925495d2.jpg
3_deformable_detr,fold_7,1,1,0,1,0,20230512_151231_jpg.rf.4dc10049f8ecfe04ad41c2d1b1428792.jpg
3_deformable_detr,fold_7,46,26,22,4,-20,20230512_153213_jpg.rf.9ee2b7f723899fca4419bd4e0c4eec72.jpg
3_deformable_detr,fold_7,16,10,9,1,-6,IMG_20230512_153426_jpg.rf.13530953faa743fa6763be6d0ab583af.jpg
3_deformable_detr,fold_7,2,1,1,0,-1,20230512_151459_jpg.rf.b5fc6223eb6e9549a2bed14367997348.jpg
3_deformable_detr,fold_7,5,5,3,2,0,IMG_20230512_145052_jpg.rf.1f1d0e8ea8a62acdeb924c64ae560628.jpg
3_deformable_detr,fold_7,1,1,1,0,0,20230512_152330_jpg.rf.d9a6f6c4784e57ad912b6182a3fd0211.jpg
3_deformable_detr,fold_7,1,1,1,0,0,0017_jpg.rf.324871efad4024d500a23b82191808a8.jpg
3_deformable_detr,fold_7,1,1,1,0,0,IMG_20230512_150908_jpg.rf.753a3cfb7ff38bc8300418f88dbf331c.jpg
3_deformable_detr,fold_7,2,2,2,0,0,20230512_151703_jpg.rf.2faae265964e4a8dd7c48f882318b9e2.jpg
3_deformable_detr,fold_7,5,4,4,0,-1,20230512_151812_jpg.rf.4e67fe81dff51295403e0c06c0621c2f.jpg
3_deformable_detr,fold_7,1,1,0,1,0,20230512_153218_jpg.rf.64a3b9a40868420e3930fa153e76d395.jpg
3_deformable_detr,fold_7,13,13,13,0,0,20230512_153010_jpg.rf.b8501fc8a709517e34e7cb69002aa015.jpg
3_deformable_detr,fold_7,17,12,12,0,-5,0038_jpg.rf.3f55cd3c03a14d11b3849a2a910a3773.jpg
3_deformable_detr,fold_7,1,1,1,0,0,20230512_145247_jpg.rf.9d204b8a475593430db82a060e2456d1.jpg
3_deformable_detr,fold_7,9,10,8,2,1,20230512_151909_jpg.rf.aead0419a0a121c39fda16a03595ab78.jpg
3_deformable_detr,fold_7,13,8,7,1,-5,20230512_153312-0-_jpg.rf.8f1668ec1eddb4c37aa8c4c6b04cdd81.jpg
3_deformable_detr,fold_7,2,2,2,0,0,0002_jpg.rf.11a670be82fdde02b205d9929f761ed7.jpg
3_deformable_detr,fold_7,17,7,5,2,-10,20230512_150002_jpg.rf.264d90b8bb0bb75c8bbe433b3c221545.jpg
3_deformable_detr,fold_7,12,9,9,0,-3,20230512_150200_jpg.rf.2582038eca240736fe94eb2ed6cae31e.jpg
3_deformable_detr,fold_7,7,6,4,2,-1,20230512_150042_jpg.rf.613029bfbedc91e536387ccf8df16dd0.jpg
3_deformable_detr,fold_7,2,2,2,0,0,20230512_152249_jpg.rf.04c1bebce986183bedd854bb677da384.jpg
3_deformable_detr,fold_7,2,2,2,0,0,20230512_151701_jpg.rf.819108571877bfd9f9063c78d807263f.jpg
3_deformable_detr,fold_7,13,9,7,2,-4,IMG_20230512_145142_jpg.rf.fb2156626619cc38cf3127f70d63b5f0.jpg
3_deformable_detr,fold_7,10,8,7,1,-2,20230512_145209_jpg.rf.2f0dfe951cb0a7165c942a2117e73f0d.jpg
3_deformable_detr,fold_7,2,0,0,0,-2,20230512_145136_jpg.rf.852bd73d66d536a7a4ffbed448466961.jpg
3_deformable_detr,fold_7,5,4,4,0,-1,IMG_20230512_151217_jpg.rf.04d3195207b1eb7346b1ba52c101a706.jpg
3_deformable_detr,fold_7,8,6,6,0,-2,20230512_153130_jpg.rf.9b7bb97006640f6490a71f226200a2ca.jpg
3_deformable_detr,fold_7,2,2,2,0,0,20230512_151638_jpg.rf.a0292d546f8d78bd93a8e0b8e16cdcad.jpg
3_deformable_detr,fold_7,17,14,13,1,-3,20230512_150154_jpg.rf.89a63f38c3d9a5091806e13ec9a0b9d0.jpg
3_deformable_detr,fold_7,8,7,7,0,-1,20230512_151851-0-_jpg.rf.fb46950ff8ddbfa6d4406784eb5e22b5.jpg
3_deformable_detr,fold_7,33,11,8,3,-22,IMG_20230512_150352_jpg.rf.c1ca8bf250991c89b762984231b93a22.jpg
3_deformable_detr,fold_7,9,5,5,0,-4,230512_150136_jpg.rf.1e2f1e90c67eb7b8f01703f120072671.jpg
3_deformable_detr,fold_7,2,1,1,0,-1,0230512_145303_jpg.rf.48b2ec4c0dbde15f8f5f8b3bd2b59378.jpg
3_deformable_detr,fold_7,1,1,1,0,0,20230512_151014_jpg.rf.1daaabfd079316b6b36cd3f076521079.jpg
3_deformable_detr,fold_7,7,6,6,0,-1,20230512_150115_jpg.rf.1e159ea5bb7c2543a1928c133ef9b549.jpg
3_deformable_detr,fold_7,1,1,1,0,0,20230512_151753_jpg.rf.a14249ba89cecfaa73e632b588efdfd7.jpg
3_deformable_detr,fold_7,2,2,2,0,0,20230512_151637_jpg.rf.a44f9c09520025824affd7d45589da18.jpg
3_deformable_detr,fold_7,9,9,9,0,0,20230512_152217_jpg.rf.a958863ea2bb344fee3c8c7b29889838.jpg
3_deformable_detr,fold_7,2,1,1,0,-1,MG_20230512_145032_jpg.rf.043a11012a2a8dcb1cee1fc40482b97d.jpg
3_deformable_detr,fold_7,6,5,5,0,-1,IMG_3831_JPG.rf.5b9e206f11628659b685b91001a564e0.jpg
3_deformable_detr,fold_7,10,7,7,0,-3,IMG_20230512_150826_018_jpg.rf.6cdf008f2fd91c8d5a59ecb707eb0a93.jpg
3_deformable_detr,fold_7,8,8,8,0,0,IMG_4096_JPG.rf.8be1b70c0cb24617e853855e4e345ebe.jpg
3_deformable_detr,fold_7,7,5,5,0,-2,0047_jpg.rf.f81c0ac4631d37256a41aa0d36e49744.jpg
3_deformable_detr,fold_7,8,6,6,0,-2,IMG_20230512_151221_jpg.rf.1eaad9c5a6a8acb495445f202d82d696.jpg
3_deformable_detr,fold_7,2,2,1,1,0,230512_150056_jpg.rf.63fc419be91fa960c9fdd540582bc424.jpg
3_deformable_detr,fold_7,1,1,1,0,0,20230512_145435_jpg.rf.0381cab4fa18f72340c2377d16cc9660.jpg
3_deformable_detr,fold_7,21,1,1,0,-20,IMG_20230512_153447_jpg.rf.f9b2e4987e37b091be6072cae946d663.jpg
3_deformable_detr,fold_7,14,6,5,1,-8,20230512_150101_jpg.rf.cc96a2d607d78ec899d39fd65e3ffcef.jpg
3_deformable_detr,fold_7,5,6,4,2,1,0230512_145402_jpg.rf.b34ea25b1c9ac3f7cc8061e80027c857.jpg
3_deformable_detr,fold_7,11,9,6,3,-2,IMG_20230512_145018_jpg.rf.d1613b46f617939d055c5b8c109e9fa3.jpg
3_deformable_detr,fold_7,3,1,1,0,-2,IMG_20230512_145338_jpg.rf.079f726ce175cc710ca12b4c3caa612c.jpg
3_deformable_detr,fold_7,6,5,5,0,-1,20230512_145402_jpg.rf.2adab9c4657dc31e00e7139d61d9500a.jpg
3_deformable_detr,fold_7,11,11,11,0,0,0046_jpg.rf.e1528b2cf27767ce9998ebd79d287f47.jpg
3_deformable_detr,fold_7,1,1,1,0,0,0023_jpg.rf.816619f3269b0637f700332186be4dc7.jpg
3_deformable_detr,fold_7,5,4,4,0,-1,IMG_3994_JPG.rf.3f53434cd9176d3f8187cface46b0ee0.jpg
3_deformable_detr,fold_7,6,5,4,1,-1,20230512_150209_jpg.rf.386fa5331924ef6713a22c58b720e320.jpg
3_deformable_detr,fold_7,5,3,3,0,-2,230512_150029_jpg.rf.12bae245124889830af4fc74e9e52dc8.jpg
3_deformable_detr,fold_7,4,3,3,0,-1,20230512_152303_jpg.rf.51286f7b0969a38d9408ce913d70bf49.jpg
3_deformable_detr,fold_7,5,5,5,0,0,20230512_145222_jpg.rf.fd35bc6270e794e1ad0a42037bded3b6.jpg
3_deformable_detr,fold_7,9,7,7,0,-2,20230512_151906_jpg.rf.898831e6903935bdc29051a4dc1aec5d.jpg
3_deformable_detr,fold_7,40,19,18,1,-21,IMG_20230512_153257_jpg.rf.d9dc811045c5a29bd9426b22f724b734.jpg
3_deformable_detr,fold_7,3,3,3,0,0,20230512_151140_jpg.rf.7db6428b7e2bbbef7dd568e63b356863.jpg
3_deformable_detr,fold_7,1,1,1,0,0,IMG_20230512_153421_jpg.rf.6158f971c571c6c40a9f73c5154fea7e.jpg
3_deformable_detr,fold_7,3,2,2,0,-1,IMG_3991_JPG.rf.956960577cc9ffaab083d7a4f4c5bd11.jpg
3_deformable_detr,fold_7,10,4,3,1,-6,20230512_150040_jpg.rf.aa50ac3e2a5a2042940711140afd2b9a.jpg
3_deformable_detr,fold_7,1,1,1,0,0,20230512_151227_jpg.rf.27d11f08dc002dbce0c7ab80e18ba38a.jpg
3_deformable_detr,fold_7,4,3,3,0,-1,IMG_20230512_151208_jpg.rf.be5e6b4532e99f11dd349cc77c5094ca.jpg
3_deformable_detr,fold_7,1,1,1,0,0,IMG_20230512_150835_jpg.rf.5163b3bd6692963a73a0e71f347963cd.jpg
3_deformable_detr,fold_7,1,1,1,0,0,20230512_153356_jpg.rf.4d48f88351e5397a697a75c05a09f970.jpg
3_deformable_detr,fold_7,2,3,2,1,1,20230512_151054_jpg.rf.7c0b5c7091bc1f6a8f74bc553c645583.jpg
3_deformable_detr,fold_7,8,5,5,0,-3,20230512_151856_jpg.rf.e796d63958aed52d331329de4229f784.jpg
3_deformable_detr,fold_7,42,18,11,7,-24,20230512_150217_jpg.rf.43a34e583d3360fb03c78ebcf6334f2b.jpg
3_deformable_detr,fold_7,1,0,0,0,-1,20230512_151616_jpg.rf.319cd6543513a0db4c94621f3c78c207.jpg
3_deformable_detr,fold_7,1,1,1,0,0,20230512_145235_jpg.rf.609ee666fef18c181192a729599f029f.jpg
3_deformable_detr,fold_7,17,6,5,1,-11,IMG_20230512_150105_jpg.rf.570debb8303e1ced483c9d4a2731ffec.jpg
3_deformable_detr,fold_7,15,12,12,0,-3,IMG_20230512_153006_493_jpg.rf.8cb0e9085e5e5a8d382f8e2647075293.jpg
3_deformable_detr,fold_7,1,2,1,1,1,20230512_151335_jpg.rf.28b2031d23e55f8020b7aa20b9efc752.jpg
3_deformable_detr,fold_7,1,1,1,0,0,IMG_20230512_145233_jpg.rf.d273d9a04013a4fdb680069c5f2e4780.jpg
3_deformable_detr,fold_7,1,2,1,1,1,IMG_3841_JPG.rf.adc4a928f5d56c89691b1d5525a2cb06.jpg
3_deformable_detr,fold_7,23,14,9,5,-9,20230512_150127_jpg.rf.f6e969d7228c49f8b298a15c5ea0d88d.jpg
3_deformable_detr,fold_7,8,6,0,6,-2,20230512_150319_jpg.rf.71d19e64b856b04c9ab111407595de18.jpg
3_deformable_detr,fold_7,8,6,6,0,-2,20230512_151037_jpg.rf.85e4a64b3db494811f84775d729cc9e7.jpg
3_deformable_detr,fold_7,1,1,1,0,0,IMG_4393_JPG.rf.47566015c2485f15e5114808d8a0d4ed.jpg
3_deformable_detr,fold_7,2,1,1,0,-1,IMG_20230512_151816_jpg.rf.8fba275d23a787980bb56f34532a5efd.jpg
3_deformable_detr,fold_7,6,7,6,1,1,20230512_151851_jpg.rf.96579435ffaa9d451e63a406f34fab4e.jpg
3_deformable_detr,fold_7,3,3,3,0,0,IMG_4388_JPG.rf.1ddaadb8d3afe73ea7e33c9a29acec1e.jpg
3_deformable_detr,fold_7,19,11,9,2,-8,IMG_20230512_150059_992_jpg.rf.b49a36b89c3ed0b8925e2ad7f1b905b9.jpg
3_deformable_detr,fold_7,13,6,6,0,-7,230512_150153_jpg.rf.fb4c5b04651624464aee8747090f6cee.jpg
3_deformable_detr,fold_7,9,6,4,2,-3,20230512_150329_jpg.rf.fd5367a6796a2fc3f0181a6e4c4b9513.jpg
3_deformable_detr,fold_7,1,0,0,0,-1,230512_150122_jpg.rf.d2ef84171022dfe6b7f85166ab202b72.jpg
3_deformable_detr,fold_7,6,5,5,0,-1,IMG_20230512_151041_jpg.rf.eda52b9119a16dac9d1d2632ea4d34bd.jpg
3_deformable_detr,fold_8,26,16,15,1,-10,20230512_153257_jpg.rf.b0ed75a4fd63f8fa4923e04bdb1c38e2.jpg
3_deformable_detr,fold_8,7,6,6,0,-1,20230512_152257_jpg.rf.25eef75e9cfc61b58dc03da8328d53ad.jpg
3_deformable_detr,fold_8,9,8,7,1,-1,230512_150137_jpg.rf.a07a63205732aea6ea773793a5a4e25c.jpg
3_deformable_detr,fold_8,2,2,2,0,0,IMG_20230512_145254_jpg.rf.dfd1ca61f82842fe96ba39de8974f5d4.jpg
3_deformable_detr,fold_8,13,9,7,2,-4,20230512_150244_jpg.rf.1ef934795ff31c5b43b6da861b2ac051.jpg
3_deformable_detr,fold_8,4,3,1,2,-1,IMG_20230512_145320_405_jpg.rf.143f083c59c1dedbd9f3f7f157927edf.jpg
3_deformable_detr,fold_8,1,1,1,0,0,IMG_4050_JPG.rf.242fde50c6291117b6172ee1dc45f081.jpg
3_deformable_detr,fold_8,1,1,1,0,0,20230512_145043_jpg.rf.943869aa154c2400192f3cbbf372a136.jpg
3_deformable_detr,fold_8,1,1,1,0,0,20230512_145034_jpg.rf.1bf97c164c29fec5dca87d03670ab344.jpg
3_deformable_detr,fold_8,2,2,2,0,0,IMG_4034_JPG.rf.92867b137f89f18d7bfc2034cbb1597f.jpg
3_deformable_detr,fold_8,11,9,8,1,-2,20230512_150131_jpg.rf.b7b4ef28a3d5833ddf815ebcf9a8b336.jpg
3_deformable_detr,fold_8,1,1,1,0,0,20230512_145223_jpg.rf.e86673dc1e563853935de252c1c2a11e.jpg
3_deformable_detr,fold_8,2,2,2,0,0,20230512_145313_jpg.rf.a52df235ea36832731aa90971489567a.jpg
3_deformable_detr,fold_8,1,1,1,0,0,20230512_151654_jpg.rf.1ff5a5051a16402ce45fe6ca565c9239.jpg
3_deformable_detr,fold_8,2,2,1,1,0,20230512_145135_jpg.rf.4d3af6f64064db39df70b1e3672a3f63.jpg
3_deformable_detr,fold_8,1,0,0,0,-1,IMG_20230512_153408_091_jpg.rf.d4b7f029dd191b0e3fc52b4b39bf8116.jpg
3_deformable_detr,fold_8,2,1,1,0,-1,20230512_151619_jpg.rf.c7fb218f315f99ea72e78a520cc5dc68.jpg
3_deformable_detr,fold_8,65,8,6,2,-57,IMG_20230512_153155_jpg.rf.348475844dfbdea71bac7dbce8198f44.jpg
3_deformable_detr,fold_8,26,15,15,0,-11,IMG_3928_JPG.rf.b59dd1a245d0a61096acf104642a588f.jpg
3_deformable_detr,fold_8,1,0,0,0,-1,0230512_145026_jpg.rf.e1ea5177e0224a86904eddffb8258ab9.jpg
3_deformable_detr,fold_8,3,2,2,0,-1,IMG_3865_JPG.rf.85489cc903cddfc5bd27ee6328f5235e.jpg
3_deformable_detr,fold_8,17,13,9,4,-4,IMG_20230512_145019_771_jpg.rf.d4b15f5b7869ffc05f7387247c4f82ae.jpg
3_deformable_detr,fold_8,3,2,2,0,-1,IMG_3909_JPG.rf.be7478f841f6abc72fcc654df3e13ada.jpg
3_deformable_detr,fold_8,7,7,7,0,0,20230512_151849_jpg.rf.52b8fefba379829baeca592f085340cd.jpg
3_deformable_detr,fold_8,8,6,6,0,-2,IMG_20230512_151934_jpg.rf.543796bd925563f125516769b066b214.jpg
3_deformable_detr,fold_8,2,2,2,0,0,0008_jpg.rf.058dbc5491e7240170841cbeb7cfebca.jpg
3_deformable_detr,fold_8,2,2,2,0,0,20230512_151804-0-_jpg.rf.da37c80768423b2be325cf7dcf3b8efd.jpg
3_deformable_detr,fold_8,4,3,2,1,-1,20230512_151138_jpg.rf.bd5d8d04a758d594acc2af15dc942b5f.jpg
3_deformable_detr,fold_8,13,12,11,1,-1,20230512_152309_jpg.rf.e6272cf81ee3a89c98dea29c7ca87fde.jpg
3_deformable_detr,fold_8,8,4,4,0,-4,20230512_150137_jpg.rf.c6db7854f50b446566afe69c0e3bae6f.jpg
3_deformable_detr,fold_8,1,0,0,0,-1,IMG_3858_JPG.rf.10b8772deec081b08895efdc83efbfcc.jpg
3_deformable_detr,fold_8,1,1,1,0,0,20230512_151447_jpg.rf.8a684005457ea3cadf9943d40014e87f.jpg
3_deformable_detr,fold_8,9,8,8,0,-1,IMG_20230512_144959_jpg.rf.8d9a872947615acdbff5cf0776139cb9.jpg
3_deformable_detr,fold_8,17,6,3,3,-11,20230512_153021_jpg.rf.6b38fba9b80543e229dc93ffb5e19695.jpg
3_deformable_detr,fold_8,11,15,9,6,4,20230512_151051_jpg.rf.dcb4ee42b399c0d6007719e173f728b6.jpg
3_deformable_detr,fold_8,10,10,10,0,0,20230512_151854_jpg.rf.0809016c2e20da637cbac7d27e6fb6c0.jpg
3_deformable_detr,fold_8,2,2,2,0,0,20230512_145219_jpg.rf.f22be001a717798eb8a2168d0d3421ab.jpg
3_deformable_detr,fold_8,5,5,5,0,0,230512_150140_jpg.rf.7c74dbb84999f31492125730db986f40.jpg
3_deformable_detr,fold_8,10,3,2,1,-7,20230512_151021_jpg.rf.de7c03d7cc7906d7c81bff3b479fd9e5.jpg
3_deformable_detr,fold_8,11,10,9,1,-1,20230512_145237_jpg.rf.d8f058e0b402e3d1e808be861e667173.jpg
3_deformable_detr,fold_8,152,38,31,7,-114,0100_jpg.rf.05cd5bba5e3a338b9bab8b49b2c62230.jpg
3_deformable_detr,fold_8,2,1,1,0,-1,20230512_151516_jpg.rf.4075925f758530db09c215e48201f510.jpg
3_deformable_detr,fold_8,4,2,2,0,-2,IMG_20230512_151322_jpg.rf.f87bdadf921aef8dde8daecc2efda877.jpg
3_deformable_detr,fold_8,1,1,1,0,0,20230512_151310_jpg.rf.49e186e145599c0c576f88f77a48645f.jpg
3_deformable_detr,fold_8,2,2,2,0,0,20230512_151840_jpg.rf.225d382469feb3893ab8adf440f0dcdd.jpg
3_deformable_detr,fold_8,15,13,11,2,-2,IMG_20230512_150202_jpg.rf.605274560fcfde991ad3e82107d6fd8c.jpg
3_deformable_detr,fold_8,28,17,14,3,-11,0512_150115_jpg.rf.572fa1a857240740ab2fd9c0bd962a84.jpg
3_deformable_detr,fold_8,11,8,5,3,-3,IMG_20230512_150135_011_jpg.rf.7d2abfcfbd33399d0709cdb1f6848e09.jpg
3_deformable_detr,fold_8,1,1,1,0,0,20230512_145421_jpg.rf.3704320bbaa6e937ed0261aa404772f1.jpg
3_deformable_detr,fold_8,14,14,14,0,0,0042_jpg.rf.7ffcac34c8b8720199d793d39ebf099c.jpg
3_deformable_detr,fold_8,34,16,11,5,-18,0512_150108_jpg.rf.2a2b0446e2345745280376767e5d1b27.jpg
3_deformable_detr,fold_8,3,3,3,0,0,IMG_20230512_152407_jpg.rf.987c14f960c413f0e6ece4c99d516916.jpg
3_deformable_detr,fold_8,7,4,4,0,-3,20230512_150116_jpg.rf.4cdde848ca21f7424c94dada8a3603c8.jpg
3_deformable_detr,fold_8,1,1,1,0,0,20230512_151642_jpg.rf.8d7807db8a2c50e7601e595cb8e4d441.jpg
3_deformable_detr,fold_8,1,1,1,0,0,IMG_20230512_161346_jpg.rf.f2d66ae86a3dee44e0234f6002702110.jpg
3_deformable_detr,fold_8,3,3,3,0,0,20230512_151340_jpg.rf.1e7341de1b15f16ffc701c3b53542fe7.jpg
3_deformable_detr,fold_8,5,5,4,1,0,20230512_145411_jpg.rf.962646db69e6629f3a045dc737b54f0c.jpg
3_deformable_detr,fold_8,12,7,4,3,-5,20230512_145240_jpg.rf.a5091d10c5393608b704fe2d2a846263.jpg
3_deformable_detr,fold_8,12,7,7,0,-5,IMG_20230512_152002_jpg.rf.0e50ad947bcac786ec04e7adf1df3e90.jpg
3_deformable_detr,fold_8,8,7,7,0,-1,IMG_4207_JPG.rf.330747e746ba1f08f12c25a697df8506.jpg
3_deformable_detr,fold_8,24,10,9,1,-14,IMG_20230512_150022_jpg.rf.951e0e5b24bd9b0e9ad93c5f8e19127d.jpg
3_deformable_detr,fold_8,1,1,1,0,0,20230512_151445_jpg.rf.7d699391bb3084d81ea03299229ab140.jpg
3_deformable_detr,fold_8,3,2,2,0,-1,IMG_20230512_145332_184_jpg.rf.332c2aa459e521d0576953fca1e0a03f.jpg
3_deformable_detr,fold_8,3,2,2,0,-1,20230512_145052_jpg.rf.e4d9741a91ef6c0f9f053feb1ffe1df5.jpg
3_deformable_detr,fold_8,12,10,9,1,-2,0032_jpg.rf.bbf27b122201c3fdb2fa22a360b64846.jpg
3_deformable_detr,fold_8,4,5,4,1,1,20230512_151300_jpg.rf.f994d9472b1ee1ddd3ac8ab3a3cc2a12.jpg
3_deformable_detr,fold_8,7,5,2,3,-2,20230512_150036_jpg.rf.409641b85ef17642977736d9dc873ae4.jpg
3_deformable_detr,fold_8,1,0,0,0,-1,IMG_20230512_144910_997_jpg.rf.93aca80524806445b3dfb1818fa4806a.jpg
3_deformable_detr,fold_8,7,7,6,1,0,IMG_20230512_152357_jpg.rf.77160d5f48db0fa53a72198288557af6.jpg
3_deformable_detr,fold_8,7,8,6,2,1,20230512_145341_jpg.rf.85ffc7a18e0ad722dbf476743313df02.jpg
3_deformable_detr,fold_8,16,17,16,1,1,IMG_20230512_151902_jpg.rf.86d659e2d2eb4651a989633ff7c3cb87.jpg
3_deformable_detr,fold_8,17,11,10,1,-6,230512_150202_jpg.rf.ea33cf5fe5f6662c3682e389e8685dfb.jpg
3_deformable_detr,fold_8,12,12,11,1,0,0048_jpg.rf.ec48089b3f18d5818c04f71cecd05f38.jpg
3_deformable_detr,fold_8,2,4,2,2,2,IMG_4091_JPG.rf.a9405bd034e33eacf6b2883c9ed04e2e.jpg
3_deformable_detr,fold_8,13,8,8,0,-5,IMG_20230512_150158_jpg.rf.c8fd099b0d72b4e29fc1807382e042b1.jpg
3_deformable_detr,fold_8,2,2,2,0,0,20230512_144932_jpg.rf.a725c2a7e9c0d34d34a6abd7d299f6df.jpg
3_deformable_detr,fold_8,16,14,12,2,-2,20230512_151039_jpg.rf.bb11ca2d78a6f005bcb2f521dfcf0dce.jpg
3_deformable_detr,fold_8,5,4,4,0,-1,20230512_152301_jpg.rf.3701d53ed7c06271583a063371e238d1.jpg
3_deformable_detr,fold_8,7,1,0,1,-6,IMG_20230512_145108_jpg.rf.5b77832e2c70819f5a5de9e318768425.jpg
3_deformable_detr,fold_8,3,2,2,0,-1,IMG_3849_JPG.rf.7ce1df74f4ca793d89d2042ccc5766ef.jpg
3_deformable_detr,fold_8,10,8,4,4,-2,20230512_145206_jpg.rf.4cf9a1bcd726515460c68ec0b753f06a.jpg
3_deformable_detr,fold_8,21,10,9,1,-11,IMG_20230512_150057_jpg.rf.1d901fec112c2705325b5b23647b5cfe.jpg
3_deformable_detr,fold_8,5,5,4,1,0,20230512_151846_jpg.rf.aaa6e44ba0c35df5988efcf5a4f2510c.jpg
3_deformable_detr,fold_8,22,13,12,1,-9,IMG_20230512_153211_jpg.rf.8b8c95e482643af377a9a4d7a0182777.jpg
3_deformable_detr,fold_8,3,3,2,1,0,0230512_145440_jpg.rf.26be693a65087ccb13d4129f4c93b786.jpg
3_deformable_detr,fold_8,9,2,1,1,-7,IMG_3931_JPG.rf.fcba871e1d94de33741779717c57137f.jpg
3_deformable_detr,fold_8,1,1,0,1,0,20230512_145025_jpg.rf.15940c55814fd494ff830db5a9061d30.jpg
3_deformable_detr,fold_8,1,1,1,0,0,IMG_20230512_145352_jpg.rf.1c96dea3488a61099952ab7250fce4b2.jpg
3_deformable_detr,fold_8,3,3,2,1,0,20230512_145231_jpg.rf.77f03cc3c54cff48c03e24558d36189b.jpg
3_deformable_detr,fold_8,16,12,10,2,-4,IMG_20230512_151508_jpg.rf.c78520025916588a7657b75ae388cb8f.jpg
3_deformable_detr,fold_8,12,12,7,5,0,IMG_20230512_145022_866_jpg.rf.245d67f93e45a020eb21fdd8f4124767.jpg
3_deformable_detr,fold_8,4,4,2,2,0,20230512_145329_jpg.rf.0c0d42d6e893d6efcd4b3119ce990d0e.jpg
3_deformable_detr,fold_8,2,2,2,0,0,20230512_145433_jpg.rf.5924d4f1a47105e53efa0a08085450a7.jpg
3_deformable_detr,fold_8,3,3,3,0,0,IMG_20230512_152405_jpg.rf.ebe5f63b7b940c8d9a74c8fb5839d39b.jpg
3_deformable_detr,fold_8,6,5,5,0,-1,20230512_150204_jpg.rf.87f7c1141bc54dad9c82b36c8beb1bb9.jpg
3_deformable_detr,fold_8,1,1,0,1,0,230512_150118_jpg.rf.ecc50b57dabc83b04e792a7ddde388f8.jpg
3_deformable_detr,fold_8,2,2,2,0,0,20230512_150052_jpg.rf.9bdf107fc37c37b05aa46914e8882f17.jpg
3_deformable_detr,fold_8,5,2,1,1,-3,20230512_151135_jpg.rf.3b3e99725d0ae8b34747d0ed51687a4a.jpg
3_deformable_detr,fold_8,2,1,0,1,-1,230512_145056_jpg.rf.cb3d61bce2d4e0686bc0310ab76413a2.jpg
3_deformable_detr,fold_8,25,11,10,1,-14,IMG_20230512_150208_jpg.rf.14a0d0d16b6d32327bcec6959b738634.jpg
3_deformable_detr,fold_8,30,21,19,2,-9,IMG_20230512_150210_524_jpg.rf.476d8805b0160b5143ad37609399dc72.jpg
3_deformable_detr,fold_8,1,0,0,0,-1,20230512_151455_jpg.rf.ea02e305291eae5ae85ae54d0ebfe26d.jpg
3_deformable_detr,fold_8,19,8,7,1,-11,IMG_20230512_150024_jpg.rf.5425ded2475701fa14408062843212ec.jpg
3_deformable_detr,fold_8,10,9,8,1,-1,20230512_153132_jpg.rf.cac6aa1f1a0f028046df980276b5e4e6.jpg
3_deformable_detr,fold_8,1,0,0,0,-1,MG_20230512_145316_jpg.rf.4d66c8eb78cdd81e04686ee0f7aa4fdf.jpg
3_deformable_detr,fold_8,12,8,8,0,-4,20230512_152311_jpg.rf.7f2da0009f2fa07600b981c50d8d6ebf.jpg
3_deformable_detr,fold_8,1,1,1,0,0,20230512_145036_jpg.rf.1ecc4ae3f81e22aac59d8b3b9c1034cd.jpg
3_deformable_detr,fold_8,1,1,1,0,0,IMG_4390_JPG.rf.2018de24c221ce01e2c3239735a272af.jpg
3_deformable_detr,fold_8,14,10,10,0,-4,IMG_20230512_145158_jpg.rf.6d28bd6cb232ef60feeaaa2d893d7326.jpg
3_deformable_detr,fold_8,4,5,3,2,1,IMG_20230512_150225_jpg.rf.5e6e4781174588e28c95f110bb49edf2.jpg
3_deformable_detr,fold_8,17,13,12,1,-4,20230512_151035_jpg.rf.7593703cffcf4a6285b53ddb6e104d39.jpg
3_deformable_detr,fold_8,5,4,4,0,-1,_20230512_150252_jpg.rf.c7786b04a48eca5fec5127b90d27efc6.jpg
3_deformable_detr,fold_8,10,8,7,1,-2,IMG_20230512_161908_jpg.rf.c3138f9567f619fcdc8eb8c700bfcff8.jpg
3_deformable_detr,fold_8,8,7,4,3,-1,20230512_150001_jpg.rf.74ea9697c92aedc234993b5551f7f1b4.jpg
3_deformable_detr,fold_8,5,7,5,2,2,IMG_20230512_151249_373_jpg.rf.f2dd29bba78783f6fbe29e66675bd321.jpg
3_deformable_detr,fold_8,3,2,2,0,-1,IMG_20230512_151542_635_jpg.rf.1e2c1e872c81db1f473f8c586f3ce9d9.jpg
3_deformable_detr,fold_8,3,1,1,0,-2,20230512_151619-0-_jpg.rf.5d6f8d7a8176754cc78ef08a707b7ea8.jpg
3_deformable_detr,fold_8,8,6,6,0,-2,IMG_20230512_145253_jpg.rf.7d0a492e681439db3a20eb64e356d8ff.jpg
3_deformable_detr,fold_8,2,2,2,0,0,20230512_151636_jpg.rf.0e80ecb006eb88d60de9b99c0fac2245.jpg
3_deformable_detr,fold_8,11,9,8,1,-2,IMG_3926_JPG.rf.769c3267365e5531dec34c648a73f597.jpg
3_deformable_detr,fold_8,13,11,9,2,-2,IMG_20230512_145120_jpg.rf.3ecb5837a329b79ac20997cfe24d3124.jpg
3_deformable_detr,fold_8,3,2,2,0,-1,230512_150054_jpg.rf.ec6dcd9709fc100d27b3f2f4937b7712.jpg
3_deformable_detr,fold_8,7,6,4,2,-1,IMG_20230512_150945_jpg.rf.26027cad843e4a3c904d281bd5e443ab.jpg
3_deformable_detr,fold_8,2,2,2,0,0,20230512_151755_jpg.rf.f2aa85c403e0f77cda500046a0fd667f.jpg
3_deformable_detr,fold_8,7,8,7,1,1,20230512_152237_jpg.rf.dceb042d25e3e44ad022b7c4330f1dcf.jpg
3_deformable_detr,fold_8,19,13,11,2,-6,20230512_153013_jpg.rf.ebf5724207d5fe9aba867759ed6ae350.jpg
3_deformable_detr,fold_8,3,2,2,0,-1,230512_150143_jpg.rf.b686af9ba8be8219e2e0a152ff0123f1.jpg
3_deformable_detr,fold_8,1,1,1,0,0,IMG_20230512_151231_jpg.rf.f19d35ba554c9c3e62efe863fb1dd098.jpg
3_deformable_detr,fold_8,1,1,1,0,0,20230512_151451-0-_jpg.rf.352f3ab1f1271f1dc2c7503413d5072b.jpg
3_deformable_detr,fold_8,13,10,10,0,-3,IMG_20230512_151640_056_jpg.rf.69bbb5903a2369e6d01c4fd2bef65e1f.jpg
3_deformable_detr,fold_8,5,0,0,0,-5,230512_150033_jpg.rf.ceea84e0a6184331d2af5a24cba9a7d0.jpg
3_deformable_detr,fold_8,11,10,10,0,-1,0053_jpg.rf.09112cd43c7e1f0da4351e79ab49af2f.jpg
3_deformable_detr,fold_8,12,9,9,0,-3,IMG_20230512_151339_jpg.rf.13ce8b9b66953b0f57413fa693a3dc35.jpg
3_deformable_detr,fold_8,2,3,2,1,1,IMG_20230512_151240_565_jpg.rf.fdf2f78ec041a34d2611406b29953d18.jpg
3_deformable_detr,fold_8,23,22,18,4,-1,IMG_20230512_150201_jpg.rf.81da174bcf14fd53b844cf7cae9f7a28.jpg
3_deformable_detr,fold_8,27,11,3,8,-16,20230512_153207_jpg.rf.81b28e88b96ae01a62cb2b2cdc468e08.jpg
3_deformable_detr,fold_8,3,2,2,0,-1,20230512_151625_jpg.rf.6d8f8d5fffad59d6ccff118606bdd771.jpg
3_deformable_detr,fold_8,8,7,6,1,-1,IMG_20230512_145440_jpg.rf.4fae61f59dfa2249c388f714b68ca784.jpg
3_deformable_detr,fold_8,2,1,1,0,-1,IMG_4191_JPG.rf.f40d8980877c6222a068ed1ef1102afa.jpg
3_deformable_detr,fold_8,1,2,1,1,1,20230512_153345_jpg.rf.7d2374802dfa67e187bded47020403c1.jpg
3_deformable_detr,fold_8,1,1,1,0,0,20230512_150733_jpg.rf.dfdc2eb0d94519616a7ec9cf127c8f8a.jpg
3_deformable_detr,fold_8,1,1,1,0,0,IMG_4028_JPG.rf.c7571b8910b4228b0179b0ffc703ee1e.jpg
3_deformable_detr,fold_8,9,8,6,2,-1,0230512_150115_jpg.rf.50a5de1d8e046395fd6c82509eb7d363.jpg
3_deformable_detr,fold_8,2,1,1,0,-1,20230512_145355_jpg.rf.67799c9783b1beeb42aebdae40eac27d.jpg
3_deformable_detr,fold_8,9,6,5,1,-3,IMG_3989_JPG.rf.51b8252c5f0a8196d379e91fcc91ad06.jpg
3_deformable_detr,fold_8,1,0,0,0,-1,20230512_145111_jpg.rf.ab829e89e439dc4aa65d413090f00b2d.jpg
3_deformable_detr,fold_8,5,4,4,0,-1,20230512_152259_jpg.rf.fef7e558f14c303ecfa184eb656375ce.jpg
3_deformable_detr,fold_8,1,1,1,0,0,IMG_20230512_151033_jpg.rf.4872ff92d415a45e16c1f52f8b7ae6db.jpg
3_deformable_detr,fold_8,32,16,16,0,-16,IMG_20230512_153350_jpg.rf.cc68f1c6759992fe198286f32b0171ec.jpg
3_deformable_detr,fold_8,2,1,1,0,-1,20230512_151506_jpg.rf.2d22a2b23e3853093943da42a80fc17b.jpg
3_deformable_detr,fold_8,1,1,1,0,0,IMG_4015_JPG.rf.8f40d2d78e19693b5d38d76ffd50d286.jpg
3_deformable_detr,fold_8,10,10,10,0,0,20230512_152217_jpg.rf.a3962f3838250709a368b8f241c7bcad.jpg
3_deformable_detr,fold_8,3,2,2,0,-1,230512_150048_jpg.rf.2a601f5dc5ab605aa2563bcbc35c41e1.jpg
3_deformable_detr,fold_8,14,10,9,1,-4,IMG_20230512_152954_jpg.rf.6f297f29021342f064430fb1e8d22587.jpg
3_deformable_detr,fold_8,2,2,2,0,0,IMG_4053_JPG.rf.307ece37dd62cbaea82bfd7b14f0ee36.jpg
3_deformable_detr,fold_8,17,13,13,0,-4,20230512_152942_jpg.rf.cc3d43f0d1f322fa8da500d78ce3a8be.jpg
3_deformable_detr,fold_8,3,1,1,0,-2,IMG_20230512_151637_jpg.rf.e79b46fd14d5a0af0846c34d1a920413.jpg
3_deformable_detr,fold_9,7,6,6,0,-1,20230512_152158_jpg.rf.02f9c3c00108d9da3f80f2943458d80a.jpg
3_deformable_detr,fold_9,4,3,3,0,-1,IMG_20230512_145312_784_jpg.rf.58023d0721ac49469db4e79c05fb5cba.jpg
3_deformable_detr,fold_9,25,19,17,2,-6,20230512_150144_jpg.rf.ecf1f47bccdedeca682aab00e68f4fbf.jpg
3_deformable_detr,fold_9,4,5,4,1,1,20230512_145408-0-_jpg.rf.7d30c64c68760c899eab7f27576adaec.jpg
3_deformable_detr,fold_9,17,8,8,0,-9,IMG_20230512_153014_136_jpg.rf.ac9f2fc67a44db81aef730e99a1dba0a.jpg
3_deformable_detr,fold_9,20,13,10,3,-7,20230512_153043_jpg.rf.5cddf43df464d99390a41596bf2ccdf2.jpg
3_deformable_detr,fold_9,8,5,5,0,-3,20230512_153242_jpg.rf.5d53d7e395b76d25f2510396dec3f47a.jpg
3_deformable_detr,fold_9,7,4,4,0,-3,20230512_151538_jpg.rf.d5df90d6db920f66f1d45e4cfa70a411.jpg
3_deformable_detr,fold_9,5,5,5,0,0,0050_jpg.rf.47c1ed097ad14e52c46f19b2b3e3f5a2.jpg
3_deformable_detr,fold_9,3,7,1,6,4,20230512_150109_jpg.rf.4d2c542089703d638847cefe3c0e0669.jpg
3_deformable_detr,fold_9,12,8,7,1,-4,IMG_20230512_151658_955_jpg.rf.6f77aded32a46d8083d7d4e54c112bb9.jpg
3_deformable_detr,fold_9,5,4,4,0,-1,IMG_20230512_145258_492_jpg.rf.3ae44ee592a82ee046166d1017a1f348.jpg
3_deformable_detr,fold_9,3,3,3,0,0,IMG_20230512_152403_jpg.rf.708a0e8a856b9c4ca92a84e1450a3e60.jpg
3_deformable_detr,fold_9,7,5,5,0,-2,20230512_151548_jpg.rf.de9bfd82e4ede57511bc911fc34f5695.jpg
3_deformable_detr,fold_9,1,2,1,1,1,IMG_20230512_151202_728_jpg.rf.1d8a1071a58b84a0628884454a63ef8a.jpg
3_deformable_detr,fold_9,11,9,8,1,-2,20230512_152251_jpg.rf.f4cd881ef463deae8c6458635e8849ac.jpg
3_deformable_detr,fold_9,4,1,1,0,-3,IMG_3835_JPG.rf.e405f9fb7ccfe92ed96a553465aa1ec9.jpg
3_deformable_detr,fold_9,18,10,9,1,-8,20230512_144934_jpg.rf.03898f9c31f25d3ec984bc32b412d5af.jpg
3_deformable_detr,fold_9,4,3,3,0,-1,IMG_3867_JPG.rf.ec5d38e5d6681088aaa0d2786eb3bb2b.jpg
3_deformable_detr,fold_9,13,6,6,0,-7,IMG_20230512_152345_469_jpg.rf.3dde8c68a98233421212da59bcbe366e.jpg
3_deformable_detr,fold_9,19,14,13,1,-5,IMG_20230512_152322_jpg.rf.190afc8c001b1a757ff0cc847eea784d.jpg
3_deformable_detr,fold_9,15,9,9,0,-6,0230512_145001_jpg.rf.da230b3dcac925c28f8c0273b5776c9a.jpg
3_deformable_detr,fold_9,8,10,8,2,2,20230512_151900_jpg.rf.1250b5103b69822786ae601e0a5c5f68.jpg
3_deformable_detr,fold_9,3,2,1,1,-1,IMG_20230512_145043_jpg.rf.3d90edfd5a365d1ec3876fca50ab884d.jpg
3_deformable_detr,fold_9,2,2,2,0,0,IMG_20230512_145345_250_jpg.rf.15fc60af583ce168515577f073866f5f.jpg
3_deformable_detr,fold_9,14,10,10,0,-4,20230512_152217_jpg.rf.2fdd5053b538b85b1941d0bb5e4261ca.jpg
3_deformable_detr,fold_9,5,0,0,0,-5,230512_150109_jpg.rf.fe44d8827f0b8ae246022ca47b5c4c2c.jpg
3_deformable_detr,fold_9,9,10,9,1,1,20230512_152318_jpg.rf.15ef28475daedc6fc4e098af4a1459e5.jpg
3_deformable_detr,fold_9,11,11,10,1,0,IMG_20230512_151554_209_jpg.rf.f15eb1b2793910f53035e241375725c8.jpg
3_deformable_detr,fold_9,1,1,1,0,0,20230512_151039_jpg.rf.12dc8e8ab83bd9d6e1e941c7a0c05874.jpg
3_deformable_detr,fold_9,1,1,1,0,0,IMG_3908_JPG.rf.04ee0448a5e502f1d8c821cea701a7e1.jpg
3_deformable_detr,fold_9,2,2,2,0,0,20230512_150227_jpg.rf.4d20daf17aea8771758821741496ecfd.jpg
3_deformable_detr,fold_9,1,1,1,0,0,20230512_153412_jpg.rf.86821476b6a03cfd46882b168695fa0b.jpg
3_deformable_detr,fold_9,11,1,1,0,-10,20230512_153437_jpg.rf.be3d60256eef37a332523d849f2754c6.jpg
3_deformable_detr,fold_9,1,1,1,0,0,20230512_150221_jpg.rf.16f1f40fdbd20de3345eed95661a9875.jpg
3_deformable_detr,fold_9,6,4,4,0,-2,20230512_145324_jpg.rf.20601749525cadde15c78b46cd0fd934.jpg
3_deformable_detr,fold_9,11,7,6,1,-4,IMG_20230512_151501_jpg.rf.050803adc8687422b6d0ca0c55649365.jpg
3_deformable_detr,fold_9,8,8,6,2,0,0041_jpg.rf.dc9ba1dc663668cabb27474922349a17.jpg
3_deformable_detr,fold_9,8,9,7,2,1,20230512_145208_jpg.rf.b8ad2aec57651698bef6edfad1ced014.jpg
3_deformable_detr,fold_9,1,1,1,0,0,20230512_151617_jpg.rf.f876cceb3568353e640a6506b3aa8b6a.jpg
3_deformable_detr,fold_9,16,11,11,0,-5,0043_jpg.rf.af436235ce1f5e4c84b661d4b30ac97f.jpg
3_deformable_detr,fold_9,6,6,6,0,0,IMG_4102_JPG.rf.988b30b26acf51017cd5b3ff16762a2b.jpg
3_deformable_detr,fold_9,5,4,4,0,-1,IMG_20230512_145425_638_jpg.rf.661f8dc69f407743144410705f4450c9.jpg
3_deformable_detr,fold_9,14,11,9,2,-3,20230512_151015_jpg.rf.3c8da9af03482ee1020db88de8cd53f5.jpg
3_deformable_detr,fold_9,6,4,3,1,-2,20230512_151814_jpg.rf.63e5823ef6a38da9206064b1975681af.jpg
3_deformable_detr,fold_9,6,5,5,0,-1,20230512_151556_jpg.rf.e585c8603435630ba81c916c0f5e3ad0.jpg
3_deformable_detr,fold_9,7,6,4,2,-1,20230512_150112_jpg.rf.91cd81f1887a38818d08e2f659a19d98.jpg
3_deformable_detr,fold_9,6,4,4,0,-2,20230512_144948_jpg.rf.f0802f30adda8942f990e793b5836607.jpg
3_deformable_detr,fold_9,1,1,1,0,0,20230512_145029_jpg.rf.d7839e9fea72e8e69ba8fd36d0e4fb46.jpg
3_deformable_detr,fold_9,18,14,13,1,-4,IMG_3904_JPG.rf.bd3a38163bc8779f0e934e0ae4ddadcf.jpg
3_deformable_detr,fold_9,1,2,1,1,1,IMG_20230512_153207_221_jpg.rf.1f2a32c755bbb2f6a4de873cb32a38fd.jpg
3_deformable_detr,fold_9,6,3,3,0,-3,IMG_20230512_150226_jpg.rf.0f75578652c746be4186e389de366a0e.jpg
3_deformable_detr,fold_9,2,0,0,0,-2,IMG_3906_JPG.rf.489fadb71a83983d81ed44a70d0060f4.jpg
3_deformable_detr,fold_9,7,8,6,2,1,20230512_150041_jpg.rf.77c6bf2c7e0b5d7af7cc6bad355e9df1.jpg
3_deformable_detr,fold_9,1,1,1,0,0,0230512_145030_jpg.rf.6c6efdb679aaba04919e4f2fbe75cc41.jpg
3_deformable_detr,fold_9,5,0,0,0,-5,230512_150321_jpg.rf.623a3367577becef7953f663a60a519b.jpg
3_deformable_detr,fold_9,5,1,1,0,-4,MG_20230512_145134_jpg.rf.23612ad15c705c682dff7447cb294722.jpg
3_deformable_detr,fold_9,27,3,2,1,-24,20230512_153521_jpg.rf.91f440ee7bd1d39009cef4ad201c6fc3.jpg
3_deformable_detr,fold_9,0,10,0,10,10,IMG_4213_JPG.rf.778fa8d9b6925e2bc9f653dd198513f2.jpg
3_deformable_detr,fold_9,6,6,6,0,0,20230512_152211_jpg.rf.f8ab5359b2be0312cf7788fc199a7cfb.jpg
3_deformable_detr,fold_9,3,2,2,0,-1,20230512_151750_jpg.rf.d25aa4eadcd0f88bad307f1be9834da7.jpg
3_deformable_detr,fold_9,14,11,8,3,-3,IMG_20230512_145200_jpg.rf.071fa9592bc47982ce5ace6be3fc1cac.jpg
3_deformable_detr,fold_9,11,6,5,1,-5,20230512_150021_jpg.rf.e7014c35e8c40fcb7fa7884ea70952ae.jpg
3_deformable_detr,fold_9,15,7,6,1,-8,IMG_20230512_150047_070_jpg.rf.473b1fece6373583075f5a81e7cd25b1.jpg
3_deformable_detr,fold_9,12,12,11,1,0,IMG_20230512_152350_jpg.rf.e5327c93655bbe8c35427b0ce8c7c897.jpg
3_deformable_detr,fold_9,7,6,5,1,-1,20230512_153033_jpg.rf.02462baf8941d1800bd6cd7071ac2700.jpg
3_deformable_detr,fold_9,5,3,3,0,-2,20230512_145350_jpg.rf.1ea30b4048e0f19948f3a1c49f936262.jpg
3_deformable_detr,fold_9,20,8,8,0,-12,20230512_153245_jpg.rf.9c9fb8ddd3ba260eca53499188a58fd5.jpg
3_deformable_detr,fold_9,2,2,2,0,0,20230512_151451_jpg.rf.0a8434d6a9efa22ee048c8273b62b68d.jpg
3_deformable_detr,fold_9,5,5,4,1,0,20230512_151436_jpg.rf.554d34d9ea0ee09cf2c15f0b2df8ebb2.jpg
3_deformable_detr,fold_9,6,5,5,0,-1,IMG_3910_JPG.rf.33d9bdf28a4dfeab746c5a00ebede622.jpg
3_deformable_detr,fold_9,1,1,1,0,0,20230512_145422_jpg.rf.855806965c417ddd5e1b836f01dc61f4.jpg
3_deformable_detr,fold_9,18,17,16,1,-1,IMG_4182_JPG.rf.9c42af3692f7bbaef5a89c980112be66.jpg
3_deformable_detr,fold_9,2,1,1,0,-1,20230512_151553_jpg.rf.eb27fb285f9f9e115b16ae58308b4a33.jpg
3_deformable_detr,fold_9,1,1,1,0,0,IMG_20230512_151942_jpg.rf.44e3a3ca4b79e01e3532e938c985d467.jpg
3_deformable_detr,fold_9,1,1,0,1,0,20230512_145026_jpg.rf.dbca47de186a8c26308fd5d82af2ccef.jpg
3_deformable_detr,fold_9,8,5,5,0,-3,IMG_20230512_151456_jpg.rf.85840748681315fe5ab4e0d0318d07ef.jpg
3_deformable_detr,fold_9,5,3,3,0,-2,20230512_145129_jpg.rf.5f78acb483122a7da1a71444f23c5e85.jpg
3_deformable_detr,fold_9,3,3,3,0,0,IMG_4049_JPG.rf.69a02eacb4e8dea786daf7ac53eff115.jpg
3_deformable_detr,fold_9,3,2,2,0,-1,20230512_151128_jpg.rf.a8a2c544627fbc40d82ac1408de83acf.jpg
3_deformable_detr,fold_9,1,1,1,0,0,0022_jpg.rf.392b7e000cd5e1b178fd42a324c62fa9.jpg
3_deformable_detr,fold_9,17,13,11,2,-4,IMG_4214_JPG.rf.342cb36b8889ed055af6630becc0a92b.jpg
3_deformable_detr,fold_9,4,3,3,0,-1,IMG_3992_JPG.rf.7e1e103b7399a2f459d53d6a310a7ee0.jpg
3_deformable_detr,fold_9,23,19,18,1,-4,IMG_20230512_152955_591_jpg.rf.0aef108570178c062fc410980092f3ee.jpg
3_deformable_detr,fold_9,32,16,16,0,-16,IMG_20230512_150325_jpg.rf.9a0b14f916539972a32ed40c795a77e2.jpg
3_deformable_detr,fold_9,2,2,1,1,0,20230512_150043_jpg.rf.c937683d3c7cefe87855391dceb56509.jpg
3_deformable_detr,fold_9,3,3,3,0,0,IMG_4038_JPG.rf.53f27c280fb9536f67b0f3bce749cded.jpg
3_deformable_detr,fold_9,1,1,1,0,0,IMG_4218_JPG.rf.776b234254cad41083ae7a7013512ded.jpg
3_deformable_detr,fold_9,3,4,3,1,1,20230512_152323_jpg.rf.f87e4ec47644402832bf9ed280233bd6.jpg
3_deformable_detr,fold_9,5,3,2,1,-2,20230512_151434_jpg.rf.6e770d46c3e9773c996335b4220cab85.jpg
3_deformable_detr,fold_9,10,7,6,1,-3,0230512_145012_jpg.rf.0f087c91d690727635837b56dc1725f3.jpg
3_deformable_detr,fold_9,1,1,1,0,0,20230512_151257_jpg.rf.0a6cd5b01b2f5eb142626849e1aa59dd.jpg
3_deformable_detr,fold_9,5,5,5,0,0,IMG_20230512_151930_jpg.rf.b1cb9853e8645a3ba38d93ab637f6627.jpg
3_deformable_detr,fold_9,14,12,12,0,-2,20230512_151038-0-_jpg.rf.b58c6345da65332e25d3fdda064694ee.jpg
3_deformable_detr,fold_9,1,1,1,0,0,20230512_145221_jpg.rf.29bff38b4873d27c522654186744b290.jpg
3_deformable_detr,fold_9,15,12,12,0,-3,IMG_20230512_152316_jpg.rf.7f4d2253d0ea3147244a7a36b4392e3c.jpg
3_deformable_detr,fold_9,1,1,1,0,0,20230512_145046_jpg.rf.43cb9d49dc86e3ae870df966e6b2b7b1.jpg
3_deformable_detr,fold_9,6,4,4,0,-2,IMG_20230512_151246_jpg.rf.0cb0203d04b163b091b29c2f755a7f65.jpg
3_deformable_detr,fold_9,8,6,6,0,-2,20230512_150900_jpg.rf.7c05ba2842680f1a240b6f0a28f08dad.jpg
3_deformable_detr,fold_9,1,1,1,0,0,20230512_151614_jpg.rf.ceb493d7d9f840a198a0413f2b423ce2.jpg
3_deformable_detr,fold_9,1,1,1,0,0,IMG_20230512_151807_jpg.rf.c8207f2bdebe5ee316d9b9a0529d1efe.jpg
3_deformable_detr,fold_9,3,3,3,0,0,20230512_153403_jpg.rf.90c6c42ac826af51ce764bcff3b6923f.jpg
3_deformable_detr,fold_9,4,1,1,0,-3,IMG_20230512_145038_jpg.rf.3da21846aa05a88c16affc46ab268cfc.jpg
3_deformable_detr,fold_9,12,8,6,2,-4,IMG_20230512_151433_jpg.rf.d9b4366826ebd2bd7917e1cb46c50ed4.jpg
3_deformable_detr,fold_9,4,5,4,1,1,20230512_145336_jpg.rf.28de2a53875dce1e728e5a0c0cb97aad.jpg
3_deformable_detr,fold_9,2,2,2,0,0,20230512_145253_jpg.rf.c6fbf385d5f1b3ae20b0ef540f9e84b5.jpg
3_deformable_detr,fold_9,19,10,9,1,-9,20230512_153250_jpg.rf.b3c0a5af0f8dd45ec4fe90ed8e62c274.jpg
3_deformable_detr,fold_9,2,2,2,0,0,20230512_151637-0-_jpg.rf.57d42a7eaecae72323f8868de4088574.jpg
3_deformable_detr,fold_9,5,5,4,1,0,IMG_3982_JPG.rf.084073c997ce2761c02b36ef237261da.jpg
3_deformable_detr,fold_9,2,0,0,0,-2,20230512_145050_jpg.rf.ae125a7aa3a0b2c6f41bc879a36698ce.jpg
3_deformable_detr,fold_9,10,9,9,0,-1,20230512_151905-0-_jpg.rf.270832f78fc4546ac9758205aad2a837.jpg
3_deformable_detr,fold_9,2,2,2,0,0,20230512_150048_jpg.rf.bdbae272f798a54cd79cfc08bd2da41e.jpg
3_deformable_detr,fold_9,13,6,5,1,-7,20230512_145159_jpg.rf.a9f2125d1fdfa80946c0b272e36cb621.jpg
3_deformable_detr,fold_9,2,2,2,0,0,20230512_151541_jpg.rf.1a96f83831f9956a1c5cd8cb7987ee61.jpg
3_deformable_detr,fold_9,1,0,0,0,-1,20230512_151118_jpg.rf.2bf6dd63d6a65371da02c372efde8ba3.jpg
3_deformable_detr,fold_9,2,1,1,0,-1,IMG_3862_JPG.rf.a37466cc240bba5feaeef8019ddd0e55.jpg
3_deformable_detr,fold_9,4,2,1,1,-2,IMG_3843_JPG.rf.3b04ef87c1af95cd756b57595eb39e72.jpg
3_deformable_detr,fold_9,16,9,7,2,-7,IMG_20230512_145144_jpg.rf.4c14218fadac19f6b4d5270f23587de8.jpg
3_deformable_detr,fold_9,2,2,2,0,0,20230512_151759_jpg.rf.04ce83457ca436da1fc767b75f695b6b.jpg
3_deformable_detr,fold_9,1,1,1,0,0,IMG_20230512_145257_jpg.rf.453736b6f9bd9250f595d3afd851de1f.jpg
3_deformable_detr,fold_9,2,1,1,0,-1,230512_150129_jpg.rf.10e62e193f0a96333642eeae2d068d57.jpg
3_deformable_detr,fold_9,1,1,1,0,0,IMG_3932_JPG.rf.42e9d2a10f9734e5a4bc91d0d9eb642c.jpg
3_deformable_detr,fold_9,63,19,17,2,-44,0512_150200_jpg.rf.8539b7a73e953ce0ea7f67784fcb2b58.jpg
3_deformable_detr,fold_9,6,6,5,1,0,IMG_20230512_145254_217_jpg.rf.4e2eb97449efdb3bab4662c35a288482.jpg
3_deformable_detr,fold_9,4,4,3,1,0,20230512_150253_jpg.rf.a852fcb9c971bcf0f4b4b6c07b3a1e7e.jpg
3_deformable_detr,fold_9,15,11,10,1,-4,IMG_20230512_151900_jpg.rf.fad29398cd9611cef06c98d97c2dc00c.jpg
3_deformable_detr,fold_9,1,0,0,0,-1,IMG_3840_JPG.rf.263bceb78886d3833883706e095d5293.jpg
3_deformable_detr,fold_9,5,4,3,1,-1,IMG_20230512_150955_jpg.rf.2011788cab5844089b8e6b7902ac846b.jpg
3_deformable_detr,fold_9,2,2,2,0,0,20230512_151440_jpg.rf.386c9f0ed80e964393660a1d9c01d9ed.jpg
3_deformable_detr,fold_9,4,4,4,0,0,20230512_152247_jpg.rf.bdbffc243ed1383af5410f7bac53699a.jpg
3_deformable_detr,fold_9,19,14,12,2,-5,20230512_152211_jpg.rf.c54aefeead1c1b68600e1ae65c10b527.jpg
3_deformable_detr,fold_9,4,3,3,0,-1,20230512_152232_jpg.rf.01102a74dddfc813f9188dc90bff647f.jpg
3_deformable_detr,fold_9,3,0,0,0,-3,IMG_20230512_151701_jpg.rf.0d3314dfd579b4e13828bb386bfee49b.jpg
3_deformable_detr,fold_9,10,9,9,0,-1,IMG_20230512_152339_jpg.rf.4d50232667e59a45a8f02b1dc00c36ea.jpg
3_deformable_detr,fold_9,5,6,5,1,1,IMG_20230512_153347_022_jpg.rf.eca10caf5bcd60d00f0f197496dabd1c.jpg
3_deformable_detr,fold_9,12,13,11,2,1,IMG_20230512_152353_jpg.rf.74eba0461c089d0aea3691aee4afbac9.jpg
3_deformable_detr,fold_9,2,1,1,0,-1,20230512_150825_jpg.rf.04725a59554eac4f344acef56d3fb6fe.jpg
3_deformable_detr,fold_9,5,5,5,0,0,20230512_151056_jpg.rf.3214ae92a59425896458690934fb5d39.jpg
3_deformable_detr,fold_9,1,1,0,1,0,230512_150046_jpg.rf.a453bfc60f25c0a831415acaf760061b.jpg
3_deformable_detr,fold_9,6,4,4,0,-2,IMG_20230512_145419_jpg.rf.605cea1a83f727c0d545999a0d6e6e84.jpg
3_deformable_detr,fold_9,24,16,14,2,-8,0512_150049_jpg.rf.4c2d31120db48096f79c8d147d016509.jpg
3_deformable_detr,fold_9,1,0,0,0,-1,0052_jpg.rf.11b9f0f1317ccd80a627cd52e3e7c819.jpg
3_deformable_detr,fold_9,4,4,2,2,0,230512_150113_jpg.rf.491cf8e16672678e5500d8eb3e1bc404.jpg
3_deformable_detr,fold_9,11,8,4,4,-3,20230512_145204_jpg.rf.c52942b0bcdcd04cafca718031f2ab26.jpg
3_deformable_detr,fold_9,2,1,1,0,-1,IMG_20230512_150931_jpg.rf.2ce16e755fe6e9b894d7d449fafbd463.jpg
3_deformable_detr,fold_9,1,1,1,0,0,20230512_145348_jpg.rf.a9486de8293f423be4b7c903a6adf9d6.jpg
3_deformable_detr,fold_9,1,1,1,0,0,20230512_151644_jpg.rf.3bb96898f1cf4f86f3720f45fe4a4ce1.jpg
3_deformable_detr,fold_9,3,3,3,0,0,IMG_4093_JPG.rf.ebedb6000fb84b714cc74fef511c31aa.jpg
3_deformable_detr,fold_9,4,4,2,2,0,20230512_145002_jpg.rf.97109db1b99cc660d69da24c9747f303.jpg
3_deformable_detr,fold_9,2,2,2,0,0,20230512_151640_jpg.rf.f22b10e3e5f15d07706b85eb0b969f91.jpg
3_deformable_detr,fold_9,2,2,2,0,0,20230512_151631_jpg.rf.4e69595c48be79bb26b1487f3e19266e.jpg
3_deformable_detr,fold_9,6,5,5,0,-1,20230512_153330_jpg.rf.462ae2c6301c8971d155ebb9a3378c36.jpg
3_deformable_detr,fold_9,8,7,6,1,-1,IMG_4189_JPG.rf.ef51bea3fc4ec3eb14a9abaa4902f277.jpg
3_deformable_detr,fold_9,21,13,11,2,-8,20230512_150126_jpg.rf.fa9718948fbb766a50fee0608d280d14.jpg
3_deformable_detr,fold_9,37,30,28,2,-7,IMG_20230512_153238_678_jpg.rf.9b33a9187212479d779bf15d553e8efc.jpg
3_deformable_detr,fold_9,2,2,0,2,0,IMG_4219_JPG.rf.81654d924a576c094f3f57b813e83fa9.jpg
3_deformable_detr,fold_9,6,5,4,1,-1,IMG_20230512_153107_jpg.rf.1ec84b2b739232a85f9ad467ee8a214f.jpg
3_deformable_detr,fold_10,14,9,6,3,-5,IMG_20230512_150109_804_jpg.rf.e638755720658c18627b68883d0270d6.jpg
3_deformable_detr,fold_10,13,14,13,1,1,IMG_4205_JPG.rf.e6945a0f8c8342f636251e46e904f729.jpg
3_deformable_detr,fold_10,1,1,0,1,0,IMG_20230512_145046_815_jpg.rf.bccba2de087b0c29681bdd4ff7c199f1.jpg
3_deformable_detr,fold_10,12,12,12,0,0,20230512_153030_jpg.rf.447a01796d662b57a717346a6885bdc7.jpg
3_deformable_detr,fold_10,29,14,13,1,-15,20230512_153308_jpg.rf.1f2393c128a7608a2a6b40892e5c576d.jpg
3_deformable_detr,fold_10,21,11,10,1,-10,20230512_150151_jpg.rf.73a61752872f6ef725371184031d1666.jpg
3_deformable_detr,fold_10,1,1,1,0,0,20230512_151711_jpg.rf.10c1db788e52a7dfc81744f4936a3ef0.jpg
3_deformable_detr,fold_10,5,5,5,0,0,20230512_152341_jpg.rf.67a7bff5a653064d0fbb2dfa8b1f90ce.jpg
3_deformable_detr,fold_10,1,1,1,0,0,20230512_150750_jpg.rf.e86dd1819063fd640c2ba43c41a741f8.jpg
3_deformable_detr,fold_10,10,9,9,0,-1,IMG_20230512_145121_jpg.rf.690688dd9055bfc063e326aa4fef07f4.jpg
3_deformable_detr,fold_10,3,2,2,0,-1,20230512_152340_jpg.rf.cfcfb6148dee3cdf12d6d85f1d247895.jpg
3_deformable_detr,fold_10,5,5,5,0,0,20230512_152235_jpg.rf.08f40afdb24635f6dcfbb88615a2f9f7.jpg
3_deformable_detr,fold_10,9,8,8,0,-1,20230512_152302_jpg.rf.6925e24fe61ef38107dc845cce1a2d60.jpg
3_deformable_detr,fold_10,1,4,1,3,3,IMG_20230512_151207_jpg.rf.ae49ac5f1949da487c30a4f4ba31817b.jpg
3_deformable_detr,fold_10,16,10,7,3,-6,20230512_150011_jpg.rf.1da3e5f3e295949ab4854def4bdbd922.jpg
3_deformable_detr,fold_10,3,1,1,0,-2,IMG_20230512_145025_jpg.rf.c0282883e0ec5ffed07135f0bda0ecfa.jpg
3_deformable_detr,fold_10,4,5,4,1,1,20230512_151843_jpg.rf.b93560c5fdb00199587ea962c11d4103.jpg
3_deformable_detr,fold_10,4,1,1,0,-3,20230512_145326_jpg.rf.e57a46b969b04ee9d16c309181d71fe7.jpg
3_deformable_detr,fold_10,1,0,0,0,-1,20230512_153428_jpg.rf.ebef48003f439c4f546df0dab6aff50b.jpg
3_deformable_detr,fold_10,23,13,13,0,-10,IMG_20230512_150120_jpg.rf.4b23fdc5feb46ad8a31de385747c52bc.jpg
3_deformable_detr,fold_10,4,5,4,1,1,IMG_3990_JPG.rf.7d3c75f1558f8f5fc9ac7eb6789e10dc.jpg
3_deformable_detr,fold_10,8,5,4,1,-3,20230512_150819_jpg.rf.d1513f98969bc1b7ac4e870d3cdb41e6.jpg
3_deformable_detr,fold_10,12,8,8,0,-4,20230512_151038_jpg.rf.6caba5860602aa931872edf19ec2b6c5.jpg
3_deformable_detr,fold_10,1,0,0,0,-1,IMG_20230512_145146_354_jpg.rf.6de83b52b9e3abba9866d24be95f4c4d.jpg
3_deformable_detr,fold_10,7,5,5,0,-2,IMG_4190_JPG.rf.7081f39db6690560b3a2bdd4cbc00d86.jpg
3_deformable_detr,fold_10,3,3,3,0,0,IMG_20230512_145252_021_jpg.rf.1779d92134a07ec7f57f4438113bb031.jpg
3_deformable_detr,fold_10,12,11,11,0,-1,230512_150135_jpg.rf.cc24c1ff5e0e940d16df6a7b71d2eabd.jpg
3_deformable_detr,fold_10,5,7,5,2,2,IMG_20230512_151042_jpg.rf.15dee8949138ef80373228e81079c023.jpg
3_deformable_detr,fold_10,6,7,5,2,1,IMG_20230512_151950_jpg.rf.c8c0371384e1a2262fdd3d8a53e11fa3.jpg
3_deformable_detr,fold_10,1,1,1,0,0,IMG_20230512_151703_jpg.rf.28a7fdeaae4d54d7cf2de4be9ed4df40.jpg
3_deformable_detr,fold_10,11,8,8,0,-3,20230512_150147_jpg.rf.55aa66e580136cb844b6c51dff5d3fed.jpg
3_deformable_detr,fold_10,37,16,13,3,-21,20230512_150235_jpg.rf.4361e97cfeccf708272ffe4ece69dbfd.jpg
3_deformable_detr,fold_10,2,1,1,0,-1,IMG_20230512_144940_500_jpg.rf.75e33e87c9ad9b74dd1e4b3091ba269f.jpg
3_deformable_detr,fold_10,5,5,4,1,0,20230512_145410_jpg.rf.56000063a0c914b346f9cd7261abac1e.jpg
3_deformable_detr,fold_10,1,1,1,0,0,IMG_4033_JPG.rf.d1e341639e4e7d193425664e20325a4c.jpg
3_deformable_detr,fold_10,14,2,2,0,-12,IMG_20230512_150125_134_jpg.rf.88679af4628e0ef4675fe385a333d31c.jpg
3_deformable_detr,fold_10,13,11,11,0,-2,20230512_151904_jpg.rf.7f72f44e41b8a58e5db1391fa2b35a42.jpg
3_deformable_detr,fold_10,2,2,2,0,0,20230512_151841-0-_jpg.rf.601490af90bd9514d0d590298e1f0255.jpg
3_deformable_detr,fold_10,5,4,4,0,-1,20230512_145357_jpg.rf.90422bd2b26f6dd0bd566293b4b30bb5.jpg
3_deformable_detr,fold_10,9,6,6,0,-3,IMG_20230512_151951_jpg.rf.31e79520ea845227f969872a61796113.jpg
3_deformable_detr,fold_10,1,1,1,0,0,20230512_151646_jpg.rf.6320d2328bf6de098fff781bcffac0cb.jpg
3_deformable_detr,fold_10,20,16,15,1,-4,IMG_3903_JPG.rf.7c248f88ef915e14444c5c43dc048c82.jpg
3_deformable_detr,fold_10,3,3,3,0,0,IMG_20230512_151830_jpg.rf.c0f3338eb7af1f0e178971c38c7dec04.jpg
3_deformable_detr,fold_10,9,8,6,2,-1,IMG_20230512_144958_jpg.rf.0a6117e6c2ebbfabe543484d7a8056db.jpg
3_deformable_detr,fold_10,4,3,3,0,-1,IMG_4095_JPG.rf.58645f8fad94bdb38886e47695cfd8cd.jpg
3_deformable_detr,fold_10,4,4,4,0,0,20230512_152345_jpg.rf.2717f971fd14976a3492abb509e947cb.jpg
3_deformable_detr,fold_10,2,2,2,0,0,IMG_3920_JPG.rf.24878eeb02230840f60014978ff530d7.jpg
3_deformable_detr,fold_10,9,6,5,1,-3,IMG_20230512_150046_jpg.rf.6e840be1f4fa3a56d132b04b6e288480.jpg
3_deformable_detr,fold_10,9,7,6,1,-2,IMG_20230512_145258_jpg.rf.a062df356e44019699d3c53596d3540e.jpg
3_deformable_detr,fold_10,1,1,1,0,0,IMG_20230512_161348_jpg.rf.aea1bf3794b2d077c45245810c001a1c.jpg
3_deformable_detr,fold_10,8,7,7,0,-1,230512_150139_jpg.rf.2d8a8d2ed426f1cb21935b033da8b2f6.jpg
3_deformable_detr,fold_10,14,11,11,0,-3,IMG_20230512_151610_001_jpg.rf.88fda6a270dac232937c53d6188fa5a9.jpg
3_deformable_detr,fold_10,1,1,0,1,0,230512_145108_jpg.rf.cf20720f57cffcf1f9fa31cecfe67fbf.jpg
3_deformable_detr,fold_10,1,1,1,0,0,IMG_3857_JPG.rf.c98e2825881d870a7242c7271763f36b.jpg
3_deformable_detr,fold_10,4,2,2,0,-2,20230512_151024_jpg.rf.a0cfadc35d426648ee3656824927c11e.jpg
3_deformable_detr,fold_10,1,1,1,0,0,0036_jpg.rf.6d90090548975dc2e489ef2ff1546863.jpg
3_deformable_detr,fold_10,2,2,2,0,0,20230512_152306_jpg.rf.a7141e38fe1a72a82a763e55d71fd0b5.jpg
3_deformable_detr,fold_10,15,9,8,1,-6,20230512_150018_jpg.rf.3bc690cd3af7d48b107dc3a68930fc2f.jpg
3_deformable_detr,fold_10,7,4,4,0,-3,IMG_20230512_151112_jpg.rf.6600a13c525e7d830908b03b8a0d3526.jpg
3_deformable_detr,fold_10,14,13,13,0,-1,0057_jpg.rf.850f7a1e0cc045be1a9326878338232a.jpg
3_deformable_detr,fold_10,7,7,7,0,0,0051_jpg.rf.e81d23e22a72795f3bbc83a62bd65cae.jpg
3_deformable_detr,fold_10,4,3,3,0,-1,0006_jpg.rf.ea818ccdacee9dd00131e372a19cf0d0.jpg
3_deformable_detr,fold_10,22,7,7,0,-15,20230512_150013_jpg.rf.88f9a3a7e9a79d06352d99a9a40fcfb5.jpg
3_deformable_detr,fold_10,1,0,0,0,-1,IMG_20230512_151605_jpg.rf.cd36cb9aab7833e1d827ed72719f9742.jpg
3_deformable_detr,fold_10,7,3,3,0,-4,20230512_150940_jpg.rf.a642f28b441714d9d9e22de0ad22f124.jpg
3_deformable_detr,fold_10,24,9,9,0,-15,0512_150306_jpg.rf.b16cedf3571182816f46e3a952d5c39a.jpg
3_deformable_detr,fold_10,3,8,3,5,5,20230512_152308_jpg.rf.f4dc38f04cbc5fd664dec02e3ed16103.jpg
3_deformable_detr,fold_10,2,2,2,0,0,IMG_20230512_151812_jpg.rf.86425b9d53f765e1b77d6eba211405fe.jpg
3_deformable_detr,fold_10,12,8,7,1,-4,20230512_152316_jpg.rf.dd8d1d54a326eb9ed9a63bc5520eadad.jpg
3_deformable_detr,fold_10,2,2,2,0,0,20230512_152213_jpg.rf.1125dc3c4a87888cb65b2d513aa9df85.jpg
3_deformable_detr,fold_10,17,9,9,0,-8,IMG_20230512_150147_169_jpg.rf.df6bd6535b4bdd11e20a358e10a11c09.jpg
3_deformable_detr,fold_10,10,10,10,0,0,IMG_4100_JPG.rf.f55f9f2afb5f41daaa63474d6df30725.jpg
3_deformable_detr,fold_10,23,19,19,0,-4,IMG_20230512_153004_jpg.rf.19c27a824e3c2f07149751bcaaa47c7f.jpg
3_deformable_detr,fold_10,1,1,1,0,0,20230512_151648_jpg.rf.f5ddd2e522a504da5dc723bdc2dec390.jpg
3_deformable_detr,fold_10,2,3,1,2,1,0005_jpg.rf.79044c26eeb52526a25a3f38e1aa840d.jpg
3_deformable_detr,fold_10,4,1,1,0,-3,IMG_20230512_145001_113_jpg.rf.5ea2af9825ef6b6ebe2436d89dbe79ca.jpg
3_deformable_detr,fold_10,1,1,1,0,0,IMG_4183_JPG.rf.1c0ab4bee811c122c1ef5f9131477050.jpg
3_deformable_detr,fold_10,2,1,1,0,-1,20230512_151124_jpg.rf.250cebbf32ee5a6ab788e62fd50ecf2c.jpg
3_deformable_detr,fold_10,3,2,2,0,-1,IMG_4022_JPG.rf.e15de99fae6d1e74eb63284f3616a75f.jpg
3_deformable_detr,fold_10,7,6,6,0,-1,20230512_152319_jpg.rf.abeccdd8fbdc8f18e24c3acdf6c07d48.jpg
3_deformable_detr,fold_10,25,15,14,1,-10,IMG_3911_JPG.rf.1bb0ec60809450d49cc43c3d8a1265de.jpg
3_deformable_detr,fold_10,6,11,6,5,5,20230512_151418_jpg.rf.90e438577c310e46b8a21f2ae0b85242.jpg
3_deformable_detr,fold_10,9,8,7,1,-1,20230512_153311_jpg.rf.3ecbca1f6ffb06d59119f6627139da8a.jpg
3_deformable_detr,fold_10,5,5,3,2,0,20230512_150206_jpg.rf.8ae1878e1b65e9920f1a99af4f941d9c.jpg
3_deformable_detr,fold_10,3,2,2,0,-1,IMG_4389_JPG.rf.d64ad350bc28019aa4851039e73dfdfa.jpg
3_deformable_detr,fold_10,10,4,3,1,-6,0512_150317_jpg.rf.a70fbe5816d46c9fa83979febbeb753f.jpg
3_deformable_detr,fold_10,7,6,4,2,-1,20230512_145440_jpg.rf.faac237167337f22dcbfb3879916747e.jpg
3_deformable_detr,fold_10,14,6,5,1,-8,20230512_150138_jpg.rf.baad1e97bbf234f37489ac66f024a808.jpg
3_deformable_detr,fold_10,12,10,9,1,-2,20230512_150159_jpg.rf.15a7a075343358e808fef60d09b7b8c3.jpg
3_deformable_detr,fold_10,2,2,1,1,0,IMG_20230512_151004_jpg.rf.fa632ed53260b0c0873743bd4155a490.jpg
3_deformable_detr,fold_10,6,4,4,0,-2,IMG_20230512_151929_jpg.rf.8916d2cec0ed6feba243725d4795cee6.jpg
3_deformable_detr,fold_10,6,2,2,0,-4,20230512_150108_jpg.rf.114d86f5dc5d95e4469bf960bc7c0a4f.jpg
3_deformable_detr,fold_10,10,9,8,1,-1,0014_jpg.rf.69fba8cc80a5714926e6841f224baffc.jpg
3_deformable_detr,fold_10,1,1,1,0,0,IMG_20230512_145359_479_jpg.rf.6b65f34991508137d8d33789257462e4.jpg
3_deformable_detr,fold_10,5,4,3,1,-1,MG_20230512_145100_jpg.rf.2fac7875b124670b96ab0a3b253f2e29.jpg
3_deformable_detr,fold_10,6,4,4,0,-2,20230512_151747_jpg.rf.f2ca78e158d0f2965152169425291a5a.jpg
3_deformable_detr,fold_10,9,8,8,0,-1,230512_150154_jpg.rf.6b065a843e8b776c3731c23f8a875399.jpg
3_deformable_detr,fold_10,1,1,1,0,0,20230512_145117_jpg.rf.1ad15540d0fbbd6bac016639ff1c07a3.jpg
3_deformable_detr,fold_10,4,4,3,1,0,20230512_145248_jpg.rf.8a3953be78b4c9d70df1b12fd15d4939.jpg
3_deformable_detr,fold_10,2,1,1,0,-1,IMG_3836_JPG.rf.434cd50ae74cfc4c9d1e3085a73a905b.jpg
3_deformable_detr,fold_10,8,7,5,2,-1,20230512_150949_jpg.rf.81b6e460185cb992a26ccccb5e72b394.jpg
3_deformable_detr,fold_10,11,11,11,0,0,IMG_20230512_152452_jpg.rf.849169ae208c086f88f01686f87e3c82.jpg
3_deformable_detr,fold_10,12,13,11,2,1,IMG_aaaa_jpg.rf.6f8cea923b21b011dca38cdc115eaf80.jpg
3_deformable_detr,fold_10,1,0,0,0,-1,IMG_20230512_145313_jpg.rf.3ae2ff3ddf2bb75af26203bf8cca362c.jpg
3_deformable_detr,fold_10,14,12,12,0,-2,IMG_20230512_151605_536_jpg.rf.39cf087a8f42f961dca0c0caa4dfa17d.jpg
3_deformable_detr,fold_10,8,7,7,0,-1,20230512_145342_jpg.rf.b956dcb9a2579c2e8f754353e1d00c75.jpg
3_deformable_detr,fold_10,8,6,6,0,-2,IMG_4193_JPG.rf.ee7ebd7c653b26c381990c2e3f69556f.jpg
3_deformable_detr,fold_10,5,4,4,0,-1,IMG_20230512_151457_jpg.rf.49e2e6a56131fab5a439e78b087a3b8a.jpg
3_deformable_detr,fold_10,1,1,1,0,0,20230512_145224_jpg.rf.b8204cbb29051890879b714634f912b6.jpg
3_deformable_detr,fold_10,11,8,7,1,-3,IMG_20230512_152257_409_jpg.rf.8463210402c73719c09f0b2210f7cfb4.jpg
3_deformable_detr,fold_10,16,10,9,1,-6,20230512_152313_jpg.rf.cae2b30990ff4679b62bdf438fbd8044.jpg
3_deformable_detr,fold_10,1,0,0,0,-1,0230512_145347_jpg.rf.58a6f73f43efb9705bb2978f49927337.jpg
3_deformable_detr,fold_10,9,8,8,0,-1,0034_jpg.rf.d4c6d4e1816e57648e3dbb1782385073.jpg
3_deformable_detr,fold_10,2,3,1,2,1,IMG_20230512_151611_jpg.rf.b44877740f7dd0dc052351bbded2044b.jpg
3_deformable_detr,fold_10,17,11,11,0,-6,230512_150149_jpg.rf.b74d07f3292d3144d25facf3dde243dc.jpg
3_deformable_detr,fold_10,59,45,35,10,-14,IMG_20230512_153218_jpg.rf.cac514c0d5c15fe1628359a5bfa2dacb.jpg
3_deformable_detr,fold_10,6,3,3,0,-3,IMG_20230512_145054_075_jpg.rf.5e98b15c8a4633098064286c64be239e.jpg
3_deformable_detr,fold_10,5,1,1,0,-4,IMG_20230512_151259_jpg.rf.7b57c2547bbd877ef1243a2ab325c2fa.jpg
3_deformable_detr,fold_10,70,39,30,9,-31,20230512_153220_jpg.rf.660dfd8464712797760cfa3b49fef4e7.jpg
3_deformable_detr,fold_10,9,5,5,0,-4,IMG_4186_JPG.rf.c6b51e615ccecf25291d4d3bd703172a.jpg
3_deformable_detr,fold_10,4,0,0,0,-4,20230512_144950_jpg.rf.b105c1ba7257a4da1b17c9f42de1770a.jpg
3_deformable_detr,fold_10,9,5,5,0,-4,IMG_20230512_145304_jpg.rf.7de02525de42506dbd7eda7365fd0065.jpg
3_deformable_detr,fold_10,4,3,3,0,-1,20230512_145209_jpg.rf.c73d398c69a90599525e2c2a8cb51f2c.jpg
3_deformable_detr,fold_10,3,3,3,0,0,20230512_151741_jpg.rf.989b1ddb73b99e41bd2bddfcf1c60e1d.jpg
3_deformable_detr,fold_10,2,2,2,0,0,20230512_152209_jpg.rf.c79a1a42b4846b485a9b00d575fb1626.jpg
3_deformable_detr,fold_10,17,13,12,1,-4,20230512_152258_jpg.rf.485967412d3788c1a657a3be4d77671e.jpg
3_deformable_detr,fold_10,2,2,2,0,0,IMG_20230512_151818_jpg.rf.593796b492f80d2ddd3e0449eec86414.jpg
3_deformable_detr,fold_10,1,1,1,0,0,20230512_145110_jpg.rf.02ac7002fe460313bbf3d2c9d99f8ba7.jpg
3_deformable_detr,fold_10,4,2,2,0,-2,IMG_3907_JPG.rf.b1def63b2acf54c44c0c502aca5f4d44.jpg
3_deformable_detr,fold_10,1,1,1,0,0,20230512_150722_jpg.rf.811e652f271c46d6a3e10299f1a6b7d9.jpg
3_deformable_detr,fold_10,1,0,0,0,-1,20230512_145243_jpg.rf.6f06c25acca67180648bf428a474f0b3.jpg
3_deformable_detr,fold_10,2,2,2,0,0,20230512_145053_jpg.rf.dd5c06f85a2f9673d635a3b60256df27.jpg
3_deformable_detr,fold_10,1,1,1,0,0,IMG_20230512_151236_jpg.rf.697c89d65f7f53a2cf18544c923eb896.jpg
3_deformable_detr,fold_10,1,1,1,0,0,0230512_145425_jpg.rf.f4fcff283a6f3d5ea4f0275a52a87728.jpg
3_deformable_detr,fold_10,24,20,19,1,-4,0001_jpg.rf.0c630bace393ba8970fa7c3c8fd7c235.jpg
3_deformable_detr,fold_10,8,7,7,0,-1,20230512_152317_jpg.rf.fddebbf7fe2a035df51e17bb0c14e2b4.jpg
3_deformable_detr,fold_10,9,6,6,0,-3,IMG_4209_JPG.rf.093053ef31116bcee7646b801c678d5b.jpg
3_deformable_detr,fold_10,23,13,12,1,-10,20230512_150122_jpg.rf.cb6d477ccda3127b4d473101af503eb3.jpg
3_deformable_detr,fold_10,4,4,4,0,0,20230512_152326_jpg.rf.8ca5737543dbfcb717b333d32cc18f8b.jpg
3_deformable_detr,fold_10,1,2,0,2,1,20230512_145056_jpg.rf.2bbf028730f3b9804aa416234c6db613.jpg
3_deformable_detr,fold_10,6,5,5,0,-1,0037_jpg.rf.e51421425c8718d498a1cc958bfeeb2b.jpg
3_deformable_detr,fold_10,10,7,7,0,-3,IMG_20230512_153400_jpg.rf.5f42ce4759cb794127f4f23098e0ff58.jpg
3_deformable_detr,fold_10,8,8,8,0,0,20230512_151848_jpg.rf.2c6000bd3b3f3ae44c8e672b08aec3b5.jpg
3_deformable_detr,fold_10,23,2,2,0,-21,IMG_20230512_153450_jpg.rf.af0e93ea32d0b17c0b616de937189066.jpg
3_deformable_detr,fold_10,3,3,3,0,0,IMG_3921_JPG.rf.e8186af83ff3af27612213a05a7c5177.jpg
3_deformable_detr,fold_10,10,7,6,1,-3,IMG_20230512_145056_jpg.rf.340c9781ae519c2a173e9014c5be4072.jpg
3_deformable_detr,fold_10,5,1,1,0,-4,20230512_145001_jpg.rf.ac3499ee309bec2035194be16f5da378.jpg
3_deformable_detr,fold_10,1,0,0,0,-1,20230512_145104_jpg.rf.a25f0f63e3b58e348bedb4aa97e67394.jpg
3_deformable_detr,fold_10,38,3,3,0,-35,0512_150303_jpg.rf.54131a2e7501a146e0d64448ccb7d595.jpg
3_deformable_detr,fold_10,1,1,0,1,0,20230512_145308_jpg.rf.692ac823c338ea1cdf326339c51eb5b1.jpg
3_deformable_detr,fold_10,7,6,6,0,-1,0060_jpg.rf.a0b1380ab0b6548c6335a9f12bb9f9f5.jpg
3_deformable_detr,fold_10,1,1,1,0,0,IMG_20230512_150846_jpg.rf.f9a1c340f4f40ffecf79883a50c53a30.jpg
3_deformable_detr,fold_10,11,11,11,0,0,20230512_151902_jpg.rf.0d916693ef179e70195af9fd22402789.jpg
3_deformable_detr,fold_10,13,10,9,1,-3,IMG_4211_JPG.rf.76ca0821ebf56f29d1009eb9ff45a384.jpg
3_deformable_detr,fold_10,10,12,9,3,2,IMG_20230512_153020_jpg.rf.e9080cc66a8631a1e9e4e610e61bc6a4.jpg
3_deformable_detr,fold_10,14,12,11,1,-2,20230512_153059_jpg.rf.48d36662c46f21f6e2c61dbaa81b1253.jpg
3_deformable_detr,fold_10,6,4,4,0,-2,IMG_20230512_145113_jpg.rf.0828a4e83c0458a5f8bc5967b29e1db1.jpg
3_deformable_detr,fold_10,1,1,1,0,0,20230512_145418_jpg.rf.8af049af1c5b2eb413647f320a119a74.jpg
4_faster_rcnn,fold_1,2,2,2,0,0,20230512_153003_jpg.rf.3e11918b7e073ed9642c3d889f82a10b.jpg
4_faster_rcnn,fold_1,3,4,3,1,1,20230512_152344_jpg.rf.9cdeba0a7faf9c91db6a1bec355cd79f.jpg
4_faster_rcnn,fold_1,8,8,8,0,0,20230512_150202_jpg.rf.2d354a6afba7660a4bdb4422aacb0bf1.jpg
4_faster_rcnn,fold_1,2,2,2,0,0,20230512_151842_jpg.rf.0400a2b89be930a6aee77dd6416cc317.jpg
4_faster_rcnn,fold_1,1,1,1,0,0,20230512_153001_jpg.rf.9e1933e066ac83bf9fbd01b8def6158d.jpg
4_faster_rcnn,fold_1,6,6,6,0,0,IMG_4052_JPG.rf.a484ba8b08f647c9d706f26a2c1bdd88.jpg
4_faster_rcnn,fold_1,1,1,0,1,0,IMG_3933_JPG.rf.b0d6e8cf999e8234386ed5bb6107f61a.jpg
4_faster_rcnn,fold_1,23,6,6,0,-17,20230512_153423_jpg.rf.199d17397bc75e4b3c997992a9469adb.jpg
4_faster_rcnn,fold_1,1,1,0,1,0,230512_150115_jpg.rf.048aa47fa124320a4fa8a5c30506622b.jpg
4_faster_rcnn,fold_1,8,6,6,0,-2,20230512_152239_jpg.rf.5270f7fe5715e9e4db1967390d36c76d.jpg
4_faster_rcnn,fold_1,7,7,6,1,0,IMG_20230512_152358_jpg.rf.14382fa8e1d185e8ecd9b6b625021b8f.jpg
4_faster_rcnn,fold_1,1,1,1,0,0,20230512_151657_jpg.rf.ae916e776287bd8044bda6da1e1dec7e.jpg
4_faster_rcnn,fold_1,2,1,1,0,-1,IMG_4202_JPG.rf.389eb0baa38b2b42b82e272dae53dd7b.jpg
4_faster_rcnn,fold_1,10,13,5,8,3,20230512_150031_jpg.rf.5b7cf141f46aecb85b2c9e4f6977aa4c.jpg
4_faster_rcnn,fold_1,4,6,4,2,2,IMG_20230512_151251_jpg.rf.13115516a78a5324e008f7864789fbec.jpg
4_faster_rcnn,fold_1,17,11,9,2,-6,20230512_150005_jpg.rf.77d140d77f3f48953c783c2d50e6f910.jpg
4_faster_rcnn,fold_1,1,0,0,0,-1,20230512_150058_jpg.rf.daa9ab4c09a0e2a557b1e8bb54702ecb.jpg
4_faster_rcnn,fold_1,6,6,6,0,0,20230512_152201_jpg.rf.3c9e01b2433736fc6ee290b90dd42684.jpg
4_faster_rcnn,fold_1,6,4,4,0,-2,IMG_20230512_151219_jpg.rf.6d76721a015ae20af4047ec2607a62e0.jpg
4_faster_rcnn,fold_1,19,17,13,4,-2,IMG_20230512_150136_jpg.rf.004497d9e0b84ae3cd5c8e7e5e9f30d7.jpg
4_faster_rcnn,fold_1,32,26,21,5,-6,0008_jpg.rf.94e89ad01289e8cfda380621151bf1bb.jpg
4_faster_rcnn,fold_1,1,1,1,0,0,IMG_4027_JPG.rf.02fde7996d0a3e63cd8727ba35b98fbd.jpg
4_faster_rcnn,fold_1,7,5,5,0,-2,IMG_4051_JPG.rf.1f19a2adfb075e1a7c5d3d9567879ae2.jpg
4_faster_rcnn,fold_1,3,3,2,1,0,IMG_20230512_145126_jpg.rf.0493bac7dcca35f2a361df2325097b88.jpg
4_faster_rcnn,fold_1,4,3,3,0,-1,0004_jpg.rf.7a14cc5ff08b5ee1437266474bc51865.jpg
4_faster_rcnn,fold_1,1,1,1,0,0,20230512_151446_jpg.rf.801ee52ac482b80a6b7e2c7a7a896dc7.jpg
4_faster_rcnn,fold_1,1,1,0,1,0,20230512_153217_jpg.rf.3d66bba80f697d614260fc56dd593486.jpg
4_faster_rcnn,fold_1,23,10,4,6,-13,20230512_150312_jpg.rf.2040a566a6e8aa7d77563942d16e3907.jpg
4_faster_rcnn,fold_1,4,4,4,0,0,20230512_153409_jpg.rf.b9be0a0b5dc71b17d03a58db2af65fd3.jpg
4_faster_rcnn,fold_1,1,1,1,0,0,20230512_145140_jpg.rf.3d71f74b4ed8a93a636f79ef1a9a7e9c.jpg
4_faster_rcnn,fold_1,7,6,6,0,-1,0002_jpg.rf.d16d3de92655da222f9470322637f0a1.jpg
4_faster_rcnn,fold_1,2,3,2,1,1,IMG_20230512_153111_jpg.rf.71fdfa6f08329e5d2412e86bf6870b02.jpg
4_faster_rcnn,fold_1,3,3,3,0,0,IMG_20230512_151306_jpg.rf.e4b348fae9b8d16d80a5be211e9e39a1.jpg
4_faster_rcnn,fold_1,7,3,3,0,-4,20230512_150132_jpg.rf.b204b63d3e3f8ef2920b32f1e0b6ab50.jpg
4_faster_rcnn,fold_1,3,3,3,0,0,IMG_20230512_151314_jpg.rf.231b8a97bc932aa622a2b27c80ee878b.jpg
4_faster_rcnn,fold_1,1,1,1,0,0,20230512_145419_jpg.rf.cf9776dd6ff86988e3d4a8734ba6f15c.jpg
4_faster_rcnn,fold_1,1,1,1,0,0,IMG_20230512_161355_jpg.rf.f1c1af37db10bfc139da92a922fa83a2.jpg
4_faster_rcnn,fold_1,1,2,1,1,1,IMG_20230512_151815_jpg.rf.fad6e45cfa5e7c506e9fbad254cef9e0.jpg
4_faster_rcnn,fold_1,6,6,5,1,0,IMG_3922_JPG.rf.4fa3ab6d4b090dd6a9114495e5b5a468.jpg
4_faster_rcnn,fold_1,37,18,12,6,-19,IMG_20230512_150214_jpg.rf.0a3e70748a25dbc7ca5305e84da8d3cd.jpg
4_faster_rcnn,fold_1,5,5,5,0,0,20230512_152251_jpg.rf.ebcf28d3c9a35107daa9beb28ae3475b.jpg
4_faster_rcnn,fold_1,2,1,0,1,-1,20230512_151110_jpg.rf.53961421a4e7bd7511e281309a72a2c9.jpg
4_faster_rcnn,fold_1,2,2,2,0,0,20230512_151630_jpg.rf.ecc81d9067cb1ce5be1c14f9a6d71d9d.jpg
4_faster_rcnn,fold_1,11,2,2,0,-9,IMG_20230512_145044_jpg.rf.d79716a7705a23a496d5d4896dbcf506.jpg
4_faster_rcnn,fold_1,1,1,1,0,0,20230512_145031_jpg.rf.0c829f489393188e9f1ecc0ff78d8324.jpg
4_faster_rcnn,fold_1,1,1,1,0,0,20230512_151712_jpg.rf.c494c6b379e948f9f084efcd40c0619d.jpg
4_faster_rcnn,fold_1,13,14,12,2,1,20230512_153109_jpg.rf.930610a4b0e78acb8ed778e44b9d5922.jpg
4_faster_rcnn,fold_1,4,6,4,2,2,IMG_20230512_151205_jpg.rf.2bbe055a56edab8e820150d32613da40.jpg
4_faster_rcnn,fold_1,2,3,0,3,1,20230512_150059-0-_jpg.rf.641cecd96312dfe886a8bf287b5916db.jpg
4_faster_rcnn,fold_1,2,2,1,1,0,20230512_145234_jpg.rf.d7e55e93d9f98a6de3d20ef7221babc8.jpg
4_faster_rcnn,fold_1,4,4,4,0,0,IMG_20230512_145359_jpg.rf.c0fb243e34926596f7a71595884ae8c5.jpg
4_faster_rcnn,fold_1,6,5,3,2,-1,20230512_145334_jpg.rf.0b72b785a7b59d3a4217025c7e5a2423.jpg
4_faster_rcnn,fold_1,10,10,8,2,0,20230512_152402_jpg.rf.2af7283a541e5a9a5150707a47c4be20.jpg
4_faster_rcnn,fold_1,2,3,2,1,1,20230512_145352_jpg.rf.c846cb3c36e5363cfaa577a44b6913d8.jpg
4_faster_rcnn,fold_1,23,17,15,2,-6,20230512_150226_jpg.rf.f79017b16f1532730f31cb325d6ab86e.jpg
4_faster_rcnn,fold_1,1,2,1,1,1,20230512_153345-0-_jpg.rf.6e0b5b843ebfea1138cb759960e1bafc.jpg
4_faster_rcnn,fold_1,2,1,1,0,-1,0036_jpg.rf.95bf6e3cde891a0e422157eafa8da143.jpg
4_faster_rcnn,fold_1,1,1,0,1,0,20230512_150121_jpg.rf.b7f710edf2464cb4724d24c65bae04b4.jpg
4_faster_rcnn,fold_1,1,1,1,0,0,20230512_150720_jpg.rf.a18892cc876f35236d2a20ba37b6efd8.jpg
4_faster_rcnn,fold_1,13,10,9,1,-3,20230512_153007_jpg.rf.d3b0e4362c8dc7fde7b007165efdd07e.jpg
4_faster_rcnn,fold_1,1,0,0,0,-1,20230512_144958_jpg.rf.bd51a27225a9ddf5ef21b54512e10b9b.jpg
4_faster_rcnn,fold_1,2,2,2,0,0,20230512_151201_jpg.rf.003d9f32250e51b928c51a05b230f55a.jpg
4_faster_rcnn,fold_1,5,1,0,1,-4,IMG_20230512_145247_597_jpg.rf.464f6c3eb3265be95f2f08e2d0bdd91a.jpg
4_faster_rcnn,fold_1,8,7,7,0,-1,20230512_152159_jpg.rf.f9d372b7fdee9c83d543f19d83accc75.jpg
4_faster_rcnn,fold_1,17,8,3,5,-9,IMG_20230512_150133_jpg.rf.e1213a79a5060e17585ebc484a3c63d6.jpg
4_faster_rcnn,fold_1,4,4,2,2,0,20230512_145007_jpg.rf.b9641853c4144bc1d5622b022182ed4b.jpg
4_faster_rcnn,fold_1,1,4,1,3,3,IMG_20230512_145057_967_jpg.rf.680792c5520fea6605bcf774a290cd8f.jpg
4_faster_rcnn,fold_1,2,2,2,0,0,20230512_151633_jpg.rf.a660ff615450152ab9fbed4d02eeb6d7.jpg
4_faster_rcnn,fold_1,8,8,7,1,0,IMG_4090_JPG.rf.677923e65dcfcc46588eee4c2c2c9e46.jpg
4_faster_rcnn,fold_1,10,10,10,0,0,20230512_152258_jpg.rf.2e43ef7a91920046b900730064da408d.jpg
4_faster_rcnn,fold_1,18,17,17,0,-1,20230512_152402_jpg.rf.5f60c1b7e4703f63b61c50a74049302f.jpg
4_faster_rcnn,fold_1,4,3,3,0,-1,20230512_151121_jpg.rf.d9f5fd5a912436d588c2e8a3681b8643.jpg
4_faster_rcnn,fold_1,15,12,12,0,-3,20230512_152310_jpg.rf.22fd13a135de99870e2b9f19a9dbd566.jpg
4_faster_rcnn,fold_1,15,13,11,2,-2,IMG_4206_JPG.rf.86dc764134fcaa91fd5246c96808ba7a.jpg
4_faster_rcnn,fold_1,1,1,1,0,0,20230512_145233_jpg.rf.9e2d494cc8579c52d6794c0fb5af14b7.jpg
4_faster_rcnn,fold_1,1,1,1,0,0,IMG_4014_JPG.rf.67af8816872a56054c245e272bdd23db.jpg
4_faster_rcnn,fold_1,11,9,9,0,-2,IMG_20230512_151956_jpg.rf.accb7456b90404e99398a8475aa5f074.jpg
4_faster_rcnn,fold_1,5,5,5,0,0,20230512_152221_jpg.rf.dfe82842e573d8a1a7ff0d4519256b1d.jpg
4_faster_rcnn,fold_1,35,14,12,2,-21,0512_150052_jpg.rf.6838fe76e0e5f7752c388cea428a676b.jpg
4_faster_rcnn,fold_1,3,3,2,1,0,IMG_20230512_150949_jpg.rf.0a7b1aca0bc2e95e7b33b4409d5f03e1.jpg
4_faster_rcnn,fold_1,5,5,4,1,0,20230512_145412_jpg.rf.9224a9f695664a7b936da6fb81af36c9.jpg
4_faster_rcnn,fold_1,10,10,9,1,0,20230512_151907_jpg.rf.8b3da1939d33aa65bfb85cb4ba33d685.jpg
4_faster_rcnn,fold_1,1,1,1,0,0,20230512_151037_jpg.rf.57044d376bf29efab4142e6e059723d3.jpg
4_faster_rcnn,fold_1,1,1,1,0,0,20230512_151510-0-_jpg.rf.8fdff95c003658062d05e4285948dcbb.jpg
4_faster_rcnn,fold_1,10,9,9,0,-1,20230512_151857_jpg.rf.d5917286f02e07a5305d7b858c6244ec.jpg
4_faster_rcnn,fold_1,2,2,2,0,0,IMG_20230512_151822_jpg.rf.cd5ee7cbb4e275377fc3e1ca11bd6a01.jpg
4_faster_rcnn,fold_1,18,15,15,0,-3,20230512_152223_jpg.rf.7b4c9b6ebd76c6c1084f1453a97610d9.jpg
4_faster_rcnn,fold_1,2,2,2,0,0,0015_jpg.rf.a767e21c0a0684765afe242b8052602a.jpg
4_faster_rcnn,fold_1,2,3,1,2,1,IMG_20230512_145027_jpg.rf.16a85daab3bfea64be4f44d4de24d8b4.jpg
4_faster_rcnn,fold_1,2,4,1,3,2,IMG_20230512_145337_jpg.rf.04c6c7ecd50fc9cd76f28da038eea12a.jpg
4_faster_rcnn,fold_1,4,3,3,0,-1,20230512_145119_jpg.rf.f0411939c238246ea7d83cb97f4b291a.jpg
4_faster_rcnn,fold_1,1,1,1,0,0,20230512_151618_jpg.rf.9cfdd92f0dd263ec71adc25e0966b10d.jpg
4_faster_rcnn,fold_1,21,21,17,4,0,20230512_150123_jpg.rf.ca38530fba79c2eea723776f3cb9701e.jpg
4_faster_rcnn,fold_1,8,9,8,1,1,IMG_20230512_151954_jpg.rf.1f74638dd64a022c7ddbc6b607ebb63f.jpg
4_faster_rcnn,fold_1,2,2,2,0,0,20230512_153358_jpg.rf.000b91eaf995cb7029bac19a97ae0eab.jpg
4_faster_rcnn,fold_1,3,2,2,0,-1,0030_jpg.rf.92e747a4b264c12a0f5bd7b7fff47c97.jpg
4_faster_rcnn,fold_1,2,1,1,0,-1,IMG_3838_JPG.rf.6259d7b6f664061333ba70518ffa409a.jpg
4_faster_rcnn,fold_1,47,33,25,8,-14,20230512_153205_jpg.rf.a397edfe98870b927aac7d426225215e.jpg
4_faster_rcnn,fold_1,3,1,1,0,-2,20230512_151421_jpg.rf.32f90f849ffd68e483c8af1c30cd3e88.jpg
4_faster_rcnn,fold_1,4,3,3,0,-1,20230512_150228_jpg.rf.bdef78abc0510427f86904d310db4ffe.jpg
4_faster_rcnn,fold_1,1,2,1,1,1,20230512_150729_jpg.rf.8d31acfa9500f54af8d12c1ddbddbd65.jpg
4_faster_rcnn,fold_1,1,0,0,0,-1,IMG_4221_JPG.rf.c34edb7d27501d2bebad754740f2c36d.jpg
4_faster_rcnn,fold_1,91,47,37,10,-44,20230512_153222_jpg.rf.02d4e5f1788464607b60d200b123696a.jpg
4_faster_rcnn,fold_1,15,14,14,0,-1,20230512_152343_jpg.rf.b78ec2e1eb5a82ab22cb447b29e60a37.jpg
4_faster_rcnn,fold_1,4,3,3,0,-1,20230512_145420_jpg.rf.63f8530ad3e9147d791de1d4a62e2845.jpg
4_faster_rcnn,fold_1,3,2,2,0,-1,IMG_20230512_145129_jpg.rf.7c57fcf634dd12adb9bd6bfb5ab72307.jpg
4_faster_rcnn,fold_1,3,3,3,0,0,IMG_20230512_152950_jpg.rf.7b0419faa0e6c3e396abcf1d3db70ba2.jpg
4_faster_rcnn,fold_1,7,6,6,0,-1,IMG_20230512_145458_jpg.rf.0869453997d27a12e193c3576f5be50f.jpg
4_faster_rcnn,fold_1,2,2,2,0,0,20230512_150320_jpg.rf.f00816162e753a50c482ccbb2723a8bb.jpg
4_faster_rcnn,fold_1,2,2,1,1,0,20230512_151501-0-_jpg.rf.ac937acab812f79dd846ec10e9eb794f.jpg
4_faster_rcnn,fold_1,4,4,4,0,0,IMG_20230512_151857_jpg.rf.f3b0a248067ce9c5df43e8eb1b7b8f48.jpg
4_faster_rcnn,fold_1,1,2,1,1,1,20230512_151507_jpg.rf.83b7b0f7341f0c68f2169ab2e25d50af.jpg
4_faster_rcnn,fold_1,4,5,4,1,1,IMG_4098_JPG.rf.d05c322cd8fa2c89a0d093e8e91666a2.jpg
4_faster_rcnn,fold_1,5,6,5,1,1,IMG_20230512_144938_jpg.rf.61fbc5c9c8be89bcb4b1529921428829.jpg
4_faster_rcnn,fold_1,9,6,6,0,-3,20230512_152348_jpg.rf.9a9f308e6e3d3ff1b666f67b5196d238.jpg
4_faster_rcnn,fold_1,2,1,1,0,-1,20230512_151131_jpg.rf.62d78c2e91ff2133e0623bbd8de03bda.jpg
4_faster_rcnn,fold_1,1,1,1,0,0,IMG_20230512_150905_jpg.rf.498fdb5cdf1e78cfffa9005586c25d1b.jpg
4_faster_rcnn,fold_1,1,1,1,0,0,20230512_145033_jpg.rf.5a4b7044f38311bf91bd61b2107f6208.jpg
4_faster_rcnn,fold_1,2,1,1,0,-1,0002_jpg.rf.244244e268805e9279e2778f66f93c67.jpg
4_faster_rcnn,fold_1,9,7,5,2,-2,IMG_20230512_145357_jpg.rf.65481eda27afaba20ecf66958bd1a415.jpg
4_faster_rcnn,fold_1,40,35,27,8,-5,IMG_20230512_150251_jpg.rf.2318a91c9b0a0d0c74b337b923e9e074.jpg
4_faster_rcnn,fold_1,4,4,3,1,0,IMG_20230512_145134_jpg.rf.084766d54cd58d09cacfc92914a1a5c7.jpg
4_faster_rcnn,fold_1,9,9,8,1,0,IMG_20230512_152000_jpg.rf.af9cbaac286010743e1eabfda3ff16fd.jpg
4_faster_rcnn,fold_1,3,4,2,2,1,20230512_145302_jpg.rf.52f6bff4360f5a174eb1a21d91490e2f.jpg
4_faster_rcnn,fold_1,4,2,2,0,-2,0013_jpg.rf.46c0cfad5d61b22f1717205aab02e682.jpg
4_faster_rcnn,fold_1,13,11,7,4,-2,20230512_152958_jpg.rf.43cafd5762e96ebdaf2638b5e2e5ede5.jpg
4_faster_rcnn,fold_1,1,1,1,0,0,IMG_20230512_145002_jpg.rf.a16310bc3cbd1bce46d8e207260f6d2f.jpg
4_faster_rcnn,fold_1,20,17,14,3,-3,20230512_150157_jpg.rf.8b6ad4dda7ad6b93ac57bd92f16dcdcd.jpg
4_faster_rcnn,fold_1,6,5,2,3,-1,IMG_20230512_144908_684_jpg.rf.89a536225f1a283e12d5bb8970ee31cb.jpg
4_faster_rcnn,fold_1,2,2,2,0,0,20230512_151455_jpg.rf.eb853c4caca8daef122f54e54ffa44ce.jpg
4_faster_rcnn,fold_1,3,3,3,0,0,IMG_20230512_151214_jpg.rf.885e6d5e144fd3b97b6ab96da191a928.jpg
4_faster_rcnn,fold_1,2,2,2,0,0,20230512_151744_jpg.rf.b461e1fdf32cd5c1232cf11220a2bef4.jpg
4_faster_rcnn,fold_1,7,7,7,0,0,IMG_3868_JPG.rf.1770b3eda4aaec864f7cf0d27d04888b.jpg
4_faster_rcnn,fold_1,7,5,5,0,-2,20230512_151845_jpg.rf.8dee8031c86ff6697d6d671e32b55f55.jpg
4_faster_rcnn,fold_1,17,10,8,2,-7,20230512_150009_jpg.rf.5eaca93499ee2328bb5b204bc086fa0e.jpg
4_faster_rcnn,fold_1,4,4,4,0,0,IMG_4055_JPG.rf.a1d3f9eab20829bc4aab9b5d5b3db316.jpg
4_faster_rcnn,fold_1,3,2,2,0,-1,20230512_145429_jpg.rf.df99f30a99cc1af30b8fe3054ff8d8af.jpg
4_faster_rcnn,fold_1,3,3,2,1,0,IMG_20230512_150829_549_jpg.rf.017095633151bc8caa1cad24d2d1f6bd.jpg
4_faster_rcnn,fold_1,10,5,4,1,-5,0230512_150206_jpg.rf.e404633a283ca64c43725aeb3181ac5b.jpg
4_faster_rcnn,fold_1,1,2,1,1,1,20230512_145044_jpg.rf.2dd273c7dcfa2783f4fc1f356c3e0fe1.jpg
4_faster_rcnn,fold_1,18,16,12,4,-2,IMG_20230512_153031_jpg.rf.5fce0e233ead5453574fecd0d970a691.jpg
4_faster_rcnn,fold_1,3,2,2,0,-1,IMG_4197_JPG.rf.f240386fc9d9d286399404892833ad93.jpg
4_faster_rcnn,fold_1,2,1,1,0,-1,MG_20230512_145132_jpg.rf.f7010b407a0b401d833ccbcf5807b8c7.jpg
4_faster_rcnn,fold_1,15,14,12,2,-1,20230512_151046_jpg.rf.8feca45b0b1694e2250d447c5e17a7e5.jpg
4_faster_rcnn,fold_1,21,13,8,5,-8,20230512_153045_jpg.rf.8ee689d2bb2062ede3d6c1a97a93cb0b.jpg
4_faster_rcnn,fold_1,2,3,2,1,1,0024_jpg.rf.d7ace9e90a7a9b7f0bac8fa590936bec.jpg
4_faster_rcnn,fold_1,1,1,1,0,0,20230512_151452_jpg.rf.f764099c780fa1069a9d911e32493b58.jpg
4_faster_rcnn,fold_1,2,3,2,1,1,0040_jpg.rf.510a2eea8b97902d00189cee85d647f2.jpg
4_faster_rcnn,fold_1,14,12,8,4,-2,IMG_20230512_144941_jpg.rf.26b2e56c21b9d1f982031b1a6c82b0cf.jpg
4_faster_rcnn,fold_1,6,5,4,1,-1,0230512_145304_jpg.rf.923a0f42aba114205181e2b5316865df.jpg
4_faster_rcnn,fold_1,14,8,7,1,-6,20230512_153445_jpg.rf.a406add89c229073e8dc9da3e87a1125.jpg
4_faster_rcnn,fold_1,11,11,10,1,0,IMG_20230512_144945_690_jpg.rf.8f6c97bc8ba7a4170c6509fdaf6dcb51.jpg
4_faster_rcnn,fold_1,3,3,3,0,0,20230512_150255_jpg.rf.06d14e4c4625afe9d0a55233a17ba81c.jpg
4_faster_rcnn,fold_1,1,1,1,0,0,20230512_145220_jpg.rf.9fc82d7b84c8883df1efc1dd7d51252b.jpg
4_faster_rcnn,fold_1,8,6,6,0,-2,IMG_20230512_151110_jpg.rf.43411da66d27f6993f2c94b13a408a1c.jpg
4_faster_rcnn,fold_1,1,0,0,0,-1,IMG_20230512_151305_326_jpg.rf.11e52599cf79be602d4d4480bd5cddda.jpg
4_faster_rcnn,fold_1,2,2,1,1,0,0230512_145048_jpg.rf.17eaa837f3d144d8a30470f44f61f75d.jpg
4_faster_rcnn,fold_2,11,10,8,2,-1,20230512_152307_jpg.rf.5ed444510318293300b04fc766ce4222.jpg
4_faster_rcnn,fold_2,1,1,1,0,0,20230512_144953_jpg.rf.8283a702fcffd9d6223570436e1bf3fa.jpg
4_faster_rcnn,fold_2,6,6,6,0,0,20230512_145403_jpg.rf.8df05cb3790b7b04d25d1e08e98dc443.jpg
4_faster_rcnn,fold_2,5,5,5,0,0,20230512_145345_jpg.rf.04a7df632b86568b244790bc2612f409.jpg
4_faster_rcnn,fold_2,1,1,1,0,0,IMG_20230512_151805_jpg.rf.394aa2e3fd7a17a935ec0df1f3258c2f.jpg
4_faster_rcnn,fold_2,1,0,0,0,-1,20230512_151500_jpg.rf.e32b98c8b02b5d583e07193899344442.jpg
4_faster_rcnn,fold_2,2,2,2,0,0,0230512_145313_jpg.rf.776dc937578790f899ad676b7712df5d.jpg
4_faster_rcnn,fold_2,1,1,1,0,0,20230512_145047_jpg.rf.95f8311e427ec6f1226783bcfa8aaeb0.jpg
4_faster_rcnn,fold_2,17,16,14,2,-1,IMG_20230512_152302_jpg.rf.e72dde5d8164d8312cbc60cf674ac1cc.jpg
4_faster_rcnn,fold_2,3,2,1,1,-1,20230512_145143_jpg.rf.e512219fc0a6a155cdc8d6e5375509c0.jpg
4_faster_rcnn,fold_2,17,16,13,3,-1,20230512_153128_jpg.rf.ea6f913ebe278f58559dcfc65c663e1e.jpg
4_faster_rcnn,fold_2,1,1,1,0,0,20230512_151801_jpg.rf.2c3c8c1015e6fae6858f400374255844.jpg
4_faster_rcnn,fold_2,2,1,0,1,-1,IMG_20230512_150319_jpg.rf.3ae187984f18f173dbb37b3a87dc2edc.jpg
4_faster_rcnn,fold_2,2,1,1,0,-1,IMG_20230512_145035_jpg.rf.e406d6ea6e2142bf078dc5712097970d.jpg
4_faster_rcnn,fold_2,11,5,4,1,-6,20230512_151045_jpg.rf.a6671c33872e0aa76aa195da177cfb2d.jpg
4_faster_rcnn,fold_2,6,3,3,0,-3,20230512_153159_jpg.rf.d07176029cb6d818c3ec89f10bf105eb.jpg
4_faster_rcnn,fold_2,2,1,0,1,-1,20230512_145258_jpg.rf.36afe6d426851a363b2a6a7d0c059a06.jpg
4_faster_rcnn,fold_2,9,9,4,5,0,0230512_145016_jpg.rf.c06fc10372ac7c1831d2d51452a8b3e8.jpg
4_faster_rcnn,fold_2,5,4,4,0,-1,20230512_151002_jpg.rf.948c61535288e6ba60980bb8fd2b67a6.jpg
4_faster_rcnn,fold_2,5,3,3,0,-2,IMG_20230512_150036_jpg.rf.6e167fde12f866a555cb292420cc966c.jpg
4_faster_rcnn,fold_2,21,20,15,5,-1,IMG_20230512_150108_jpg.rf.010507bacbd8da808ace5e119e09b182.jpg
4_faster_rcnn,fold_2,1,2,1,1,1,IMG_20230512_151210_354_jpg.rf.8bd99e3d531a171119a6ce1f73298053.jpg
4_faster_rcnn,fold_2,16,11,10,1,-5,0058_jpg.rf.0a179a6a2aa1a22cf6d0c2490fc3cca2.jpg
4_faster_rcnn,fold_2,2,2,2,0,0,20230512_150805_jpg.rf.c936fd2cb76b51c90f6b1886c1d67b07.jpg
4_faster_rcnn,fold_2,38,34,22,12,-4,0512_150128_jpg.rf.2af323c722a16ccc0c5aa34b5e501664.jpg
4_faster_rcnn,fold_2,7,8,4,4,1,20230512_150107_jpg.rf.5e11723e84aa6da5755cf3c63cf34d7e.jpg
4_faster_rcnn,fold_2,5,3,3,0,-2,IMG_20230512_152210_460_jpg.rf.ab8278e1877e151e4ae555c6237762a4.jpg
4_faster_rcnn,fold_2,1,1,1,0,0,IMG_20230512_161352_jpg.rf.55bade867ee284f39237788ac06b0acc.jpg
4_faster_rcnn,fold_2,1,0,0,0,-1,IMG_3833_JPG.rf.abe8bed2e2a60f385c89c035ed2e7754.jpg
4_faster_rcnn,fold_2,4,4,2,2,0,20230512_145400_jpg.rf.487d472b7875668199199822410b27fa.jpg
4_faster_rcnn,fold_2,3,3,3,0,0,0006_jpg.rf.4286dc69c06dcdbaf0df817343256a21.jpg
4_faster_rcnn,fold_2,4,3,3,0,-1,20230512_151752_jpg.rf.c6abd13d3824e552c45d2ae43cd156c3.jpg
4_faster_rcnn,fold_2,6,5,5,0,-1,20230512_145358_jpg.rf.42f74f37b3baefb9f8cb08628d322a69.jpg
4_faster_rcnn,fold_2,1,1,1,0,0,0230512_145420_jpg.rf.e077901cc39df12e7031754a04b4216f.jpg
4_faster_rcnn,fold_2,2,2,2,0,0,20230512_151441_jpg.rf.01b614d64de666a58fed8b8feea9004a.jpg
4_faster_rcnn,fold_2,12,12,7,5,0,20230512_153315_jpg.rf.7906c060598957a1e622c50902191cc1.jpg
4_faster_rcnn,fold_2,4,3,3,0,-1,0025_jpg.rf.f5d46a7f5f498531cada47eed608a3e7.jpg
4_faster_rcnn,fold_2,6,6,5,1,0,IMG_3832_JPG.rf.4a27d40741e9e24a57b4d4409e5bf699.jpg
4_faster_rcnn,fold_2,4,4,3,1,0,IMG_20230512_145422_423_jpg.rf.a2f634b682eede423e27173c65e298dc.jpg
4_faster_rcnn,fold_2,3,2,1,1,-1,IMG_20230512_145034_jpg.rf.b7070d4f3b8615f07e606e417094950b.jpg
4_faster_rcnn,fold_2,6,5,3,2,-1,20230512_151810-0-_jpg.rf.5bab122233efd5d6e060c2de01ae9475.jpg
4_faster_rcnn,fold_2,1,2,1,1,1,20230512_151649_jpg.rf.62f6a7ef7962197e1933352c3cf07e1d.jpg
4_faster_rcnn,fold_2,5,4,4,0,-1,20230512_151315_jpg.rf.7d9aa1fa6aeea9c557900122bb89076d.jpg
4_faster_rcnn,fold_2,1,0,0,0,-1,230512_150043_jpg.rf.997b92cbbb33f969daf86ff1c0a48495.jpg
4_faster_rcnn,fold_2,18,15,11,4,-3,IMG_4215_JPG.rf.f586481a5ed49d1952135b51b94a258f.jpg
4_faster_rcnn,fold_2,15,12,10,2,-3,IMG_20230512_152253_596_jpg.rf.e1455dadb47781b4e95ce4f0479c4643.jpg
4_faster_rcnn,fold_2,18,10,5,5,-8,IMG_20230512_150056_181_jpg.rf.337f1b254575b10ba95ca7a5b1e7e5aa.jpg
4_faster_rcnn,fold_2,13,7,6,1,-6,20230512_150029_jpg.rf.29ca99ad8a2b5956fdc7e21d1601c79f.jpg
4_faster_rcnn,fold_2,1,1,1,0,0,20230512_145239_jpg.rf.0d14eff09fc5186a9eccb0c477759e6b.jpg
4_faster_rcnn,fold_2,20,13,12,1,-7,20230512_153255_jpg.rf.72d8abd35f45fdaa52da9b99aa3daf48.jpg
4_faster_rcnn,fold_2,24,38,24,14,14,0106_jpg.rf.ea3d3d53b74e632d3112cfd4b25da4de.jpg
4_faster_rcnn,fold_2,2,5,2,3,3,0230512_145006_jpg.rf.eb1d6247f79c4ed2e093c5fcaf73e407.jpg
4_faster_rcnn,fold_2,4,3,2,1,-1,IMG_20230512_145316_jpg.rf.250aaba6ef305223c5dec100c738233c.jpg
4_faster_rcnn,fold_2,11,11,6,5,0,20230512_145205_jpg.rf.8be964bf86f6306b95645b3e8b4177aa.jpg
4_faster_rcnn,fold_2,2,1,1,0,-1,20230512_145125_jpg.rf.c0d2af11ce72a4bb0c259d23b2700862.jpg
4_faster_rcnn,fold_2,5,5,5,0,0,20230512_151810_jpg.rf.b4a391d3bd61afb0cff6f47e49a1736e.jpg
4_faster_rcnn,fold_2,8,7,7,0,-1,IMG_20230512_151240_jpg.rf.21dc1955fc3611fdbde01fb2d3db23e3.jpg
4_faster_rcnn,fold_2,1,1,1,0,0,IMG_20230512_151233_jpg.rf.75f4efffa9f2c8ddf8c60930c30caa50.jpg
4_faster_rcnn,fold_2,2,2,2,0,0,20230512_145245_jpg.rf.23b906c05c2822f1a0f5a97d26511473.jpg
4_faster_rcnn,fold_2,5,5,4,1,0,20230512_145335-0-_jpg.rf.e11b1b03b49524f5174370062e01b4f7.jpg
4_faster_rcnn,fold_2,25,18,14,4,-7,IMG_20230512_150137_686_jpg.rf.87a512bdf05b800f446ab29f4925d265.jpg
4_faster_rcnn,fold_2,2,2,2,0,0,IMG_3837_JPG.rf.6f942021a4fd687376ae5b9b4d970b40.jpg
4_faster_rcnn,fold_2,17,16,14,2,-1,20230512_144951_jpg.rf.9ab67b54e372e2d5fcc0ba78e49718cf.jpg
4_faster_rcnn,fold_2,1,1,0,1,0,20230512_153216_jpg.rf.eb0c9677e99c15c65103ae3a612d52d8.jpg
4_faster_rcnn,fold_2,16,16,12,4,0,20230512_144957_jpg.rf.edf44bd7d8feadfc28a3389bd946b805.jpg
4_faster_rcnn,fold_2,3,4,1,3,1,IMG_20230512_145032_jpg.rf.d9c71446c077191b543ca5691d58f022.jpg
4_faster_rcnn,fold_2,40,17,11,6,-23,20230512_150324_jpg.rf.3ff2950eb65ac5c31086e53bc4e56ed5.jpg
4_faster_rcnn,fold_2,1,1,1,0,0,20230512_151651-0-_jpg.rf.b824f35100b3f7edb1d2a6095c5dfaa2.jpg
4_faster_rcnn,fold_2,23,20,16,4,-3,20230512_153141_jpg.rf.613e5b5025183f2520937d9596cdd56a.jpg
4_faster_rcnn,fold_2,1,2,0,2,1,IMG_3846_JPG.rf.6ac47067db06f4b0377dc758d0af3e6e.jpg
4_faster_rcnn,fold_2,13,12,10,2,-1,IMG_20230512_145059_jpg.rf.ca7ed19e9dee72856eedaac64c143c22.jpg
4_faster_rcnn,fold_2,7,8,6,2,1,20230512_150118_jpg.rf.995a1787a6672b3228e543351c485407.jpg
4_faster_rcnn,fold_2,29,20,16,4,-9,20230512_150102_jpg.rf.992c8db88e8e711f38b63308f2f2ceb0.jpg
4_faster_rcnn,fold_2,1,1,1,0,0,IMG_20230512_153419_jpg.rf.9224e0b2559139217bdba3afdc04378c.jpg
4_faster_rcnn,fold_2,13,1,1,0,-12,20230512_153022_jpg.rf.863e7532bc45f9f8755c15b6a24dda83.jpg
4_faster_rcnn,fold_2,59,30,22,8,-29,20230512_153358_jpg.rf.97d1a8ba190dcaf1d26753099c80dac6.jpg
4_faster_rcnn,fold_2,3,3,1,2,0,20230512_145406_jpg.rf.b6c696ca3ffd7789f8655f344c1ccd98.jpg
4_faster_rcnn,fold_2,3,3,3,0,0,IMG_4387_JPG.rf.3205816644d251fe12961d17cfe8b818.jpg
4_faster_rcnn,fold_2,10,8,4,4,-2,20230512_150020_jpg.rf.6a0dfe027260521f3168f7985b48272f.jpg
4_faster_rcnn,fold_2,1,1,1,0,0,0011_jpg.rf.ef78555de2ee0947227176b9c9b4319b.jpg
4_faster_rcnn,fold_2,10,11,10,1,1,20230512_150229_jpg.rf.db8357bef31fe081f8e5059cfd0c9fb4.jpg
4_faster_rcnn,fold_2,2,2,2,0,0,20230512_151743_jpg.rf.6203480990e7a828e8c8e3f743a0053b.jpg
4_faster_rcnn,fold_2,6,6,3,3,0,20230512_145157_jpg.rf.459cfae5642460c5c30e67dd372cadcc.jpg
4_faster_rcnn,fold_2,2,3,2,1,1,20230512_145122_jpg.rf.f302914da7ccad75fb2edfd9b9ec0efd.jpg
4_faster_rcnn,fold_2,13,12,9,3,-1,IMG_20230512_145118_jpg.rf.d1ef05f6a7704db2945116a966e5bd70.jpg
4_faster_rcnn,fold_2,6,0,0,0,-6,20230512_153037_jpg.rf.b93a210f722c0d5464f223e099ec3dce.jpg
4_faster_rcnn,fold_2,3,1,1,0,-2,20230512_150758_jpg.rf.8a907872529b09fec41c34fbc4a3c85b.jpg
4_faster_rcnn,fold_2,3,2,2,0,-1,20230512_145126_jpg.rf.76790ff28fba433b2868c3becc799204.jpg
4_faster_rcnn,fold_2,111,62,46,16,-49,0105_jpg.rf.21f79c1f08ac725f3eafce77e52091e8.jpg
4_faster_rcnn,fold_2,3,3,2,1,0,20230512_145438_jpg.rf.c1caee1e341cc9a711b6cf640a2a8509.jpg
4_faster_rcnn,fold_2,4,5,3,2,1,IMG_20230512_145346_jpg.rf.515d73a420cc0607f0a677c3ec22ea14.jpg
4_faster_rcnn,fold_2,4,4,2,2,0,20230512_145144_jpg.rf.f15cd7a8e403d35924c9a9953ceb0ed2.jpg
4_faster_rcnn,fold_2,11,7,2,5,-4,20230512_150030_jpg.rf.6f76526d3409cadbfe960092b45d99ff.jpg
4_faster_rcnn,fold_2,14,14,10,4,0,20230512_151050_jpg.rf.bb1678e3a1546f2d4b401bf96df99936.jpg
4_faster_rcnn,fold_2,1,1,1,0,0,230512_150038_jpg.rf.9ebbdcccc679c75c9dceb5b2e686d104.jpg
4_faster_rcnn,fold_2,8,7,7,0,-1,20230512_151748_jpg.rf.fdcf266c293fa03554fecbec46885bcf.jpg
4_faster_rcnn,fold_2,4,3,2,1,-1,20230512_145131_jpg.rf.05acfd31fb743167b9795df743ef22b4.jpg
4_faster_rcnn,fold_2,5,7,5,2,2,IMG_20230512_150030_jpg.rf.eb7e32ee807e4ad675ec4b1f485d1194.jpg
4_faster_rcnn,fold_2,3,5,3,2,2,20230512_151026-copia-1-_jpg.rf.25048c6b13b3d64d8a468f548967f5d4.jpg
4_faster_rcnn,fold_2,1,1,1,0,0,IMG_4042_JPG.rf.3b0722af6ff7f5abfc5b80296e0e51a4.jpg
4_faster_rcnn,fold_2,1,1,1,0,0,0230512_145106_jpg.rf.f11d7922f45bb3e9056a0274e877bd6f.jpg
4_faster_rcnn,fold_2,4,6,3,3,2,20230512_145152_jpg.rf.c078905785bf4f39e87ab4dbfeb67b79.jpg
4_faster_rcnn,fold_2,2,2,2,0,0,IMG_20230512_151751_jpg.rf.86507ee6252cc7d41c2fa99c5f84bbc9.jpg
4_faster_rcnn,fold_2,8,9,6,3,1,20230512_145155_jpg.rf.483609701afa99b05a432395c2a1dc59.jpg
4_faster_rcnn,fold_2,1,1,1,0,0,20230512_151501_jpg.rf.16af334ffaad29022c4afa8eda4bbb5b.jpg
4_faster_rcnn,fold_2,4,4,3,1,0,20230512_150208_jpg.rf.5e82906cb9373103e9e98ed6a4338a1e.jpg
4_faster_rcnn,fold_2,2,3,2,1,1,20230512_151704_jpg.rf.fd83532c35f591e140a380aa12cd8530.jpg
4_faster_rcnn,fold_2,4,2,2,0,-2,0230512_145310_jpg.rf.58da36115ae6f33dda807758d87657c9.jpg
4_faster_rcnn,fold_2,8,7,6,1,-1,20230512_145134_jpg.rf.5d0f231790df81ba4a0051d2b6752135.jpg
4_faster_rcnn,fold_2,4,4,4,0,0,20230512_150055_jpg.rf.4cc48b2b47552b6368afa5d3491ee008.jpg
4_faster_rcnn,fold_2,19,23,17,6,4,IMG_20230512_150053_jpg.rf.0df30dcd2353d3b9fb7a7df012361881.jpg
4_faster_rcnn,fold_2,10,10,8,2,0,20230512_152215_jpg.rf.a4d9425dfde22fcd54004debebaf80ce.jpg
4_faster_rcnn,fold_2,6,5,3,2,-1,20230512_145408_jpg.rf.3d8eeed18535cb95a6e8d1931052f34c.jpg
4_faster_rcnn,fold_2,8,8,6,2,0,20230512_152941_jpg.rf.a2201e1690ef639f51bfe7ce95cec221.jpg
4_faster_rcnn,fold_2,3,3,3,0,0,20230512_151306_jpg.rf.cfe45d7efb4a4c29beccc71f36871b48.jpg
4_faster_rcnn,fold_2,1,1,1,0,0,IMG_20230512_151234_jpg.rf.b19f52712286d372282ee90e4f3a8c24.jpg
4_faster_rcnn,fold_2,6,3,2,1,-3,IMG_20230512_145136_jpg.rf.a268e723779ce1a1a30472767d3788c0.jpg
4_faster_rcnn,fold_2,4,1,1,0,-3,20230512_145405_jpg.rf.583b8e88a9d9542c857773d30f074199.jpg
4_faster_rcnn,fold_2,1,1,1,0,0,20230512_151808_jpg.rf.88493c8cb7d1ddd67bcbdd48f290be76.jpg
4_faster_rcnn,fold_2,2,5,2,3,3,IMG_20230512_151255_jpg.rf.085333bc247d4e08cfef9873bd98d250.jpg
4_faster_rcnn,fold_2,14,14,8,6,0,20230512_145200_jpg.rf.a6508f9b4a5dc4d2e37a648f6f58cad7.jpg
4_faster_rcnn,fold_2,5,6,3,3,1,IMG_20230512_150153_jpg.rf.21455b2b84261cf0a3ce6dd9147d31c2.jpg
4_faster_rcnn,fold_2,9,10,8,2,1,0230512_145438_jpg.rf.8d0faa32dac3b0a8d27ae1876a0db052.jpg
4_faster_rcnn,fold_2,1,1,1,0,0,20230512_145023_jpg.rf.b2955fd5ab715016af10f2efa47feb0c.jpg
4_faster_rcnn,fold_2,4,2,2,0,-2,IMG_3986_JPG.rf.5f1e1a04a780c294057b3aeb49ce1327.jpg
4_faster_rcnn,fold_2,2,2,2,0,0,20230512_151639_jpg.rf.2e5a4b318c40ab84158ba5ef4ab1ae75.jpg
4_faster_rcnn,fold_2,2,1,1,0,-1,0010_jpg.rf.5d4cbd2e216fb4306b05f3a979d801a6.jpg
4_faster_rcnn,fold_2,61,36,23,13,-25,20230512_153154_jpg.rf.8e0789e24006a0265466d9bf9fdd2d5d.jpg
4_faster_rcnn,fold_2,3,3,0,3,0,IMG_3866_JPG.rf.9976a97a1422b88843b54c8cfe8f8cef.jpg
4_faster_rcnn,fold_2,2,1,1,0,-1,20230512_145123_jpg.rf.7c684cfce69e0678a5f37aceb8e58703.jpg
4_faster_rcnn,fold_2,2,2,1,1,0,20230512_151634_jpg.rf.4af8920897c95556710f5d66b8848580.jpg
4_faster_rcnn,fold_2,1,1,0,1,0,20230512_151253_jpg.rf.b5e989a50a5c70e0f8911ebb246c4bd9.jpg
4_faster_rcnn,fold_2,6,8,6,2,2,20230512_153108_jpg.rf.d3d27e961d217f62f45c29eec6d6c2ed.jpg
4_faster_rcnn,fold_2,31,23,17,6,-8,0512_150045_jpg.rf.097128a0f4dc3739d053c017dd7fd643.jpg
4_faster_rcnn,fold_2,2,2,2,0,0,20230512_145217_jpg.rf.8b4c9e235361be21ec1ef0addc99dc7a.jpg
4_faster_rcnn,fold_2,13,8,3,5,-5,20230512_153057_jpg.rf.4d29da76e8c70adbe3707715c3333882.jpg
4_faster_rcnn,fold_2,1,1,1,0,0,20230512_145040_jpg.rf.c652c89ab18a37e582fa39fe9f7abdc6.jpg
4_faster_rcnn,fold_2,10,10,9,1,0,IMG_20230512_145100_jpg.rf.e7b035adf2c640d6a600846236b01b19.jpg
4_faster_rcnn,fold_2,1,1,1,0,0,20230512_151458_jpg.rf.44033d4e267440e0172a403e2c9b2c2f.jpg
4_faster_rcnn,fold_2,1,1,1,0,0,IMG_4039_JPG.rf.3f78f739ca76cba4136559eee15bdd94.jpg
4_faster_rcnn,fold_2,15,16,12,4,1,IMG_20230512_150039_1_jpg.rf.ffd13d7440dc972309a1f58f33063648.jpg
4_faster_rcnn,fold_2,2,3,2,1,1,0230512_145340_jpg.rf.beb3f9c554344398d6f6007f748edd63.jpg
4_faster_rcnn,fold_2,8,7,7,0,-1,IMG_4188_JPG.rf.2b1e9cc2bc82b3d05861cab7bdbfb235.jpg
4_faster_rcnn,fold_2,4,5,3,2,1,IMG_20230512_145231_804_jpg.rf.35d239e095afd813f22e568b66281c10.jpg
4_faster_rcnn,fold_2,8,9,7,2,1,20230512_152333_jpg.rf.901f79538b04a75cfd995edb99dba147.jpg
4_faster_rcnn,fold_2,1,1,1,0,0,IMG_20230512_151122_744_jpg.rf.0203c58a683248c6ba3e7ca2baa5ee22.jpg
4_faster_rcnn,fold_2,9,9,7,2,0,20230512_152403_jpg.rf.21f06ac205b62518bb4ac1c1d05a2bce.jpg
4_faster_rcnn,fold_2,21,17,12,5,-4,20230512_150012_jpg.rf.5bc4d2f31a26aab541fdbeb4a437985a.jpg
4_faster_rcnn,fold_2,8,7,5,2,-1,20230512_150920_jpg.rf.5224cc7eab4f53f93bdec2d81bba5f0e.jpg
4_faster_rcnn,fold_2,7,6,6,0,-1,20230512_145404_jpg.rf.91d448b69a976705a98b28002a84c842.jpg
4_faster_rcnn,fold_2,1,3,1,2,2,0003_jpg.rf.bf7cde9cd5a6dc0cc2ee160ef4121efe.jpg
4_faster_rcnn,fold_2,7,7,7,0,0,IMG_20230512_145054_jpg.rf.b241c4cdeabfff0793bff4970cd95da2.jpg
4_faster_rcnn,fold_2,1,1,1,0,0,20230512_145032-0-_jpg.rf.dc8b664d3fb1425d1783c11f8bcb0068.jpg
4_faster_rcnn,fold_2,2,2,2,0,0,20230512_145316-0-_jpg.rf.6c2d352bf056f852f59df415c04c3b73.jpg
4_faster_rcnn,fold_2,6,5,4,1,-1,IMG_4037_JPG.rf.c2e2f236825c2dff84efbeb902eeb29d.jpg
4_faster_rcnn,fold_2,2,1,0,1,-1,IMG_3916_JPG.rf.250aee83d82e083052118d5322edb81e.jpg
4_faster_rcnn,fold_2,3,2,2,0,-1,20230512_150045_jpg.rf.56868f65f25cf730ad8340c6a67caa9b.jpg
4_faster_rcnn,fold_3,3,2,0,2,-1,20230512_145409_jpg.rf.d09685c8c603cbe9e1a20305c3a191ef.jpg
4_faster_rcnn,fold_3,6,5,5,0,-1,20230512_150944_jpg.rf.eaecb1ecef20585ed9293d182792536f.jpg
4_faster_rcnn,fold_3,9,11,8,3,2,IMG_20230512_152206_244_jpg.rf.39d59820f61b06056f549a4d3442ac7b.jpg
4_faster_rcnn,fold_3,5,6,3,3,1,20230512_151749_jpg.rf.05c1da9e8ad61457f7836f667088adf9.jpg
4_faster_rcnn,fold_3,5,4,4,0,-1,0004_jpg.rf.851243b8e41e3a1bd722c5b177c9bf93.jpg
4_faster_rcnn,fold_3,1,1,1,0,0,20230512_151806_jpg.rf.26383849e96ac2c96291e0c7409e44d2.jpg
4_faster_rcnn,fold_3,1,1,1,0,0,0012_jpg.rf.48d09ce5c069b09d1c9d6cf497ff9a97.jpg
4_faster_rcnn,fold_3,5,4,4,0,-1,20230512_151026_jpg.rf.d30352bb19624c98cae22d002974b61a.jpg
4_faster_rcnn,fold_3,9,7,7,0,-2,20230512_151855_jpg.rf.e3fa630bb03de4788e09724f320ec036.jpg
4_faster_rcnn,fold_3,2,2,1,1,0,20230512_145316_jpg.rf.496d4ed779e1450c242495fa46e36987.jpg
4_faster_rcnn,fold_3,4,5,4,1,1,20230512_153116_jpg.rf.cdd42e1383bc6c130d47f65e21bcc4e6.jpg
4_faster_rcnn,fold_3,5,4,4,0,-1,20230512_145437_jpg.rf.0909c9ccb332356410c1a52743b7c7bf.jpg
4_faster_rcnn,fold_3,4,3,2,1,-1,20230512_153139_jpg.rf.c012da59f33e990f927df57e0a6a7f6c.jpg
4_faster_rcnn,fold_3,3,2,2,0,-1,0031_jpg.rf.895d9050f9dc5640677a308629b20ad8.jpg
4_faster_rcnn,fold_3,21,21,18,3,0,IMG_20230512_152944_jpg.rf.cda9c2160b066ef7e220cf96a991f737.jpg
4_faster_rcnn,fold_3,8,9,8,1,1,IMG_4187_JPG.rf.f301f6508b0e93d82808ac4e2f80dab0.jpg
4_faster_rcnn,fold_3,1,0,0,0,-1,230512_150212_jpg.rf.3e63a63731d99962cf04897093c61c0e.jpg
4_faster_rcnn,fold_3,3,2,1,1,-1,20230512_150056_jpg.rf.c9ae963578e609418dc9e533e5a26adf.jpg
4_faster_rcnn,fold_3,7,6,6,0,-1,IMG_20230512_153337_765_jpg.rf.f1a04e6d77f25605da1438e3829fd581.jpg
4_faster_rcnn,fold_3,10,38,6,32,28,0200_jpg.rf.72e8b4790e76291a0c9e6877dd61eef5.jpg
4_faster_rcnn,fold_3,4,4,3,1,0,IMG_20230512_151438_jpg.rf.ff747d9ae06e7829a2e860bb43baf295.jpg
4_faster_rcnn,fold_3,1,1,1,0,0,IMG_20230512_145007_395_jpg.rf.b8b6b70654f786328e3fe2f85e949a6f.jpg
4_faster_rcnn,fold_3,1,1,1,0,0,0014_jpg.rf.edb35667570fa3a23afcb19d179ea59d.jpg
4_faster_rcnn,fold_3,2,1,1,0,-1,20230512_151640_jpg.rf.4b7574d0b6f05544e5a43a5be4589a6f.jpg
4_faster_rcnn,fold_3,1,1,1,0,0,20230512_151616_jpg.rf.73b54fe227f3ac8f3da41b5fba2b170a.jpg
4_faster_rcnn,fold_3,43,25,17,8,-18,IMG_20230512_150354_jpg.rf.1ed97bfbf8670ca6750d76619dac51ef.jpg
4_faster_rcnn,fold_3,1,0,0,0,-1,20230512_145009_jpg.rf.9f8f641e028bed4b2706301af0fb27ee.jpg
4_faster_rcnn,fold_3,3,5,3,2,2,20230512_152204_jpg.rf.b0b665cf50c6b54094f4fe1a4a01ecce.jpg
4_faster_rcnn,fold_3,4,3,3,0,-1,20230512_145348-0-_jpg.rf.a616aa6a3ced888f83d2044dbd9ec726.jpg
4_faster_rcnn,fold_3,9,8,6,2,-1,IMG_20230512_145301_jpg.rf.71b506460c51cef84cbbfdc651695e13.jpg
4_faster_rcnn,fold_3,9,8,7,1,-1,20230512_145156_jpg.rf.85e178453eba594f6ce65cebf40de3fb.jpg
4_faster_rcnn,fold_3,3,3,2,1,0,20230512_150025_jpg.rf.0bef8a6273605277f912993bceb28c2c.jpg
4_faster_rcnn,fold_3,4,4,4,0,0,20230512_145130_jpg.rf.51678843234545aa7f95a07feefbe048.jpg
4_faster_rcnn,fold_3,1,1,1,0,0,0230512_145124_jpg.rf.24447141d50bf7957914c622cb19bbc6.jpg
4_faster_rcnn,fold_3,1,1,1,0,0,20230512_151656_jpg.rf.581bfb229dea559f67a2aa2ac578db62.jpg
4_faster_rcnn,fold_3,2,2,1,1,0,IMG_20230512_145127_jpg.rf.d2db7f78af8d459d1ccab501da8c6fcd.jpg
4_faster_rcnn,fold_3,3,5,2,3,2,IMG_20230512_145110_jpg.rf.d1d01bf0ca4a3344a6bf7d4b94e63c96.jpg
4_faster_rcnn,fold_3,2,1,1,0,-1,230512_150052_jpg.rf.495fe344c6875f2116d1ef5a0bd92daf.jpg
4_faster_rcnn,fold_3,3,2,2,0,-1,IMG_3934_JPG.rf.1b359ac7d45ac33c7623f668cb9731d0.jpg
4_faster_rcnn,fold_3,8,12,6,6,4,IMG_20230512_150231_jpg.rf.764af7adf374d2dee3739d99e3a0d56a.jpg
4_faster_rcnn,fold_3,7,6,5,1,-1,IMG_20230512_145110_246_jpg.rf.153877ddf43d3d76a37f64fb0aa5f617.jpg
4_faster_rcnn,fold_3,15,9,7,2,-6,20230512_150106_jpg.rf.3025eeb24b28ae43f2ad27872636bbbf.jpg
4_faster_rcnn,fold_3,1,1,1,0,0,20230512_151113_jpg.rf.b6cd4222d666bbace543a8c77d865f35.jpg
4_faster_rcnn,fold_3,2,2,2,0,0,20230512_151756_jpg.rf.6e05ac20e235330456b0b0d06c00138c.jpg
4_faster_rcnn,fold_3,1,1,1,0,0,20230512_151035_jpg.rf.103e19cb70bac5049a33c63e773d1a79.jpg
4_faster_rcnn,fold_3,6,6,4,2,0,230512_145340_jpg.rf.9fdd58e2d10ba1375e278a07b95c337c.jpg
4_faster_rcnn,fold_3,12,10,5,5,-2,20230512_145203_jpg.rf.35ba545e195d0af402a018f91a322dab.jpg
4_faster_rcnn,fold_3,11,10,9,1,-1,IMG_20230512_153029_jpg.rf.80e951915c88eafeea885e5fb27b45e8.jpg
4_faster_rcnn,fold_3,2,1,1,0,-1,0230512_145130_jpg.rf.faddf96f4d26a63f9284354dd447afd4.jpg
4_faster_rcnn,fold_3,13,12,10,2,-1,20230512_145238_jpg.rf.b85535f8851b826fe2e42e26692f5635.jpg
4_faster_rcnn,fold_3,9,7,6,1,-2,20230512_153316_jpg.rf.24b77c461257ba1bd947e731de450708.jpg
4_faster_rcnn,fold_3,27,24,16,8,-3,20230512_150125_jpg.rf.d10c3232f4247c5514953cf92c7083c5.jpg
4_faster_rcnn,fold_3,3,2,2,0,-1,20230512_151438_jpg.rf.9d2b9be770df6ec4ba79d984fe00b8b4.jpg
4_faster_rcnn,fold_3,50,33,31,2,-17,0512_150210_jpg.rf.a172e8c839e22e596b7db396b08d63d1.jpg
4_faster_rcnn,fold_3,17,16,10,6,-1,20230512_150321_jpg.rf.a5e551cbda2cf857d53bcbd4d60b92c5.jpg
4_faster_rcnn,fold_3,1,0,0,0,-1,20230512_151213_jpg.rf.419a445cd8b3392ce737e6b1c6cb0d88.jpg
4_faster_rcnn,fold_3,7,8,7,1,1,IMG_20230512_152958_116_jpg.rf.12bbdfc4e9ae5914029f9e97d0fcd224.jpg
4_faster_rcnn,fold_3,8,2,2,0,-6,0230512_145231_jpg.rf.f02c6f94b7286a6b59a1c8b2423f5ba8.jpg
4_faster_rcnn,fold_3,20,20,16,4,0,20230512_152944_jpg.rf.3c5b2edc21ab50f9893441607f43f699.jpg
4_faster_rcnn,fold_3,10,12,10,2,2,20230512_152328_jpg.rf.9afc7b5536cb56c41fedd9c22fd78fe4.jpg
4_faster_rcnn,fold_3,1,1,1,0,0,20230512_151448_jpg.rf.83cf709cf0b2547d212be3a377779599.jpg
4_faster_rcnn,fold_3,4,6,4,2,2,20230512_145151_jpg.rf.1c7cdb8ed83d156aba9a1e8e94becd21.jpg
4_faster_rcnn,fold_3,2,2,1,1,0,0230512_145009_jpg.rf.027a2f31eb1269ab45f13bf35444b96c.jpg
4_faster_rcnn,fold_3,24,16,14,2,-8,20230512_153310_jpg.rf.4207c4421e3464536cb4bd47453058d2.jpg
4_faster_rcnn,fold_3,1,0,0,0,-1,20230512_145103_jpg.rf.62604473c5e590c815e5d908b8d354a0.jpg
4_faster_rcnn,fold_3,2,2,1,1,0,IMG_20230512_145351_839_jpg.rf.676aa37e025296713a6e39f90d91aa3b.jpg
4_faster_rcnn,fold_3,4,3,3,0,-1,20230512_152301-0-_jpg.rf.1afa46256fa26afe6cd36253d167878e.jpg
4_faster_rcnn,fold_3,5,4,4,0,-1,IMG_20230512_145310_230_jpg.rf.a3b7f15bfc867ece22ea5c289b0d4b74.jpg
4_faster_rcnn,fold_3,12,10,9,1,-2,20230512_150153_jpg.rf.330fb945dbe64ad88c012d6c611ab4e9.jpg
4_faster_rcnn,fold_3,9,14,9,5,5,20230512_152315_jpg.rf.e5aebd25c65f9475f8256b49c71ff68a.jpg
4_faster_rcnn,fold_3,1,1,1,0,0,20230512_151304_jpg.rf.820f387501b1325203f72b034ae1ff0a.jpg
4_faster_rcnn,fold_3,5,5,1,4,0,IMG_3842_JPG.rf.4a4a46be5bc0098c5e1314e61ddc11de.jpg
4_faster_rcnn,fold_3,1,1,1,0,0,20230512_145219_jpg.rf.0755ac5ed17a2444b92a33aaea06d7a3.jpg
4_faster_rcnn,fold_3,16,13,11,2,-3,20230512_150148_jpg.rf.0d501896a72c41b99bfcd956b0436fb3.jpg
4_faster_rcnn,fold_3,5,5,3,2,0,IMG_20230512_145011_556_jpg.rf.00fbb204260504401d5042a1e1cd5b8d.jpg
4_faster_rcnn,fold_3,1,1,1,0,0,IMG_20230512_145336_167_jpg.rf.b667487bd924e740ebac74f50e1e463d.jpg
4_faster_rcnn,fold_3,11,12,10,2,1,20230512_150201_jpg.rf.c4784605e4e8290a39a5a8546b8daf34.jpg
4_faster_rcnn,fold_3,14,14,13,1,0,0056_jpg.rf.de05042e164d7742536e2b31f92d3670.jpg
4_faster_rcnn,fold_3,1,2,1,1,1,0034_jpg.rf.32acf93f344bd74d2605e49ed3db9e0e.jpg
4_faster_rcnn,fold_3,9,6,4,2,-3,0230512_150100_jpg.rf.bac5d1418079223e898fdae8b34c9b0d.jpg
4_faster_rcnn,fold_3,2,2,1,1,0,IMG_3983_JPG.rf.9148c9d4463c4afaf34c762d4c53ead6.jpg
4_faster_rcnn,fold_3,13,11,6,5,-2,20230512_150105_jpg.rf.9bb4f73900fecf656a093f8eac337860.jpg
4_faster_rcnn,fold_3,4,4,1,3,0,20230512_145124_jpg.rf.b61b648c127689b8eeb3a43495c3df3e.jpg
4_faster_rcnn,fold_3,16,14,13,1,-2,IMG_20230512_152416_jpg.rf.924528612413e225894a24fc2dec0a36.jpg
4_faster_rcnn,fold_3,1,1,1,0,0,20230512_152207_jpg.rf.61fece27ba33f3c6fc069a211008dab5.jpg
4_faster_rcnn,fold_3,23,14,9,5,-9,_20230512_150225_jpg.rf.9718d11f60b7e396ae6928ae7f14c90b.jpg
4_faster_rcnn,fold_3,19,19,15,4,0,20230512_150239_jpg.rf.e13a84d4d7ec0f7e070c7ccb4fb737b3.jpg
4_faster_rcnn,fold_3,4,4,4,0,0,20230512_152346_jpg.rf.a8c2948d3e9aa465d912f3465556eb90.jpg
4_faster_rcnn,fold_3,6,6,6,0,0,20230512_150818_jpg.rf.58c0f3208c48520ddc0588916be6397c.jpg
4_faster_rcnn,fold_3,1,1,1,0,0,IMG_20230512_150843_jpg.rf.3c9dacc8aa8ae98bcec98a6b950df819.jpg
4_faster_rcnn,fold_3,1,1,1,0,0,IMG_3839_JPG.rf.2b8f533bc337b2b41e4aa08d82c895f0.jpg
4_faster_rcnn,fold_3,13,3,2,1,-10,IMG_20230512_150401_jpg.rf.0f4c64f7dd592050ecd9a38797714f40.jpg
4_faster_rcnn,fold_3,4,3,1,2,-1,0008_jpg.rf.3fe730c41fdc7b3704f6885ae667338f.jpg
4_faster_rcnn,fold_3,7,5,5,0,-2,IMG_20230512_150236_jpg.rf.b127381341df0777f6b90c3d6193ab5f.jpg
4_faster_rcnn,fold_3,13,10,10,0,-3,20230512_153104_jpg.rf.e6b0a044d9369e49df9c83ed02c5f924.jpg
4_faster_rcnn,fold_3,1,1,1,0,0,20230512_151446_jpg.rf.e46015a969282d2959dba6262188eb21.jpg
4_faster_rcnn,fold_3,1,1,1,0,0,IMG_4046_JPG.rf.5365cbd02513c386b454d943407c56e0.jpg
4_faster_rcnn,fold_3,7,7,5,2,0,IMG_20230512_150841_155_jpg.rf.8f074ff9aa19c6cf12ce37edaace8c77.jpg
4_faster_rcnn,fold_3,3,3,3,0,0,20230512_145122-0-_jpg.rf.7f7266ca36660b1ab4d0a4f2a704a54e.jpg
4_faster_rcnn,fold_3,3,3,3,0,0,20230512_151620_jpg.rf.ced9071f82dc586dd5ac71f5fae00dc4.jpg
4_faster_rcnn,fold_3,1,1,1,0,0,20230512_151655_jpg.rf.1681dccfc685ad40e584cad62c4f6b8e.jpg
4_faster_rcnn,fold_3,8,3,3,0,-5,0230512_145235_jpg.rf.20bb212232c9b2421611218796835da2.jpg
4_faster_rcnn,fold_3,13,11,6,5,-2,20230512_151008_jpg.rf.0cd6367e8494296811c3d1a88e22360b.jpg
4_faster_rcnn,fold_3,12,12,12,0,0,IMG_20230512_152352_jpg.rf.2c7ab0d8791aacf1c20aa134ddf7f9ed.jpg
4_faster_rcnn,fold_3,2,1,1,0,-1,IMG_20230512_151034_jpg.rf.d8d2ab03b8a59931929429b4bc8c7106.jpg
4_faster_rcnn,fold_3,12,5,1,4,-7,IMG_20230512_150124_jpg.rf.fef0579e7a6b4c283294de15512f524a.jpg
4_faster_rcnn,fold_3,7,9,6,3,2,20230512_150027_jpg.rf.787439d34fc22269c3ab90e55ea595ed.jpg
4_faster_rcnn,fold_3,3,2,2,0,-1,20230512_151627_jpg.rf.9dc28340fd04ffea8cf28dd5e51283d6.jpg
4_faster_rcnn,fold_3,4,4,3,1,0,IMG_20230512_151218_jpg.rf.10b21ddd648ad67d1f264e8b99ead4d4.jpg
4_faster_rcnn,fold_3,37,27,24,3,-10,IMG_20230512_150249_jpg.rf.61bc4fbd0c49a88a29443f72cc742e3b.jpg
4_faster_rcnn,fold_3,6,8,4,4,2,20230512_150023_jpg.rf.06c0ade806a1d3e688bc144ef13dbaf8.jpg
4_faster_rcnn,fold_3,8,8,6,2,0,20230512_150210_jpg.rf.e4435f297c285583a73370f97d9cef80.jpg
4_faster_rcnn,fold_3,8,8,7,1,0,IMG_4089_JPG.rf.7967cd5700ba2e9b62aa13ecaa3a28b1.jpg
4_faster_rcnn,fold_3,0,6,0,6,6,0031_jpg.rf.00b387ba75b602a79b19e9003038b8ea.jpg
4_faster_rcnn,fold_3,3,1,1,0,-2,IMG_4196_JPG.rf.66adce382a697aad33bcbc7ab8814677.jpg
4_faster_rcnn,fold_3,26,19,5,14,-7,0512_150111_jpg.rf.d4cf10c518eff125048b590e0a4605cb.jpg
4_faster_rcnn,fold_3,2,2,1,1,0,IMG_20230512_151827_jpg.rf.e428f11ebc690c01de13c493aaf89f10.jpg
4_faster_rcnn,fold_3,4,3,2,1,-1,0009_jpg.rf.14ae6cb384f301625cca9baa804d99e2.jpg
4_faster_rcnn,fold_3,6,5,5,0,-1,IMG_20230512_145423_jpg.rf.f32325604574f1dc3efee2c645d2272b.jpg
4_faster_rcnn,fold_3,8,2,1,1,-6,20230512_150140_jpg.rf.b2c7162d38d1696ac9436b4c5de3c5bd.jpg
4_faster_rcnn,fold_3,3,5,2,3,2,20230512_145132_jpg.rf.b2c282982621d398e0a5b6f181a8e8c1.jpg
4_faster_rcnn,fold_3,18,17,17,0,-1,20230512_153054_jpg.rf.acae07a63d6f22a0dc7fca55cf6b2d89.jpg
4_faster_rcnn,fold_3,5,4,4,0,-1,0005_jpg.rf.619937b06bbe7d217806b697a9eaf55e.jpg
4_faster_rcnn,fold_3,2,2,0,2,0,230512_150120_jpg.rf.1f7889194211bdac4259fdcd65e2af46.jpg
4_faster_rcnn,fold_3,17,22,15,7,5,IMG_20230512_150215_jpg.rf.9b54f4c34af6ee37c5ada817e2111c19.jpg
4_faster_rcnn,fold_3,3,2,1,1,-1,20230512_145242_jpg.rf.88c3024b1c64b0b6b0db5dddea0bbe0e.jpg
4_faster_rcnn,fold_3,17,15,15,0,-2,0230512_145032_jpg.rf.e9aeb44392fbee708cc4bb450582bc0f.jpg
4_faster_rcnn,fold_3,1,0,0,0,-1,0001_jpg.rf.a9b41d3e1ed49082f175c1d3de0b732e.jpg
4_faster_rcnn,fold_3,19,16,14,2,-3,IMG_20230512_150300_jpg.rf.4a9882ab0ad5a15acf150bad52ccf7d8.jpg
4_faster_rcnn,fold_3,26,23,19,4,-3,IMG_20230512_150103_353_jpg.rf.eaad90385ad647d1df922a626623f903.jpg
4_faster_rcnn,fold_3,7,5,4,1,-2,20230512_150022_jpg.rf.5a680d2814abd10e92a1f6ddf628a4b0.jpg
4_faster_rcnn,fold_3,2,1,1,0,-1,0015_jpg.rf.1f8e46b5b78af1818a40afacf5a7fe1f.jpg
4_faster_rcnn,fold_3,4,4,2,2,0,IMG_20230512_144918_793_jpg.rf.fe7a52b8285a2a10f29948f41ac02b51.jpg
4_faster_rcnn,fold_3,3,3,3,0,0,20230512_145233_jpg.rf.8a9f06089b7122f3b71b6b1b537d6310.jpg
4_faster_rcnn,fold_3,1,1,1,0,0,20230512_151802_jpg.rf.9a715b86b471f00ddc7bd3a521537317.jpg
4_faster_rcnn,fold_3,18,18,15,3,0,20230512_153055_jpg.rf.0b63692f9c79fad5834fab15740f4292.jpg
4_faster_rcnn,fold_3,2,3,1,2,1,20230512_151739_jpg.rf.fecdc818de88f0d7b449820f099a729b.jpg
4_faster_rcnn,fold_3,4,4,1,3,0,20230512_150313_jpg.rf.7d2a23518189f8dfc49022c0bb08346b.jpg
4_faster_rcnn,fold_3,6,6,5,1,0,20230512_153401_jpg.rf.1ded42782d8fd0ae0793add50267e0f5.jpg
4_faster_rcnn,fold_3,3,2,2,0,-1,20230512_152321_jpg.rf.b0515ed603d5d83688c8ee2dfedeaa66.jpg
4_faster_rcnn,fold_3,1,0,0,0,-1,20230512_151233_jpg.rf.57d77820fe4dbc49f59fbae1adba2530.jpg
4_faster_rcnn,fold_3,8,8,8,0,0,IMG_20230512_145010_jpg.rf.ba751af01c38c7678521f2c4ac49568d.jpg
4_faster_rcnn,fold_3,11,9,6,3,-2,20230512_150957_jpg.rf.2c85fc69db682fcfa08ad10362437bf3.jpg
4_faster_rcnn,fold_3,2,1,1,0,-1,0026_jpg.rf.10b0037e1af1fddb19365505a0710c5e.jpg
4_faster_rcnn,fold_3,1,1,0,1,0,0230512_145119_jpg.rf.a6362e13240d8879ce6e61258d8292ff.jpg
4_faster_rcnn,fold_3,12,9,4,5,-3,IMG_20230512_152237_316_jpg.rf.d5f18e3c135f2f386671e759efda8b69.jpg
4_faster_rcnn,fold_3,13,15,12,3,2,20230512_152314_jpg.rf.6c3a181a30741b0f98140ba02a523656.jpg
4_faster_rcnn,fold_3,21,15,12,3,-6,IMG_20230512_150127_jpg.rf.93acf533bedd75541341479d4df15bde.jpg
4_faster_rcnn,fold_3,10,9,9,0,-1,IMG_4194_JPG.rf.4cdca480fa2d46704cadc5840d0238b9.jpg
4_faster_rcnn,fold_3,2,2,2,0,0,20230512_145425_jpg.rf.8c9689378836a9437ec8ca49c37064b8.jpg
4_faster_rcnn,fold_3,9,4,2,2,-5,20230512_150034_jpg.rf.d8c7b9720feb16c5a52d002b7d3fdbec.jpg
4_faster_rcnn,fold_3,2,2,2,0,0,20230512_151800_jpg.rf.60975505aa8c8066f47f273831b23407.jpg
4_faster_rcnn,fold_3,15,16,15,1,1,IMG_20230512_152327_jpg.rf.9a4db2d219a086a344f3eb954ba715b9.jpg
4_faster_rcnn,fold_3,8,8,7,1,0,20230512_153038_jpg.rf.263cbf9b4c15ef94a433b3b4d9c52ad6.jpg
4_faster_rcnn,fold_3,2,2,2,0,0,20230512_151740_jpg.rf.bfe7cb62c2579413cf5790e5fdbe33bc.jpg
4_faster_rcnn,fold_3,3,2,2,0,-1,20230512_151622_jpg.rf.99d95c55959b0e321e3679e87f923922.jpg
4_faster_rcnn,fold_3,1,2,1,1,1,0007_jpg.rf.2f8d48ecd0ea275fbd9f39696545a7de.jpg
4_faster_rcnn,fold_4,8,6,5,1,-2,20230512_152304_jpg.rf.af417071e5055ff7a21c7e5c8a36b6b4.jpg
4_faster_rcnn,fold_4,2,2,1,1,0,IMG_4032_JPG.rf.24900b5575b9992102af280f6bba47e6.jpg
4_faster_rcnn,fold_4,2,2,1,1,0,0230512_145348_jpg.rf.cdc212bd3fb2bf4f176382d869092c48.jpg
4_faster_rcnn,fold_4,3,5,4,1,2,20230512_151623_jpg.rf.72bb569548154b9cacef8ad44ea34cbb.jpg
4_faster_rcnn,fold_4,16,11,5,6,-5,20230512_150033_jpg.rf.187d7f8b3b10fd4c55a59ca829ef7fc8.jpg
4_faster_rcnn,fold_4,5,5,5,0,0,20230512_151847_jpg.rf.bd70f9e3dff9227488b4ca7adbf77b50.jpg
4_faster_rcnn,fold_4,17,15,14,1,-2,0230512_145037_jpg.rf.043bbe5a69ebdbfca0307a4e11b0ac63.jpg
4_faster_rcnn,fold_4,35,26,15,11,-9,20230512_150150_jpg.rf.7c6e4ba9b7c81892495bdb947e71e7bc.jpg
4_faster_rcnn,fold_4,12,12,11,1,0,20230512_151910_jpg.rf.83e74c185917f56390fb7c632f1ddbb8.jpg
4_faster_rcnn,fold_4,13,14,6,8,1,IMG_20230512_153056_jpg.rf.ce869252548200602c656449cd5652e5.jpg
4_faster_rcnn,fold_4,6,6,6,0,0,20230512_152218_jpg.rf.93c255ace7ac5cb6c518b519f276c38a.jpg
4_faster_rcnn,fold_4,1,1,1,0,0,IMG_20230512_150858_jpg.rf.0c886d7a0228ac541d46c5461d00eaa9.jpg
4_faster_rcnn,fold_4,8,8,6,2,0,IMG_20230512_153026_jpg.rf.8b55b13a2be603023efcf36910819c5c.jpg
4_faster_rcnn,fold_4,20,19,18,1,-1,IMG_20230512_162026_jpg.rf.5b2e0930b83dcdad9e4b2c7dc2220ad8.jpg
4_faster_rcnn,fold_4,3,1,0,1,-2,20230512_152203_jpg.rf.f37f9576053c5dda9448b82302e0a353.jpg
4_faster_rcnn,fold_4,7,8,7,1,1,20230512_150912_jpg.rf.18152396c31db59c1819409ba319c0aa.jpg
4_faster_rcnn,fold_4,1,1,1,0,0,20230512_151104_jpg.rf.68db94fa29d48c9461b06ea1012225cb.jpg
4_faster_rcnn,fold_4,9,9,6,3,0,IMG_4184_JPG.rf.c3ce659fb0267eb11d28871cd003f680.jpg
4_faster_rcnn,fold_4,8,9,8,1,1,IMG_20230512_152244_576_jpg.rf.97d6ebe9005d26f9e1a4c40801745b3f.jpg
4_faster_rcnn,fold_4,6,5,3,2,-1,IMG_20230512_144951_654_jpg.rf.73864ab361d6a49bef8ae0582378dcd8.jpg
4_faster_rcnn,fold_4,4,3,3,0,-1,20230512_152245_jpg.rf.ad9c9eed13ca805362ff37a6409c22f1.jpg
4_faster_rcnn,fold_4,7,7,4,3,0,0230512_145259_jpg.rf.a81f0fe30e13f9985ea29fbb8c3ca4bb.jpg
4_faster_rcnn,fold_4,1,0,0,0,-1,20230512_151444_jpg.rf.d7d4a6ea41d6e0b978df16189a7ef0b7.jpg
4_faster_rcnn,fold_4,3,3,2,1,0,IMG_20230512_145249_jpg.rf.3fc3e8c98a6aad287c04adaf81f76d80.jpg
4_faster_rcnn,fold_4,13,17,13,4,4,20230512_152301_jpg.rf.13169aad5cc03cf2c0524d6515d1d94b.jpg
4_faster_rcnn,fold_4,8,7,5,2,-1,20230512_150133_jpg.rf.959f58c55ea7f14e5d45aefc1a142e65.jpg
4_faster_rcnn,fold_4,5,4,3,1,-1,IMG_20230512_145102_470_jpg.rf.a4be99517dd9cf481f2fb0f577967e6e.jpg
4_faster_rcnn,fold_4,16,15,14,1,-1,IMG_3905_JPG.rf.442064c53f4baafe2a90c8d4533175cf.jpg
4_faster_rcnn,fold_4,3,2,2,0,-1,20230512_151752-0-_jpg.rf.adde6111e2c01f49d300871eeeeaf43b.jpg
4_faster_rcnn,fold_4,15,12,12,0,-3,IMG_20230512_153244_jpg.rf.fd36ed68885d906d1bfe0772308714e1.jpg
4_faster_rcnn,fold_4,45,32,20,12,-13,IMG_20230512_150252_jpg.rf.91876ddbae7daf47c170e3510196d23c.jpg
4_faster_rcnn,fold_4,15,15,7,8,0,0230512_144954_jpg.rf.9e07b2d4ee27051f0fa96e46105520b2.jpg
4_faster_rcnn,fold_4,9,5,4,1,-4,20230512_151010_jpg.rf.ff0a6fa0a1930269ecf709bdd00cc6b8.jpg
4_faster_rcnn,fold_4,1,1,0,1,0,20230512_145011_jpg.rf.85e961b884fe88c3056ad6c5a04daafb.jpg
4_faster_rcnn,fold_4,1,1,1,0,0,20230512_151659_jpg.rf.d533f433ef4f94da44e6019d93e2f69d.jpg
4_faster_rcnn,fold_4,6,3,3,0,-3,20230512_144945_jpg.rf.49417903dca45c5adf0a0717d2a3dda5.jpg
4_faster_rcnn,fold_4,6,6,5,1,0,20230512_152305_jpg.rf.b263e7fe5ca0aa0ae073ef44c4d6ad63.jpg
4_faster_rcnn,fold_4,2,2,2,0,0,20230512_152256_jpg.rf.414a0a8bdcc3eb0a766f8a87f6a30f22.jpg
4_faster_rcnn,fold_4,5,6,5,1,1,20230512_151844_jpg.rf.b9cd7c0869b5dcad46ed7aa755549a1d.jpg
4_faster_rcnn,fold_4,12,12,7,5,0,20230512_145238-0-_jpg.rf.a0bc376d8aa6c21ae201e90cd541ddca.jpg
4_faster_rcnn,fold_4,11,11,10,1,0,IMG_20230512_152349_jpg.rf.76f8813a71224f65490c6d1d4faea02e.jpg
4_faster_rcnn,fold_4,8,8,7,1,0,20230512_145210_jpg.rf.6800be488a1a4beab14cab796974b7e7.jpg
4_faster_rcnn,fold_4,38,33,26,7,-5,IMG_20230512_150114_jpg.rf.d5fd8310f61f94bfde93cace46c477bb.jpg
4_faster_rcnn,fold_4,2,1,1,0,-1,IMG_20230512_151102_245_jpg.rf.2d98a1d78cce88aad42bfe628f8ebe8d.jpg
4_faster_rcnn,fold_4,13,13,9,4,0,IMG_20230512_151332_jpg.rf.58fb5690cf39dcfb9f524a2ffc7cd6b2.jpg
4_faster_rcnn,fold_4,4,4,4,0,0,20230512_145359_jpg.rf.538caafcbceeeab2a7c4cb9e58bb1e6a.jpg
4_faster_rcnn,fold_4,4,2,2,0,-2,0230512_145436_jpg.rf.68d4283942702699c181b1c4e2b81a95.jpg
4_faster_rcnn,fold_4,1,1,0,1,0,0012_jpg.rf.5fee49c3e98f9b2a75823078d85768de.jpg
4_faster_rcnn,fold_4,7,6,6,0,-1,20230512_150040-0-_jpg.rf.c74af3340e71a4f4d5a1fc4d5da8ffe5.jpg
4_faster_rcnn,fold_4,8,8,6,2,0,IMG_20230512_150239_jpg.rf.0eb9dc459dd6d692fc26252cf2107fd0.jpg
4_faster_rcnn,fold_4,1,0,0,0,-1,0230512_145052_jpg.rf.f17d7b98aa9a0360c0acc806b326b6a7.jpg
4_faster_rcnn,fold_4,13,11,10,1,-2,IMG_20230512_152453_jpg.rf.1723f10503a3e6db7fbceca5913e5ee1.jpg
4_faster_rcnn,fold_4,15,16,15,1,1,0044_jpg.rf.a0660e380e16b315347f5e8999d870df.jpg
4_faster_rcnn,fold_4,1,1,1,0,0,20230512_145416_jpg.rf.85e0cfe06b91ae56be79ec72f5f2166f.jpg
4_faster_rcnn,fold_4,8,5,4,1,-3,20230512_145343_jpg.rf.e8b4ce21c1272def811c108b7b1604e1.jpg
4_faster_rcnn,fold_4,45,26,22,4,-19,0512_150205_jpg.rf.698866d107ebfcc4f94fd99f31b35b02.jpg
4_faster_rcnn,fold_4,2,4,2,2,2,IMG_20230512_151308_jpg.rf.9eafa4b376d2b0b24c2d76c7cefacf05.jpg
4_faster_rcnn,fold_4,53,30,25,5,-23,0512_150120_jpg.rf.1a423f81d04e2ea199fda4f8950d5ec2.jpg
4_faster_rcnn,fold_4,1,1,1,0,0,20230512_145323_jpg.rf.42fec2bfece6489ae531e4112d227ded.jpg
4_faster_rcnn,fold_4,2,3,2,1,1,IMG_20230512_151304_jpg.rf.bdf70f382af5e54ed70fa1fa32041649.jpg
4_faster_rcnn,fold_4,1,0,0,0,-1,20230512_153306_jpg.rf.d458260a195df2ca8597a9690a8bc292.jpg
4_faster_rcnn,fold_4,10,8,8,0,-2,20230512_151858_jpg.rf.3e2b4dbf1ece4e9a00109cbeb8dc13dd.jpg
4_faster_rcnn,fold_4,6,7,6,1,1,IMG_20230512_151212_jpg.rf.f922d49a1e43e214462b88c675a0f36c.jpg
4_faster_rcnn,fold_4,24,17,15,2,-7,20230512_153019_jpg.rf.6b11b011a1b75c2eb51c302864a6ea12.jpg
4_faster_rcnn,fold_4,16,13,13,0,-3,20230512_150111_jpg.rf.3f08c8521cd7c859a80b7ba2d1856e75.jpg
4_faster_rcnn,fold_4,1,1,1,0,0,20230512_151650_jpg.rf.18be50d732782b5b8fb5f6c6db59cc14.jpg
4_faster_rcnn,fold_4,4,1,1,0,-3,20230512_144940_jpg.rf.47a23c7f63536b38b08e8f2722741d17.jpg
4_faster_rcnn,fold_4,11,11,11,0,0,0054_jpg.rf.5df028d18381f316e9ed0d97adbbfbc0.jpg
4_faster_rcnn,fold_4,5,4,3,1,-1,IMG_4217_JPG.rf.b26704f0c46f7b6c0d25d7f2aa4eac49.jpg
4_faster_rcnn,fold_4,4,3,3,0,-1,20230512_145352-0-_jpg.rf.bd97ac0cb6ee49b575c0ecff7f91e2a1.jpg
4_faster_rcnn,fold_4,1,1,1,0,0,IMG_3856_JPG.rf.4cd3bfac67d223cd7bd1b1efd3b24a09.jpg
4_faster_rcnn,fold_4,20,18,18,0,-2,IMG_20230512_152344_jpg.rf.fd23ba06eae998d14ce833db2c7d2195.jpg
4_faster_rcnn,fold_4,17,15,11,4,-2,IMG_20230512_150217_jpg.rf.59ee9b06cb5a58b718b0ff7c76a2573f.jpg
4_faster_rcnn,fold_4,1,1,1,0,0,20230512_151654-0-_jpg.rf.21ff99bb21484d784b641bc49d9310ea.jpg
4_faster_rcnn,fold_4,13,12,12,0,-1,IMG_20230512_151617_084_jpg.rf.864b3ce525fdd2abc7cc1f20bd6005c7.jpg
4_faster_rcnn,fold_4,5,5,5,0,0,230512_150030_jpg.rf.35a4005da91e89204ecd28ce53e7d8ee.jpg
4_faster_rcnn,fold_4,6,5,4,1,-1,20230512_150037_jpg.rf.a47f7ce797194722a66a03263aee18ea.jpg
4_faster_rcnn,fold_4,5,5,4,1,0,IMG_20230512_150051_jpg.rf.66c8214813ef8f830b3612827d4de766.jpg
4_faster_rcnn,fold_4,14,14,12,2,0,20230512_152949_jpg.rf.67f9765f971d32daf7623088e0781422.jpg
4_faster_rcnn,fold_4,2,3,2,1,1,20230512_150046_jpg.rf.a3f3b22b2918be1f870eb4ccdaab79d1.jpg
4_faster_rcnn,fold_4,7,4,2,2,-3,IMG_20230512_150112_1_jpg.rf.bf75baa207583c375190da53145a7679.jpg
4_faster_rcnn,fold_4,15,13,11,2,-2,IMG_20230512_153023_jpg.rf.317d3bbb9dbd87e5a653c2851476e12f.jpg
4_faster_rcnn,fold_4,5,3,2,1,-2,IMG_3847_JPG.rf.7ed87b14fc0af6892da29e4861a20db2.jpg
4_faster_rcnn,fold_4,3,0,0,0,-3,0003_jpg.rf.808f042f9b4d2044e82ecf546085a2b3.jpg
4_faster_rcnn,fold_4,16,13,12,1,-3,20230512_151042_jpg.rf.668f39eb72d209648acafdc48e653b94.jpg
4_faster_rcnn,fold_4,7,5,5,0,-2,20230512_151549_jpg.rf.f43c366ab902f205b42b2d3ece3e5840.jpg
4_faster_rcnn,fold_4,6,6,6,0,0,20230512_145344_jpg.rf.3bb4caede9892124f0b05d554bde4f37.jpg
4_faster_rcnn,fold_4,1,0,0,0,-1,20230512_145106_jpg.rf.f8f6fb5e7680b51b521aeb38bd04b4d4.jpg
4_faster_rcnn,fold_4,4,3,2,1,-1,IMG_4056_JPG.rf.26cf10e8b88a0d85256d77231719fa6f.jpg
4_faster_rcnn,fold_4,25,8,7,1,-17,0512_150105_jpg.rf.bf34c202007f5f0e97f15dd34c8af9ec.jpg
4_faster_rcnn,fold_4,1,1,1,0,0,20230512_145259_jpg.rf.4e068952a2cfa65232622575f2c5e59f.jpg
4_faster_rcnn,fold_4,8,10,6,4,2,IMG_20230512_150233_jpg.rf.fda528f9aab7dbc67a541c09b3ad100a.jpg
4_faster_rcnn,fold_4,23,16,6,10,-7,IMG_20230512_150117_559_jpg.rf.acc98bc013000372fc9482efda238776.jpg
4_faster_rcnn,fold_4,20,17,11,6,-3,IMG_20230512_150227_jpg.rf.c50986ec06debff70d855a963ab1652a.jpg
4_faster_rcnn,fold_4,1,2,1,1,1,20230512_145254_jpg.rf.9747b881733bcadb9a2575a7adfaf75f.jpg
4_faster_rcnn,fold_4,7,6,5,1,-1,20230512_151550_jpg.rf.c44e1e4b7281907db5e481f675bb38ec.jpg
4_faster_rcnn,fold_4,9,9,9,0,0,20230512_152300_jpg.rf.ca2bad1620eeb8a9708c24c8c2a6140e.jpg
4_faster_rcnn,fold_4,1,1,1,0,0,20230512_151454_jpg.rf.2edeb7ad32e74ab446183c1ed2a6a8db.jpg
4_faster_rcnn,fold_4,2,2,1,1,0,20230512_151458_jpg.rf.e6aebc1a203d13c8d455292cbf8efbd5.jpg
4_faster_rcnn,fold_4,2,2,2,0,0,20230512_151804_jpg.rf.85f9cab4d985c7a3ab655e9e58f37592.jpg
4_faster_rcnn,fold_4,4,2,2,0,-2,20230512_150056-0-_jpg.rf.726ba341e3872665ea20101a9121709b.jpg
4_faster_rcnn,fold_4,1,1,1,0,0,20230512_151710-0-_jpg.rf.d1c6ce2dc1214885b420fa5cf5b548eb.jpg
4_faster_rcnn,fold_4,7,4,4,0,-3,0035_jpg.rf.88b59c904d75a54342b73641b3751f03.jpg
4_faster_rcnn,fold_4,3,5,2,3,2,20230512_150207_jpg.rf.2636d37c60105f9dc29244105d586763.jpg
4_faster_rcnn,fold_4,11,6,5,1,-5,20230512_153529_jpg.rf.9da097c550c92828a111a560d7417f19.jpg
4_faster_rcnn,fold_4,2,2,2,0,0,20230512_145142_jpg.rf.4c1baf7188f9de7e345b9d556ae04487.jpg
4_faster_rcnn,fold_4,1,1,1,0,0,0021_jpg.rf.f361beb31a38d69ae7d5b1ba99586d9f.jpg
4_faster_rcnn,fold_4,1,0,0,0,-1,IMG_20230512_145308_jpg.rf.60b7e140102953684517e9840c3f84fd.jpg
4_faster_rcnn,fold_4,1,1,0,1,0,20230512_145115_jpg.rf.559191d80ad4506d081542afe21569dc.jpg
4_faster_rcnn,fold_4,8,8,8,0,0,20230512_151848-0-_jpg.rf.4c259cab53877565769f8e42eb6a0530.jpg
4_faster_rcnn,fold_4,2,2,2,0,0,IMG_20230512_153102_jpg.rf.358691eda0f0c7c79eb866b582696397.jpg
4_faster_rcnn,fold_4,3,3,1,2,0,IMG_20230512_150935_625_jpg.rf.cff6166bfeadb181c727209a263dcaff.jpg
4_faster_rcnn,fold_4,3,4,2,2,1,IMG_3985_JPG.rf.5c7d7114a15a375a31c89b82a6710707.jpg
4_faster_rcnn,fold_4,2,2,2,0,0,20230512_151632_jpg.rf.fb7428039c06580293185bb9fd642dff.jpg
4_faster_rcnn,fold_4,2,1,1,0,-1,IMG_20230512_151628_jpg.rf.0963b2196e508f701f2dc60946b1db1f.jpg
4_faster_rcnn,fold_4,1,1,1,0,0,0230512_145319_jpg.rf.7d5ab2070daeed5a15f73e243edac4bd.jpg
4_faster_rcnn,fold_4,5,5,4,1,0,IMG_3914_JPG.rf.ca20ceecff09da300344c1920873e12b.jpg
4_faster_rcnn,fold_4,3,2,0,2,-1,IMG_4036_JPG.rf.c2b46ca616106cdb334a1b0aac2c914c.jpg
4_faster_rcnn,fold_4,2,2,2,0,0,0230512_145122_jpg.rf.d772ceaa3f11800d1db3d3fc009b64fa.jpg
4_faster_rcnn,fold_4,22,21,21,0,-1,20230512_153049_jpg.rf.523c3f6b00af1f2e03d5832e7dd51cae.jpg
4_faster_rcnn,fold_4,3,2,2,0,-1,IMG_20230512_151832_jpg.rf.b82753ef867011bf9f3989f4130320b7.jpg
4_faster_rcnn,fold_4,1,1,1,0,0,20230512_151710_jpg.rf.e2a5628c7930faedb74febbd18a15ccd.jpg
4_faster_rcnn,fold_4,5,5,5,0,0,IMG_4185_JPG.rf.6ef6b7a942afe064f7a7a9e4939729df.jpg
4_faster_rcnn,fold_4,0,12,0,12,12,20230512_151901_jpg.rf.b378a9d5c3045cf87dd1529a7b516a3a.jpg
4_faster_rcnn,fold_4,0,38,0,38,38,0512_150124_jpg.rf.7253b200930360a6b66d16035d62353c.jpg
4_faster_rcnn,fold_4,3,3,3,0,0,IMG_4195_JPG.rf.0d03c7bef40b40141ba8fa902afc3944.jpg
4_faster_rcnn,fold_4,4,2,2,0,-2,20230512_151029_jpg.rf.aa4b3114b5545da90c2fa92150f01f70.jpg
4_faster_rcnn,fold_4,20,12,10,2,-8,20230512_153247_jpg.rf.78c6c0964c07caf937b2079e23dcd922.jpg
4_faster_rcnn,fold_4,7,7,7,0,0,IMG_20230512_153040_jpg.rf.3179cdcfc75730df90bea9e4cbaf0f49.jpg
4_faster_rcnn,fold_4,10,12,7,5,2,IMG_20230512_145141_jpg.rf.c065d756b2e91f8933ac0a39ecf7c61c.jpg
4_faster_rcnn,fold_4,3,3,2,1,0,IMG_20230512_145333_jpg.rf.4bf3129c20f06bdb19d22b037e743535.jpg
4_faster_rcnn,fold_4,3,3,3,0,0,20230512_151621_jpg.rf.1cbfdf5023fe1c36f7e1875304467d87.jpg
4_faster_rcnn,fold_4,4,4,2,2,0,IMG_20230512_145030_jpg.rf.a2c5e550d29709fcbbe253d3a17faa45.jpg
4_faster_rcnn,fold_4,5,5,5,0,0,20230512_152223_jpg.rf.f6e3e9cd94a0f7908edd48a70c791781.jpg
4_faster_rcnn,fold_4,17,13,12,1,-4,IMG_20230512_152350_jpg.rf.4fb06c58b682b06360ed9fa33472ca3f.jpg
4_faster_rcnn,fold_4,16,13,12,1,-3,20230512_150149_jpg.rf.5f8b1bb241d961acb2fc7ceb62fbcbe5.jpg
4_faster_rcnn,fold_4,7,8,5,3,1,20230512_152306_jpg.rf.20aa1ef8f2026e47d56210676e93fca7.jpg
4_faster_rcnn,fold_4,21,19,14,5,-2,20230512_144930_jpg.rf.f3caeeb846d5d4f624e9885bcb85d864.jpg
4_faster_rcnn,fold_4,14,12,10,2,-2,IMG_20230512_153017_077_jpg.rf.70df56b8159d336a40a3fab054edb7c4.jpg
4_faster_rcnn,fold_4,6,3,2,1,-3,IMG_20230512_144916_143_jpg.rf.00ee144f83892f61d5178b7edacdc535.jpg
4_faster_rcnn,fold_4,1,0,0,0,-1,0018_jpg.rf.ca81692f06f9a1e7e06b1042d8cbe236.jpg
4_faster_rcnn,fold_4,7,7,7,0,0,20230512_152242_jpg.rf.4dee3224c614312f3bd59fc772965ff5.jpg
4_faster_rcnn,fold_4,9,3,1,2,-6,IMG_20230512_150043_1_jpg.rf.5e7eb6e74c9c826c0209bc26685279a3.jpg
4_faster_rcnn,fold_4,1,1,0,1,0,0230512_145013_jpg.rf.14bb403c31ebd5a9f4be760858d91e7c.jpg
4_faster_rcnn,fold_4,1,1,1,0,0,IMG_4044_JPG.rf.e22068c91df69c24b01d3bb4f484ccf9.jpg
4_faster_rcnn,fold_4,9,4,4,0,-5,IMG_20230512_150125_jpg.rf.bdb9638a94f4957f29777b278afdfb54.jpg
4_faster_rcnn,fold_4,17,13,12,1,-4,20230512_152946_jpg.rf.00fa418fbf2242a22bd020d8133a24ee.jpg
4_faster_rcnn,fold_4,19,14,8,6,-5,IMG_20230512_150131_jpg.rf.325767bc75099b22d288f353f1a8fbe2.jpg
4_faster_rcnn,fold_4,16,16,13,3,0,20230512_151041_jpg.rf.0b792381ac6bb324435dd5a7b43616cf.jpg
4_faster_rcnn,fold_4,2,1,1,0,-1,20230512_151443_jpg.rf.7d2dfd53f11811d0c3a7fe9e184ef15f.jpg
4_faster_rcnn,fold_4,13,12,12,0,-1,20230512_153243_jpg.rf.a8672f75e3195db775772b68bce054bf.jpg
4_faster_rcnn,fold_4,7,8,5,3,1,IMG_3912_JPG.rf.6558238f753c37ffb70dd8d3bcee5e9f.jpg
4_faster_rcnn,fold_4,13,7,7,0,-6,IMG_20230512_151318_682_jpg.rf.cdeb9703323a496f0e9620a04f4ec09d.jpg
4_faster_rcnn,fold_4,1,1,1,0,0,0038_jpg.rf.d0b487b5b7af9ce9d50c875d519b9707.jpg
4_faster_rcnn,fold_4,13,15,11,4,2,20230512_150015_jpg.rf.5089b7d402f3ce99da9541171299577e.jpg
4_faster_rcnn,fold_4,13,12,8,4,-1,20230512_153332_jpg.rf.f6c943fc1dfba3d62a21eb08ecf60b8c.jpg
4_faster_rcnn,fold_4,7,7,6,1,0,20230512_152247_jpg.rf.df7d569b56aaba2e6bf5fc59ec8f414c.jpg
4_faster_rcnn,fold_5,23,21,12,9,-2,IMG_20230512_150248_jpg.rf.11fd0431dfaace4800d3f2d4912bd780.jpg
4_faster_rcnn,fold_5,9,7,7,0,-2,20230512_150203_jpg.rf.d7cdb618f9cc06830ca3fad4137b7cac.jpg
4_faster_rcnn,fold_5,13,12,8,4,-1,IMG_20230512_145048_jpg.rf.2f0c31d1a5ff8b461878196ebf8c11df.jpg
4_faster_rcnn,fold_5,3,2,2,0,-1,20230512_145350-0-_jpg.rf.ccf3d3aca429fe2887c17c60d55a358a.jpg
4_faster_rcnn,fold_5,14,14,12,2,0,IMG_20230512_153052_jpg.rf.8577be081284ea5d1672c21d4fd9f288.jpg
4_faster_rcnn,fold_5,2,2,2,0,0,20230512_151628_jpg.rf.fdfad9f330381519b41b6c69eeae4609.jpg
4_faster_rcnn,fold_5,4,6,3,3,2,20230512_150906_jpg.rf.b4718b9b84d49303d6b0fb5e035fe49b.jpg
4_faster_rcnn,fold_5,2,2,2,0,0,IMG_20230512_151744_jpg.rf.1d579e4bc8e6391207029a3d59c821a9.jpg
4_faster_rcnn,fold_5,2,2,1,1,0,0013_jpg.rf.55b646371565f20bce0f6ce403646502.jpg
4_faster_rcnn,fold_5,16,11,7,4,-5,20230512_145021_jpg.rf.57a18381e0e233f1d4d97199a9263ed4.jpg
4_faster_rcnn,fold_5,4,3,3,0,-1,20230512_152325_jpg.rf.b754896fe384db191f35564d52272327.jpg
4_faster_rcnn,fold_5,3,2,2,0,-1,IMG_20230512_151247_jpg.rf.33589b240751a2f02c7a7c51bafafe59.jpg
4_faster_rcnn,fold_5,3,4,3,1,1,20230512_151624_jpg.rf.339fa34d1377a1b59daa0460f8896c47.jpg
4_faster_rcnn,fold_5,7,8,5,3,1,IMG_20230512_145013_jpg.rf.23ebd19f18a23ba18f9bde6b91f93cbd.jpg
4_faster_rcnn,fold_5,5,6,5,1,1,20230512_153327_jpg.rf.07e6f7dfffed230d78bc971f5cdb9b9f.jpg
4_faster_rcnn,fold_5,1,1,1,0,0,20230512_151652_jpg.rf.42dfca221b4b4fbaf828e370670fd031.jpg
4_faster_rcnn,fold_5,13,8,7,1,-5,20230512_151021-copia-1-_jpg.rf.abdeaa1b054ea3b58658807cca9089ae.jpg
4_faster_rcnn,fold_5,2,2,2,0,0,IMG_20230512_151820_jpg.rf.2fe30b8ed1d8e20bac353cf3379cdcce.jpg
4_faster_rcnn,fold_5,9,8,6,2,-1,IMG_20230512_151055_jpg.rf.4509eabdb200535ad64add0b786d59a4.jpg
4_faster_rcnn,fold_5,3,3,3,0,0,20230512_150026_jpg.rf.33fe35571137ce16bd8c3bd383b8db8f.jpg
4_faster_rcnn,fold_5,4,3,2,1,-1,0005_jpg.rf.024cc60176c5f8a007eca0cbdacb4691.jpg
4_faster_rcnn,fold_5,17,14,12,2,-3,20230512_151040_jpg.rf.87640fb95b74f117e81bcca0c41f76af.jpg
4_faster_rcnn,fold_5,11,9,5,4,-2,20230512_152314_jpg.rf.0becd9c30d5157c4b2a582e3fa4b759a.jpg
4_faster_rcnn,fold_5,11,8,8,0,-3,20230512_151853_jpg.rf.b5af18c1578fd0fbb73f9427792d45c0.jpg
4_faster_rcnn,fold_5,1,1,1,0,0,20230512_150249_jpg.rf.78e9f249c2e4a31b39a078b7266ac51a.jpg
4_faster_rcnn,fold_5,22,16,11,5,-6,20230512_150104_jpg.rf.291e8ff0d311863c8ac10188b0cb1b28.jpg
4_faster_rcnn,fold_5,3,3,2,1,0,20230512_145232_jpg.rf.f26463ccf279cd604dca1dded979fa14.jpg
4_faster_rcnn,fold_5,10,4,3,1,-6,20230512_153454_jpg.rf.a2384c87b34aeaa97bbbbd20e8b1d56b.jpg
4_faster_rcnn,fold_5,1,0,0,0,-1,20230512_151017_jpg.rf.c588fa9199c6dffdb1179f7f483c865f.jpg
4_faster_rcnn,fold_5,17,15,12,3,-2,20230512_150146_jpg.rf.e84fc4cf33f8326d64d02b7ed8cafce4.jpg
4_faster_rcnn,fold_5,6,6,4,2,0,IMG_3850_JPG.rf.7f7105ed07be37f94ee73db7da91b99e.jpg
4_faster_rcnn,fold_5,1,1,0,1,0,20230512_145114_jpg.rf.38c9c923c79af5172bfb7315ee2859bb.jpg
4_faster_rcnn,fold_5,1,1,0,1,0,20230512_152332_jpg.rf.4836b4b24c985755468de47d12fd4fa5.jpg
4_faster_rcnn,fold_5,6,6,6,0,0,20230512_151136_jpg.rf.a8aef98dbb4c86bffec8ae4287c1dc6e.jpg
4_faster_rcnn,fold_5,5,5,4,1,0,IMG_20230512_152359_jpg.rf.a5ab36a1dd0fd3e5088b4ed61c7990eb.jpg
4_faster_rcnn,fold_5,17,14,10,4,-3,IMG_4208_JPG.rf.8f59289e526ec56a405f244ebaa1a95a.jpg
4_faster_rcnn,fold_5,1,2,1,1,1,20230512_151208_jpg.rf.0f6b66ca4ada91b2974b5945e2b92069.jpg
4_faster_rcnn,fold_5,3,2,2,0,-1,20230512_151839_jpg.rf.7e5100e585fd816285691f17e14cfcdb.jpg
4_faster_rcnn,fold_5,4,4,4,0,0,IMG_3919_JPG.rf.9a5b0afd3da0db473f842046c5113690.jpg
4_faster_rcnn,fold_5,8,7,4,3,-1,20230512_145241_jpg.rf.455691f27dd7da4e6c25ba615f3f2620.jpg
4_faster_rcnn,fold_5,2,2,2,0,0,0230512_145355_jpg.rf.c17e94a0f80c4c06f2a620a85826ebcc.jpg
4_faster_rcnn,fold_5,1,2,1,1,1,20230512_151504_jpg.rf.c79fb008568aeb31342688eb80ad9a49.jpg
4_faster_rcnn,fold_5,2,2,2,0,0,0029_jpg.rf.e9d3f2a53d6d73564cd418ea60fbbd61.jpg
4_faster_rcnn,fold_5,2,2,2,0,0,20230512_151133_jpg.rf.a96da38b573a4da364c3f36aaf0c460d.jpg
4_faster_rcnn,fold_5,2,2,2,0,0,IMG_20230512_151814_jpg.rf.d8d7b03e58abeca643b8f9e71acfd81a.jpg
4_faster_rcnn,fold_5,1,0,0,0,-1,20230512_151010_jpg.rf.a46c76d923129f16810ff21ca0937475.jpg
4_faster_rcnn,fold_5,2,1,1,0,-1,0032_jpg.rf.ac745db746452e37d39279a2c8ecd454.jpg
4_faster_rcnn,fold_5,8,7,6,1,-1,20230512_151510_jpg.rf.b27f217e8ec95c059fa149f7f8f03d2b.jpg
4_faster_rcnn,fold_5,3,2,2,0,-1,IMG_20230512_151228_jpg.rf.1e509a8a9a3464432051f5ec53cc611c.jpg
4_faster_rcnn,fold_5,15,14,14,0,-1,0045_jpg.rf.b8baabd840c67f80f92a3844015afe9b.jpg
4_faster_rcnn,fold_5,13,10,10,0,-3,20230512_151047_jpg.rf.3fb94f0bd6175b2f1306a1aac0027216.jpg
4_faster_rcnn,fold_5,12,8,8,0,-4,IMG_20230512_150922_jpg.rf.e1a7736e96dfcd7e2b06e2f5c94a3cc1.jpg
4_faster_rcnn,fold_5,1,2,1,1,1,0010_jpg.rf.d1d93d099773f36e90b527f8611d128c.jpg
4_faster_rcnn,fold_5,68,43,38,5,-25,IMG_20230512_153133_jpg.rf.b54f10d107857a0eb7fbb7943b030152.jpg
4_faster_rcnn,fold_5,1,2,1,1,1,IMG_20230512_151445_jpg.rf.853f3efcb5076d2d7bac2e663f2804bd.jpg
4_faster_rcnn,fold_5,1,1,1,0,0,IMG_20230512_151214_161_jpg.rf.057ee941cfb105e5fd41f7e4342f657a.jpg
4_faster_rcnn,fold_5,1,0,0,0,-1,230512_150310_jpg.rf.25af60211cc7ea70d0a37dae89d778ae.jpg
4_faster_rcnn,fold_5,11,10,10,0,-1,IMG_20230512_151958_jpg.rf.c0c5a182cd6f5f4319120803cadd4e15.jpg
4_faster_rcnn,fold_5,7,7,1,6,0,230512_150020_jpg.rf.3321ea3a69f605601bbe1180e33c4372.jpg
4_faster_rcnn,fold_5,2,2,2,0,0,20230512_151705_jpg.rf.5d4aace27e10d6b9f9dcd14c2eb80876.jpg
4_faster_rcnn,fold_5,10,7,6,1,-3,IMG_20230512_151057_jpg.rf.34b51a9edb1d08b21feec0712493ad44.jpg
4_faster_rcnn,fold_5,4,3,3,0,-1,20230512_151746_jpg.rf.28bbdba7c34f11ae2fa3b6c62e25edcc.jpg
4_faster_rcnn,fold_5,12,11,9,2,-1,20230512_145147_jpg.rf.8cbc9f87bfc771396f02c8e27231d7ee.jpg
4_faster_rcnn,fold_5,5,6,5,1,1,IMG_20230512_152233_631_jpg.rf.5a6ed894f5cd8513bac1f0dfbdeb7bf3.jpg
4_faster_rcnn,fold_5,1,1,1,0,0,20230512_145424_jpg.rf.fdacfd117c87835a809a784e9019c683.jpg
4_faster_rcnn,fold_5,1,1,1,0,0,20230512_145347_jpg.rf.d1edf1d3992c10216d75faac6523aed9.jpg
4_faster_rcnn,fold_5,7,7,6,1,0,IMG_20230512_145116_jpg.rf.89714791069678114dd234188f4e153e.jpg
4_faster_rcnn,fold_5,5,5,5,0,0,20230512_152308_jpg.rf.f4e8f4ca110dded8e5b00937a84760be.jpg
4_faster_rcnn,fold_5,11,5,3,2,-6,IMG_4212_JPG.rf.93840a5a997c2230b8ec5404df51506e.jpg
4_faster_rcnn,fold_5,22,20,12,8,-2,20230512_150120_jpg.rf.e2c884c6c431ae355dbe5eae448fe9fe.jpg
4_faster_rcnn,fold_5,1,2,1,1,1,0035_jpg.rf.8f80b9113851faa3ce22f7a4237e063b.jpg
4_faster_rcnn,fold_5,1,0,0,0,-1,IMG_4020_JPG.rf.bc2697c76c5828734e1ac848245c5a5b.jpg
4_faster_rcnn,fold_5,6,6,5,1,0,IMG_20230512_151224_jpg.rf.f07ca2ca5270e16cfa2d0b808d60cc7f.jpg
4_faster_rcnn,fold_5,14,15,13,2,1,20230512_152357_jpg.rf.6852fe96763037ed9985128c109b3ce2.jpg
4_faster_rcnn,fold_5,21,15,13,2,-6,IMG_20230512_150344_jpg.rf.21eb7b1441ddc9b2740cc4367709590f.jpg
4_faster_rcnn,fold_5,2,2,0,2,0,20230512_145054_jpg.rf.3d4529e01dd37f4f80ba26154a898555.jpg
4_faster_rcnn,fold_5,7,7,7,0,0,20230512_152258_jpg.rf.7636714c888f4e6cbf70120b64064d40.jpg
4_faster_rcnn,fold_5,2,2,2,0,0,20230512_151841_jpg.rf.9dd3a6bca715d1085cb1da5cae6efd0f.jpg
4_faster_rcnn,fold_5,19,12,6,6,-7,20230512_150051_jpg.rf.c03c04498642818f22eb4115246bdb27.jpg
4_faster_rcnn,fold_5,2,2,1,1,0,20230512_151635_jpg.rf.ee2ff8efc5aaa53fea09028b60c05e75.jpg
4_faster_rcnn,fold_5,24,10,5,5,-14,IMG_20230512_150107_368_jpg.rf.841def69669689958248c77fd74c6ef5.jpg
4_faster_rcnn,fold_5,1,1,1,0,0,20230512_151647_jpg.rf.367411ded71931545e2f1f2799cebf0b.jpg
4_faster_rcnn,fold_5,2,1,1,0,-1,20230512_151223_jpg.rf.6a7ba0efceb9c41d056eee7ad9219353.jpg
4_faster_rcnn,fold_5,4,4,4,0,0,20230512_145213_jpg.rf.166b2f375e79324c95dc48c23bef06fa.jpg
4_faster_rcnn,fold_5,2,2,1,1,0,IMG_3844_JPG.rf.8a9213642776490b8b621595f6183af2.jpg
4_faster_rcnn,fold_5,14,11,6,5,-3,20230512_145202_jpg.rf.fc0b0601e248df8d80e9bb9ba998d0e7.jpg
4_faster_rcnn,fold_5,26,12,9,3,-14,0512_150040_jpg.rf.f8c148cb1d657923d62ef9d7c2a4e8c4.jpg
4_faster_rcnn,fold_5,9,8,8,0,-1,20230512_153259_jpg.rf.893deba08433f5f85baa0becc85071b1.jpg
4_faster_rcnn,fold_5,1,1,1,0,0,IMG_20230512_150840_jpg.rf.3e9980cbe445c9f1025d481e7a7a5710.jpg
4_faster_rcnn,fold_5,17,14,10,4,-3,20230512_151049_jpg.rf.7faee580bbaad04f4aee5a6edf72e5b5.jpg
4_faster_rcnn,fold_5,43,23,18,5,-20,0512_150100_jpg.rf.9eaed3be83ecba8e3e4efbdc882c1fa5.jpg
4_faster_rcnn,fold_5,2,0,0,0,-2,230512_150026_jpg.rf.633ed1e3a24d8c7ecacc82788de5c3b8.jpg
4_faster_rcnn,fold_5,3,3,0,3,0,IMG_20230512_153013_jpg.rf.93712b9e1c24432fd87372997521847c.jpg
4_faster_rcnn,fold_5,2,1,1,0,-1,0017_jpg.rf.c3653cc70e103964ca9e6a3e85f3f694.jpg
4_faster_rcnn,fold_5,5,3,3,0,-2,20230512_151508_jpg.rf.00e90b7105d608decd85f3e850e1f875.jpg
4_faster_rcnn,fold_5,8,6,4,2,-2,IMG_20230512_150939_jpg.rf.d5260c01e2cabb005d119333eda4e87d.jpg
4_faster_rcnn,fold_5,2,2,1,1,0,IMG_4021_JPG.rf.7556e49a1eda27532dfb6cc32c974482.jpg
4_faster_rcnn,fold_5,5,5,5,0,0,20230512_152302_jpg.rf.016780b8da4c66843b955300975f2747.jpg
4_faster_rcnn,fold_5,34,17,15,2,-17,IMG_20230512_150128_453_jpg.rf.081da15c5e562b5ce7f42ab95339a34a.jpg
4_faster_rcnn,fold_5,1,1,1,0,0,0027_jpg.rf.041bc0af55a373703357342785fa3667.jpg
4_faster_rcnn,fold_5,1,1,1,0,0,20230512_150050_jpg.rf.c95631863834d93e37ddc2fda8829ab4.jpg
4_faster_rcnn,fold_5,10,9,9,0,-1,IMG_20230512_153016_jpg.rf.c257848a0cea9445774e7172a68a0d16.jpg
4_faster_rcnn,fold_5,21,19,18,1,-2,20230512_152409_jpg.rf.5d8e7c06336544573f46c12fe04ef26b.jpg
4_faster_rcnn,fold_5,4,2,2,0,-2,IMG_20230512_151230_jpg.rf.77eaf1e461982f94562c61c5de9e3444.jpg
4_faster_rcnn,fold_5,3,3,3,0,0,IMG_4192_JPG.rf.915fc04cdd59b40454fa22fea6dcf2f7.jpg
4_faster_rcnn,fold_5,1,1,1,0,0,20230512_145226_jpg.rf.d01dc6c5e4859db13d337281014a74b1.jpg
4_faster_rcnn,fold_5,1,1,1,0,0,20230512_151100_jpg.rf.8c5db2f9786fe5fedf170c30766e11a8.jpg
4_faster_rcnn,fold_5,11,9,9,0,-2,20230512_151912_jpg.rf.2dfbdab89b348f4eda01f5edbb8bf596.jpg
4_faster_rcnn,fold_5,8,8,5,3,0,20230512_145439_jpg.rf.21c5c0c901e6a327a75c7f0dc4eafc1c.jpg
4_faster_rcnn,fold_5,1,0,0,0,-1,IMG_20230512_151206_373_jpg.rf.25070077bf672ae36c15ea6e22fdc049.jpg
4_faster_rcnn,fold_5,1,1,1,0,0,20230512_145257_jpg.rf.f1c0c8bd862cb12f380ae5d7949e68a2.jpg
4_faster_rcnn,fold_5,5,4,4,0,-1,IMG_20230512_153021_jpg.rf.c74db55af384c855422ee71d8c0c24a2.jpg
4_faster_rcnn,fold_5,20,20,18,2,0,IMG_20230512_152355_jpg.rf.1ee2ad035e7125aadb708f8b70abd231.jpg
4_faster_rcnn,fold_5,3,6,2,4,3,20230512_152249_jpg.rf.9209f7c7b47e7778a14dc41949d8882b.jpg
4_faster_rcnn,fold_5,1,1,1,0,0,20230512_151230_jpg.rf.ab81eae29bf9052e3dd989b36b3a00cd.jpg
4_faster_rcnn,fold_5,3,3,3,0,0,IMG_3915_JPG.rf.83d4afabcacf1fe7976e4f01a8b55687.jpg
4_faster_rcnn,fold_5,2,3,3,0,1,IMG_3913_JPG.rf.23307ea91d746d228b58a6db32ff0bca.jpg
4_faster_rcnn,fold_5,10,9,7,2,-1,IMG_20230512_145140_jpg.rf.a089bf5c311c725d73e925fe2d7d4c66.jpg
4_faster_rcnn,fold_5,10,8,8,0,-2,20230512_151859_jpg.rf.820ed98fb886601f4f15717490003a3e.jpg
4_faster_rcnn,fold_5,3,3,3,0,0,20230512_152225_jpg.rf.889528313caa94497bf581fc9b6ec204.jpg
4_faster_rcnn,fold_5,7,5,5,0,-2,20230512_145340_jpg.rf.962ef85b90f87307d46df866e8b6be07.jpg
4_faster_rcnn,fold_5,1,1,1,0,0,IMG_4397_JPG.rf.ff87fb693a34984f9e818a3a3a1a79b3.jpg
4_faster_rcnn,fold_5,11,11,11,0,0,20230512_151903_jpg.rf.e84304253d71e06ad8473e1be6aa7582.jpg
4_faster_rcnn,fold_5,16,14,7,7,-2,IMG_20230512_150056_jpg.rf.65358cd23942ee92bc5024b41d26500a.jpg
4_faster_rcnn,fold_5,29,19,14,5,-10,0512_150057_jpg.rf.c228357b2bf9bb499210e8c8c7afa45b.jpg
4_faster_rcnn,fold_5,2,2,2,0,0,20230512_153435_jpg.rf.52f71510b3fa5d1e5d0f6e2468cab216.jpg
4_faster_rcnn,fold_5,16,9,7,2,-7,IMG_20230512_145123_jpg.rf.1bbba4202dcb5637d1840db017c11671.jpg
4_faster_rcnn,fold_5,1,2,0,2,1,20230512_153421_jpg.rf.4cb37bb0380a93d519214becab03862c.jpg
4_faster_rcnn,fold_5,16,12,11,1,-4,20230512_144939_jpg.rf.32f704ff01b8b91ab11ac16462053c96.jpg
4_faster_rcnn,fold_5,1,2,1,1,1,20230512_151453_jpg.rf.fc89aea08c4953e972d355bc593bd6ae.jpg
4_faster_rcnn,fold_5,1,1,0,1,0,IMG_4019_JPG.rf.13ea285b754475b580f840ba9fc99608.jpg
4_faster_rcnn,fold_5,5,5,4,1,0,20230512_152320_jpg.rf.373cf359be94c413709d04995faada1e.jpg
4_faster_rcnn,fold_5,1,0,0,0,-1,IMG_20230512_145029_jpg.rf.7bf65ac7d5d4f934ebfd179e7ad97968.jpg
4_faster_rcnn,fold_5,2,2,2,0,0,0049_jpg.rf.d9e63c2316d02b96968a7dd44061b337.jpg
4_faster_rcnn,fold_5,1,3,1,2,2,230512_150124_jpg.rf.a1dce64e321706af2f260a6b933ae5d1.jpg
4_faster_rcnn,fold_5,1,1,1,0,0,20230512_145108_jpg.rf.cfa16a281bcee146efbf5aac473021a3.jpg
4_faster_rcnn,fold_5,3,2,1,1,-1,20230512_145127_jpg.rf.2e6c583887c26feb5d54542c0b963ea1.jpg
4_faster_rcnn,fold_5,7,7,6,1,0,IMG_20230512_151451_jpg.rf.2218d423d5bccf8392a803b3052b5d3b.jpg
4_faster_rcnn,fold_5,5,5,4,1,0,0230512_145345_jpg.rf.349c9a4b5a46e8d3477462f4e4215cba.jpg
4_faster_rcnn,fold_5,11,11,11,0,0,20230512_151908_jpg.rf.b315ad5e28b7bf0551708d4ea9d3dd39.jpg
4_faster_rcnn,fold_5,12,9,7,2,-3,20230512_152237_jpg.rf.808fe6741a783c4fa83bfabf79676eac.jpg
4_faster_rcnn,fold_5,1,1,1,0,0,20230512_151806-0-_jpg.rf.ee8c0cb2ceb0752fb58a7e8380a489b8.jpg
4_faster_rcnn,fold_5,5,4,4,0,-1,20230512_152311_jpg.rf.5e824954dc303eba4a13e80481374d92.jpg
4_faster_rcnn,fold_5,5,2,1,1,-3,IMG_20230512_151619_jpg.rf.602d997ec01411a318e031faecec475a.jpg
4_faster_rcnn,fold_5,8,9,8,1,1,20230512_150205_jpg.rf.af4ff5234c4e2039ba4aa43dfef61137.jpg
4_faster_rcnn,fold_5,1,1,1,0,0,20230512_151641_jpg.rf.9d3677c71aedef7846514f40d39cc285.jpg
4_faster_rcnn,fold_5,1,1,1,0,0,IMG_4396_JPG.rf.a6ca21b5c9e64200051d628058fac8d3.jpg
4_faster_rcnn,fold_5,4,5,4,1,1,IMG_20230512_151255_jpg.rf.7a344a314dbceac482eaa7344270d575.jpg
4_faster_rcnn,fold_5,3,3,2,1,0,20230512_145413_jpg.rf.d92c86a64c63fad8780cddf8f9af65d7.jpg
4_faster_rcnn,fold_5,15,15,12,3,0,IMG_20230512_153000_904_jpg.rf.0910e6a7b929687a7f2cb7d8110febe6.jpg
4_faster_rcnn,fold_5,3,3,3,0,0,IMG_3864_JPG.rf.0b9655ea20ce691d9f9006c6ab150d3c.jpg
4_faster_rcnn,fold_5,10,11,8,3,1,230512_145026_jpg.rf.f23932c58f897cb3d0594cc7af5c44f4.jpg
4_faster_rcnn,fold_5,6,6,2,4,0,230512_150021_jpg.rf.9f8dde8cf7d3e52b983f2e1dee1f56d6.jpg
4_faster_rcnn,fold_5,21,17,15,2,-4,20230512_152319_jpg.rf.3d825a3794a8b316d78f9af2806a7c6c.jpg
4_faster_rcnn,fold_5,1,1,1,0,0,20230512_152353_jpg.rf.ed8431bc0af772a21f7e6f7b52b33d4e.jpg
4_faster_rcnn,fold_5,10,9,9,0,-1,20230512_151345_jpg.rf.4dd52a96ef715b94641151e55cadac59.jpg
4_faster_rcnn,fold_5,6,6,5,1,0,20230512_145401_jpg.rf.44167fa74f8667ec2ab9d47632567ba8.jpg
4_faster_rcnn,fold_6,1,2,1,1,1,IMG_3918_JPG.rf.73a732415980a079e2ee9f088f0b902b.jpg
4_faster_rcnn,fold_6,3,1,0,1,-2,20230512_150304_jpg.rf.42997b281c38f2d2e1caa252c8202466.jpg
4_faster_rcnn,fold_6,1,1,0,1,0,20230512_145018_jpg.rf.6120633e9f3b01a0322386f7107b3216.jpg
4_faster_rcnn,fold_6,2,3,1,2,1,IMG_20230512_151746_jpg.rf.e11cc2bdd754b8c380d4b2f51b494333.jpg
4_faster_rcnn,fold_6,1,1,1,0,0,IMG_3859_JPG.rf.217ab58b1022e7dbdcc07a4a48bdf055.jpg
4_faster_rcnn,fold_6,3,4,3,1,1,20230512_151142_jpg.rf.959c44ca45dfd6e8f7458240928724a4.jpg
4_faster_rcnn,fold_6,7,9,7,2,2,IMG_20230512_153034_jpg.rf.d2546314233e70df166dd444373fe566.jpg
4_faster_rcnn,fold_6,39,17,13,4,-22,20230512_150259_jpg.rf.640d17e1a5cec14371d2ef32c74c215b.jpg
4_faster_rcnn,fold_6,1,1,1,0,0,20230512_151613-0-_jpg.rf.d6f5456bcfe941a2766b34ca25d6e64c.jpg
4_faster_rcnn,fold_6,1,0,0,0,-1,20230512_151247_jpg.rf.559bbd96f04ed0b61011356b33038efb.jpg
4_faster_rcnn,fold_6,12,12,12,0,0,20230512_151901-0-_jpg.rf.23717847adee37125505701d84f8b2c4.jpg
4_faster_rcnn,fold_6,2,2,1,1,0,0230512_145403_jpg.rf.86e849309856a70f7343d14e0be80d1f.jpg
4_faster_rcnn,fold_6,18,15,13,2,-3,20230512_150212-0-_jpg.rf.42aaa169dabc6e224af1ad2603fa77d9.jpg
4_faster_rcnn,fold_6,1,1,1,0,0,IMG_20230512_150958_jpg.rf.806f513ed04cbf893c8a805d028e17a5.jpg
4_faster_rcnn,fold_6,6,2,2,0,-4,IMG_20230512_150849_517_jpg.rf.8292597aeb2edd9ad9a8634d1e6ce325.jpg
4_faster_rcnn,fold_6,5,7,5,2,2,20230512_153406_jpg.rf.5fd9ed7f498c063bbe363af58bf64afe.jpg
4_faster_rcnn,fold_6,1,1,1,0,0,20230512_145139_jpg.rf.1ccaa55656a3b72abb079fcaca9ebd91.jpg
4_faster_rcnn,fold_6,9,10,5,5,1,20230512_145207_jpg.rf.d6520c0b52ca9d11cbdb08e7fcad7279.jpg
4_faster_rcnn,fold_6,1,1,1,0,0,20230512_151709_jpg.rf.67e1deefca206f50f10d35552ae2213f.jpg
4_faster_rcnn,fold_6,9,9,7,2,0,20230512_152229_jpg.rf.f718118201e6c3b0a3b3d89958725c05.jpg
4_faster_rcnn,fold_6,18,11,10,1,-7,20230512_151030_jpg.rf.99cd8001fdf2562bbd43c3e28ec3bc18.jpg
4_faster_rcnn,fold_6,1,1,1,0,0,0016_jpg.rf.2a262f7303067736073549486906cc43.jpg
4_faster_rcnn,fold_6,1,1,1,0,0,20230512_151651_jpg.rf.d9eebb8d47a3a2ecc2b5ab5fce867c62.jpg
4_faster_rcnn,fold_6,3,4,3,1,1,IMG_20230512_151216_jpg.rf.212dba7457c89d85163142d3417d011a.jpg
4_faster_rcnn,fold_6,2,2,2,0,0,20230512_151754_jpg.rf.54ba86e6a384ea604ca2e9b48b6baaf5.jpg
4_faster_rcnn,fold_6,7,8,5,3,1,MG_20230512_145052_jpg.rf.e48facc3a59ffc87c5c20e1e858d782f.jpg
4_faster_rcnn,fold_6,1,1,1,0,0,20230512_145105_jpg.rf.773b834198bf17c51531470842565757.jpg
4_faster_rcnn,fold_6,2,1,0,1,-1,20230512_150310_jpg.rf.1c8474c411cc1309fdcb6f4f05ad76e7.jpg
4_faster_rcnn,fold_6,11,8,6,2,-3,IMG_20230512_151242_jpg.rf.46afd180ee87359123f370468c16ecd9.jpg
4_faster_rcnn,fold_6,7,8,6,2,1,IMG_20230512_150822_610_jpg.rf.202648ab81c8a246ef6e9d92f76fc793.jpg
4_faster_rcnn,fold_6,13,12,11,1,-1,0230512_150158_jpg.rf.87404c9e49a82e56c7dade7c3898effc.jpg
4_faster_rcnn,fold_6,3,3,3,0,0,20230512_145214_jpg.rf.7dff106d138e1a8492bda9d8a939f1df.jpg
4_faster_rcnn,fold_6,12,11,9,2,-1,20230512_150028_jpg.rf.af876dc827626d5f87a6fe1e271ef879.jpg
4_faster_rcnn,fold_6,10,9,6,3,-1,20230512_150924_jpg.rf.e5426caf129241e7f71edfd6460ffb7b.jpg
4_faster_rcnn,fold_6,36,28,25,3,-8,IMG_20230512_150302_jpg.rf.9b111acf170d8c1671212ec46ca5f96b.jpg
4_faster_rcnn,fold_6,2,2,1,1,0,IMG_3855_JPG.rf.3c07d7a3a717987d18e4881f741f0109.jpg
4_faster_rcnn,fold_6,42,26,18,8,-16,0002_jpg.rf.e28c19f2eeb804b4f3db5cb8a9b96722.jpg
4_faster_rcnn,fold_6,2,2,2,0,0,20230512_151519_jpg.rf.a798ec75f634d9c0b2099d74e6391b2f.jpg
4_faster_rcnn,fold_6,1,1,1,0,0,20230512_145231_jpg.rf.5067ec9a11eb10e94f1992fa7b9fdca9.jpg
4_faster_rcnn,fold_6,6,6,5,1,0,20230512_151813_jpg.rf.8e04e5f09260558a80ad8ed222a6842d.jpg
4_faster_rcnn,fold_6,17,16,16,0,-1,0039_jpg.rf.24da2dcb61a34ae88e4e3ae85334ec49.jpg
4_faster_rcnn,fold_6,2,2,1,1,0,IMG_4016_JPG.rf.57796edbcc20ef6bb7930ae2c9b790e7.jpg
4_faster_rcnn,fold_6,9,10,5,5,1,0230512_150107_jpg.rf.255ebb7bf873cd1fb62870dd946c636b.jpg
4_faster_rcnn,fold_6,1,1,1,0,0,IMG_4045_JPG.rf.5fd568888c253fc15e61ef0e6a600736.jpg
4_faster_rcnn,fold_6,2,1,0,1,-1,20230512_151706_jpg.rf.a1ec45640c8ceaf421bdd396abbff09a.jpg
4_faster_rcnn,fold_6,5,1,1,0,-4,IMG_20230512_150931_075_jpg.rf.e33516383d2c37617b8a3623da6f46df.jpg
4_faster_rcnn,fold_6,2,3,2,1,1,20230512_150045-0-_jpg.rf.e0a79a709ca27bbd1ddee5f8a4336ea8.jpg
4_faster_rcnn,fold_6,5,5,5,0,0,20230512_152227_jpg.rf.0537631b05bb432698dc401e82e41cdd.jpg
4_faster_rcnn,fold_6,6,5,5,0,-1,20230512_151547_jpg.rf.11083d91d633eac77747e3332d593385.jpg
4_faster_rcnn,fold_6,12,15,11,4,3,20230512_151043_jpg.rf.3411f895e2985588186e8495e99b2a5d.jpg
4_faster_rcnn,fold_6,2,2,1,1,0,20230512_150754_jpg.rf.25cdffe09e3da5825e5287e9707d28b7.jpg
4_faster_rcnn,fold_6,2,3,2,1,1,20230512_150054_jpg.rf.d397e2f4f89585ae423d36316b68e0d3.jpg
4_faster_rcnn,fold_6,1,1,1,0,0,20230512_151658_jpg.rf.64accf87df1b759e733862bd5826d73c.jpg
4_faster_rcnn,fold_6,9,7,7,0,-2,20230512_150251_jpg.rf.5e1c1bb0e6397c87b2959920705bf3e4.jpg
4_faster_rcnn,fold_6,1,1,0,1,0,20230512_145027_jpg.rf.ec568ee157ffdc70fa125022bd4e2226.jpg
4_faster_rcnn,fold_6,24,25,18,7,1,IMG_3929_JPG.rf.a2180d03c20d1cfeece3cc8d116bef58.jpg
4_faster_rcnn,fold_6,6,6,4,2,0,IMG_20230512_145356_jpg.rf.aade91e03425891ebb1e7913c596a6bb.jpg
4_faster_rcnn,fold_6,4,0,0,0,-4,20230512_151320_jpg.rf.000a402e9a61ca254ddb3eb836b8d52e.jpg
4_faster_rcnn,fold_6,1,3,1,2,2,20230512_150053_jpg.rf.088308ae98c13a53c0cd09a0c5d7873d.jpg
4_faster_rcnn,fold_6,2,2,2,0,0,IMG_4030_JPG.rf.d581bcd4c0908b4512a05d8d538db640.jpg
4_faster_rcnn,fold_6,2,1,0,1,-1,20230512_145101_jpg.rf.2e2ab39bfad17ac6cf7a40fbca0233b7.jpg
4_faster_rcnn,fold_6,11,6,5,1,-5,20230512_151319_jpg.rf.95cf4d71c19232b1c36b69b6329abdb6.jpg
4_faster_rcnn,fold_6,1,1,1,0,0,20230512_145222_jpg.rf.dc5b10230a198c45f4f849d8bea6cf45.jpg
4_faster_rcnn,fold_6,13,13,13,0,0,0003_jpg.rf.a4014333632a8045d62b2480bccb288b.jpg
4_faster_rcnn,fold_6,21,19,17,2,-2,IMG_20230512_150346_jpg.rf.5eb42adbd89cd335587264e87d4a07ea.jpg
4_faster_rcnn,fold_6,2,2,1,1,0,20230512_151742_jpg.rf.734b217dddc054e2dbb00d9964713986.jpg
4_faster_rcnn,fold_6,1,1,0,1,0,20230512_145328_jpg.rf.dcfa7faebf8b77528401b336abf6eaad.jpg
4_faster_rcnn,fold_6,5,5,5,0,0,20230512_145335_jpg.rf.896d2a48efad0e17923f2fec260761b0.jpg
4_faster_rcnn,fold_6,4,3,3,0,-1,IMG_4386_JPG.rf.642872f82064187dff74f15b1ff0a923.jpg
4_faster_rcnn,fold_6,2,1,0,1,-1,20230512_150049_jpg.rf.e1512981920c32d09de9c291359753fd.jpg
4_faster_rcnn,fold_6,2,2,1,1,0,IMG_3848_JPG.rf.6bccac66dae879c76b4ff16dd5be0243.jpg
4_faster_rcnn,fold_6,4,5,2,3,1,0230512_145343_jpg.rf.fcd20fb05b55e0279971dbad416be7a2.jpg
4_faster_rcnn,fold_6,5,2,2,0,-3,IMG_4092_JPG.rf.3e9ac49e2c6b51adac2c75ecdf6ebc5b.jpg
4_faster_rcnn,fold_6,5,8,2,6,3,20230512_150110_jpg.rf.36e77e8ab39d8ce0cccdd59c9e84ceca.jpg
4_faster_rcnn,fold_6,2,2,2,0,0,IMG_20230512_150928_jpg.rf.713e71e29e1ae02d5cdba88b3134bae9.jpg
4_faster_rcnn,fold_6,3,2,2,0,-1,230512_150127_jpg.rf.85daac8693c9a5866ff2f7839d81d2e8.jpg
4_faster_rcnn,fold_6,2,2,2,0,0,20230512_145048_jpg.rf.6202c446935381c48cf520aa5c6640f6.jpg
4_faster_rcnn,fold_6,16,9,0,9,-7,IMG_3930_JPG.rf.7a6e996e69e203ed4aa5de3126a2d2ee.jpg
4_faster_rcnn,fold_6,10,11,10,1,1,20230512_152223_jpg.rf.9ee2de301ef5a2a10d57b30f309a7d84.jpg
4_faster_rcnn,fold_6,7,6,6,0,-1,IMG_4057_JPG.rf.62dc219aee41c1e1eeb47a2bd511e5f0.jpg
4_faster_rcnn,fold_6,29,22,17,5,-7,0512_150154_jpg.rf.6ab493c468717275a5b2b74420a88180.jpg
4_faster_rcnn,fold_6,13,12,11,1,-1,IMG_20230512_153036_jpg.rf.92b3c0599c74bfff25f17f2e97011b27.jpg
4_faster_rcnn,fold_6,4,7,2,5,3,0230512_145357_jpg.rf.bb3b0c47d3344c5f0714c51d50f9eab8.jpg
4_faster_rcnn,fold_6,6,6,5,1,0,20230512_145337_jpg.rf.eb0881ecd757c868e839b7663c8ec930.jpg
4_faster_rcnn,fold_6,1,1,0,1,0,230512_150306_jpg.rf.57428899933c6b401506a61768585669.jpg
4_faster_rcnn,fold_6,3,3,3,0,0,20230512_151543_jpg.rf.10d24602404882d9cc93169ca45912de.jpg
4_faster_rcnn,fold_6,101,31,26,5,-70,0108_jpg.rf.e585b32f135131ce6476b6962a9dbad4.jpg
4_faster_rcnn,fold_6,18,16,15,1,-2,20230512_152242_jpg.rf.db9cf140b85724a386050e2debe57fa2.jpg
4_faster_rcnn,fold_6,8,8,6,2,0,20230512_145153_jpg.rf.31de3120042ffe1cc96af5b129c48c8d.jpg
4_faster_rcnn,fold_6,2,2,2,0,0,20230512_151240_jpg.rf.d86e0b8b1457d5a8b4c4c2db8c1e9b84.jpg
4_faster_rcnn,fold_6,2,3,2,1,1,20230512_145338_jpg.rf.210a3a3cfad0b0ee89036fcc677c1076.jpg
4_faster_rcnn,fold_6,4,4,4,0,0,IMG_4094_JPG.rf.fc1f6e86b3b032266a05b3508e461113.jpg
4_faster_rcnn,fold_6,2,1,1,0,-1,IMG_20230512_151944_jpg.rf.d5aeefc60fa0f36a43c0496ef0aef803.jpg
4_faster_rcnn,fold_6,3,3,3,0,0,20230512_145339_jpg.rf.bf7369afe55b64f770770e2bc84385eb.jpg
4_faster_rcnn,fold_6,18,19,14,5,1,IMG_20230512_152305_jpg.rf.12f543505870e65321b9087ee0584124.jpg
4_faster_rcnn,fold_6,2,2,1,1,0,IMG_4025_JPG.rf.8d3de7ea571de848fc149e176c6897c3.jpg
4_faster_rcnn,fold_6,1,1,0,1,0,20230512_151505-0-_jpg.rf.55f9872a1224dfaeaf8fca6da2616e98.jpg
4_faster_rcnn,fold_6,20,7,6,1,-13,IMG_20230512_150212_422_jpg.rf.e76cd69c3a527a0ab898b69fef489876.jpg
4_faster_rcnn,fold_6,6,4,4,0,-2,20230512_150139_jpg.rf.84eb5a1f5ed3efe7d09bc7dd51a476e8.jpg
4_faster_rcnn,fold_6,2,2,1,1,0,20230512_145013_jpg.rf.5b923d696845fee91efca209fb16b8b7.jpg
4_faster_rcnn,fold_6,2,2,2,0,0,20230512_153004_jpg.rf.362642eaeb26a8549f4da1202eebd478.jpg
4_faster_rcnn,fold_6,15,10,10,0,-5,20230512_153313_jpg.rf.77943aee7a7bf04a3db49e3f4dc00814.jpg
4_faster_rcnn,fold_6,1,1,1,0,0,20230512_153355_jpg.rf.8223bc454d4e607609c33d5982f02df2.jpg
4_faster_rcnn,fold_6,11,6,6,0,-5,20230512_151544_jpg.rf.3baf349b8c061da5ae2bbe4333bd3506.jpg
4_faster_rcnn,fold_6,4,3,3,0,-1,IMG_20230512_151443_jpg.rf.72eb3bb7a6af81a16f5db60357cc4e37.jpg
4_faster_rcnn,fold_6,18,16,15,1,-2,IMG_20230512_152317_jpg.rf.7f9c7624fac8ec2441ebdd0d2ba16ec5.jpg
4_faster_rcnn,fold_6,3,3,2,1,0,IMG_20230512_145132_jpg.rf.d215e294ca9ff5ec89558b9b78083b48.jpg
4_faster_rcnn,fold_6,2,2,2,0,0,0230512_145400_jpg.rf.2839dc03d44af92c89a92bc7b644ab85.jpg
4_faster_rcnn,fold_6,1,1,0,1,0,20230512_150224_jpg.rf.f64a4cfe331fa0a225b85de2782b4b40.jpg
4_faster_rcnn,fold_6,1,2,1,1,1,IMG_20230512_151810_jpg.rf.82616c1ceb56e348dbbddc1a08161690.jpg
4_faster_rcnn,fold_6,1,3,1,2,2,20230512_145333_jpg.rf.afbd586b0c1d9f54c3d3ea178568eb9d.jpg
4_faster_rcnn,fold_6,5,4,3,1,-1,230512_150144_jpg.rf.17c847f6562b5ceb1d19a0239be452dc.jpg
4_faster_rcnn,fold_6,5,7,4,3,2,20230512_153523_jpg.rf.94e20d7417dcd4856650e05b3a708e35.jpg
4_faster_rcnn,fold_6,17,15,12,3,-2,IMG_20230512_152414_jpg.rf.2a84950ae556ac2909c0e739dbdb963e.jpg
4_faster_rcnn,fold_6,7,7,7,0,0,IMG_4101_JPG.rf.8c4f8e4e10187eb9df93264151a1ed8d.jpg
4_faster_rcnn,fold_6,4,0,0,0,-4,230512_145050_jpg.rf.c9c628742a57d86b1f31849454a8559b.jpg
4_faster_rcnn,fold_6,2,3,2,1,1,20230512_151702_jpg.rf.0456f0fe756386f89c4b23d655ea901b.jpg
4_faster_rcnn,fold_6,13,9,5,4,-4,20230512_150113_jpg.rf.3a5a13ac96bac5c0e6e2c49bc83c904b.jpg
4_faster_rcnn,fold_6,11,13,8,5,2,20230512_151044_jpg.rf.bd2efab172db3bb0ca6ce2ff37f6a8ca.jpg
4_faster_rcnn,fold_6,3,3,3,0,0,20230512_145339-0-_jpg.rf.fea54fcbceb00e71f078268b9b40d178.jpg
4_faster_rcnn,fold_6,1,0,0,0,-1,20230512_150234_jpg.rf.f07768807cd91c66efa0a831a47227f2.jpg
4_faster_rcnn,fold_6,1,1,1,0,0,20230512_152328_jpg.rf.2ee5fc7202b8e73c23dedf7899bfd23d.jpg
4_faster_rcnn,fold_6,1,1,1,0,0,20230512_150736_jpg.rf.86dffaa733e76af31361da63d1f9c5be.jpg
4_faster_rcnn,fold_6,1,1,1,0,0,IMG_20230512_151152_632_jpg.rf.e78de54f18056ed239e1e53f8b27b606.jpg
4_faster_rcnn,fold_6,1,1,1,0,0,IMG_20230512_145000_jpg.rf.08a86ebaadb5647031d884039f76ad3d.jpg
4_faster_rcnn,fold_6,5,5,4,1,0,MG_20230512_145246_jpg.rf.c35a60cd9e1280159604c5915a9e199e.jpg
4_faster_rcnn,fold_6,1,1,1,0,0,20230512_151222_jpg.rf.77904cc81033fc2ad3a414b07b9c1b2e.jpg
4_faster_rcnn,fold_6,14,15,7,8,1,IMG_20230512_145147_jpg.rf.8cac9a120dccf5b1ce92992c1c714c4d.jpg
4_faster_rcnn,fold_6,18,14,11,3,-4,0201_jpg.rf.517ca1ec56a693f7c628bd07b5acdfc2.jpg
4_faster_rcnn,fold_6,1,1,1,0,0,20230512_151615_jpg.rf.3d0f727d5e2b61ba73995558758dffb3.jpg
4_faster_rcnn,fold_6,6,5,5,0,-1,IMG_4097_JPG.rf.4f85a4c675f81cdca11f141abb8d7c2d.jpg
4_faster_rcnn,fold_6,2,2,2,0,0,20230512_151705-0-_jpg.rf.3ca3d09e046dc693a1fb88dca9ebaa3b.jpg
4_faster_rcnn,fold_6,2,0,0,0,-2,20230512_153408_jpg.rf.b5d7a9cb1b0260613799e2d57092c4ec.jpg
4_faster_rcnn,fold_6,1,2,1,1,1,IMG_20230512_151127_629_jpg.rf.f41df076266191a6a8a7eca7b189e061.jpg
4_faster_rcnn,fold_6,1,1,1,0,0,0028_jpg.rf.2103488effe87e7c2da4cf07f6ed7f75.jpg
4_faster_rcnn,fold_6,4,4,4,0,0,IMG_4054_JPG.rf.c3d803491fea4d419a745a606ab372e6.jpg
4_faster_rcnn,fold_6,6,6,5,1,0,0061_jpg.rf.9c87cf09deaf73a61f5ac233c2bdb702.jpg
4_faster_rcnn,fold_6,1,1,1,0,0,20230512_145032_jpg.rf.a2eb942256aef666c2ddc91b6c22b7a5.jpg
4_faster_rcnn,fold_6,1,2,1,1,1,20230512_145138_jpg.rf.04549600bf4eee12b13c6119d3c35a78.jpg
4_faster_rcnn,fold_6,3,4,3,1,1,20230512_150019_jpg.rf.3831013b1b3289f609c139cb5b3ee2d0.jpg
4_faster_rcnn,fold_6,5,4,3,1,-1,IMG_20230512_151248_jpg.rf.fd83e7f5d0f84675cb06da482f588b3b.jpg
4_faster_rcnn,fold_6,1,1,1,0,0,20230512_150810_jpg.rf.ca47a1fafa212b60e926b93e5eb8674b.jpg
4_faster_rcnn,fold_6,5,4,2,2,-1,20230512_145436_jpg.rf.f86063716cf890f2f2412ed2bc009f84.jpg
4_faster_rcnn,fold_6,12,8,6,2,-4,20230512_150103_jpg.rf.7c63165e8e1129a671cb603fa47109d8.jpg
4_faster_rcnn,fold_6,1,1,1,0,0,0019_jpg.rf.f929e8c0a480b1ec40d48ffa32427490.jpg
4_faster_rcnn,fold_6,15,5,5,0,-10,20230512_151327_jpg.rf.d5fc64b9888dff7235c7da7317d07fc0.jpg
4_faster_rcnn,fold_6,15,12,8,4,-3,20230512_145239_jpg.rf.36d4ca0350293c4011bd19f94bc7867d.jpg
4_faster_rcnn,fold_6,9,8,7,1,-1,IMG_20230512_151048_jpg.rf.c92aa7d50112ca96c1f3bdd418f74d1c.jpg
4_faster_rcnn,fold_6,1,1,1,0,0,IMG_3917_JPG.rf.7696994544924bd6d81ad9d1ace3f843.jpg
4_faster_rcnn,fold_6,5,5,5,0,0,20230512_150057_jpg.rf.8739eeb8744698e06d085991ee1483d5.jpg
4_faster_rcnn,fold_6,7,8,7,1,1,IMG_20230512_151223_jpg.rf.af08f6dc665fcecd42728873d339f65f.jpg
4_faster_rcnn,fold_6,9,9,8,1,0,IMG_20230512_145259_jpg.rf.655fa0eaa10935cb21a8b2452c556c92.jpg
4_faster_rcnn,fold_6,2,2,0,2,0,IMG_20230512_145024_jpg.rf.48184e0191f6dc0deaabedad53f15496.jpg
4_faster_rcnn,fold_6,13,14,11,3,1,IMG_20230512_152228_454_jpg.rf.41bea2902570b7445e0f1ec3abc4a012.jpg
4_faster_rcnn,fold_6,3,1,1,0,-2,230512_150042_jpg.rf.333656aaee32bab812e48513c9f469d1.jpg
4_faster_rcnn,fold_6,2,1,1,0,-1,20230512_145431_jpg.rf.026561e5d2d5a23868267be144014c1a.jpg
4_faster_rcnn,fold_6,2,1,1,0,-1,IMG_4029_JPG.rf.5a655364af1d770d5e464fd022215d30.jpg
4_faster_rcnn,fold_7,12,12,12,0,0,IMG_20230512_152242_316_jpg.rf.640eb728992e501ad35261a525ddcd6f.jpg
4_faster_rcnn,fold_7,21,13,13,0,-8,20230512_153312_jpg.rf.9bc8be12c2f1c3b853b5dd7ce2de2445.jpg
4_faster_rcnn,fold_7,1,1,1,0,0,IMG_4043_JPG.rf.3fd3ae2706b1bd88e07090f3f20fe829.jpg
4_faster_rcnn,fold_7,1,1,1,0,0,20230512_145250_jpg.rf.effdab3112b728049f9a595e68cc1fbe.jpg
4_faster_rcnn,fold_7,2,2,1,1,0,IMG_3845_JPG.rf.99db8c1cc5267eb444c95ebe84cd88ba.jpg
4_faster_rcnn,fold_7,2,2,2,0,0,20230512_151759-0-_jpg.rf.9397d17b6e9b50b8b3327c1f6e7e4e13.jpg
4_faster_rcnn,fold_7,23,22,19,3,-1,20230512_153047_jpg.rf.c2e7222d0e6d439a279014b9de708707.jpg
4_faster_rcnn,fold_7,1,1,1,0,0,IMG_20230512_144936_jpg.rf.02a75ef0c1666837558e6b5e99086463.jpg
4_faster_rcnn,fold_7,4,4,4,0,0,IMG_20230512_145250_052_jpg.rf.22501a15b7ee521908502f0562f1943b.jpg
4_faster_rcnn,fold_7,1,0,0,0,-1,IMG_20230512_151943_jpg.rf.245470432c5353d43170f1aa8d72aa47.jpg
4_faster_rcnn,fold_7,15,14,9,5,-1,20230512_152312_jpg.rf.27e0a448e297ab33c52fb903a0a61757.jpg
4_faster_rcnn,fold_7,22,14,10,4,-8,IMG_20230512_150103_jpg.rf.0a6f19ce6332956f8b29791a9f2bfd27.jpg
4_faster_rcnn,fold_7,18,6,5,1,-12,20230512_150003_jpg.rf.4bee1a84712696acd3c6434f86ac8310.jpg
4_faster_rcnn,fold_7,3,5,3,2,2,20230512_150158_jpg.rf.38b8f697e558e1ec0f9c87c946a7c86d.jpg
4_faster_rcnn,fold_7,3,3,3,0,0,20230512_145319_jpg.rf.cd5fadb6c5fddffa67d73b8b37272f64.jpg
4_faster_rcnn,fold_7,30,12,9,3,-18,20230512_150004_jpg.rf.495dbb753fb5fd527e14101c52213803.jpg
4_faster_rcnn,fold_7,1,1,1,0,0,20230512_151613_jpg.rf.e0b45cee6190ca8866233157c4462548.jpg
4_faster_rcnn,fold_7,0,36,0,36,36,IMG_20230512_150254_jpg.rf.a5c0f01d411bde413dbb553e6557c16f.jpg
4_faster_rcnn,fold_7,2,2,0,2,0,IMG_20230512_145306_094_jpg.rf.09cc5cc7fd6ffa704dffb84466385562.jpg
4_faster_rcnn,fold_7,16,13,13,0,-3,20230512_152241_jpg.rf.9b0739a668aaaecd1a1d3e7bf8b2688f.jpg
4_faster_rcnn,fold_7,1,1,1,0,0,20230512_145417_jpg.rf.db3be61a74c7e02c4d1054b72f46745b.jpg
4_faster_rcnn,fold_7,7,6,6,0,-1,20230512_151546_jpg.rf.650e7a29638d0dabdf27fcfefcab07cb.jpg
4_faster_rcnn,fold_7,3,4,3,1,1,20230512_152322_jpg.rf.53fd89be056ce49374a18ace4aa4f447.jpg
4_faster_rcnn,fold_7,2,2,1,1,0,20230512_150824_jpg.rf.9590430380cde837c5b86f877c2bf080.jpg
4_faster_rcnn,fold_7,1,1,1,0,0,20230512_151604_jpg.rf.39e93e2b60bed55a4fb26d60d17f81ce.jpg
4_faster_rcnn,fold_7,6,7,6,1,1,20230512_152250_jpg.rf.0c23d9c9105722daa1a62bbed8129065.jpg
4_faster_rcnn,fold_7,10,10,7,3,0,20230512_153314_jpg.rf.fdc2e0650616a2e23fae79ddbc6b98bb.jpg
4_faster_rcnn,fold_7,1,1,1,0,0,20230512_151540_jpg.rf.6fc0f7a0e69e619bbef3fea84a825105.jpg
4_faster_rcnn,fold_7,9,8,1,7,-1,IMG_20230512_150115_jpg.rf.93d6ec31991ffdb896e9bf82280f1f99.jpg
4_faster_rcnn,fold_7,19,12,6,6,-7,20230512_150010_jpg.rf.620f860344c0524a1ea0d2095e555387.jpg
4_faster_rcnn,fold_7,1,1,1,0,0,0230512_145318_jpg.rf.98f8a12ed2e48f7e62edcc542f5a7a3b.jpg
4_faster_rcnn,fold_7,9,8,7,1,-1,20230512_151513_jpg.rf.9ba62843997a0b42cb30d66d35cfe761.jpg
4_faster_rcnn,fold_7,2,2,2,0,0,20230512_145051_jpg.rf.603261488d01ac12c49ce95447252a07.jpg
4_faster_rcnn,fold_7,3,3,3,0,0,20230512_151745_jpg.rf.26e57cd112d09282bbedc612b9e3bddc.jpg
4_faster_rcnn,fold_7,29,22,19,3,-7,IMG_20230512_150104_jpg.rf.d5cb8950b8524a6e8b69b37121f816be.jpg
4_faster_rcnn,fold_7,11,11,10,1,0,IMG_20230512_151854_jpg.rf.96120163430ff0d69f2a3b4c65cf13be.jpg
4_faster_rcnn,fold_7,1,1,1,0,0,20230512_151443_jpg.rf.02c0d1f9196b0a7db17357b113fa32ed.jpg
4_faster_rcnn,fold_7,4,5,4,1,1,0059_jpg.rf.9ac56781472ffe9dda122b176baf1512.jpg
4_faster_rcnn,fold_7,8,8,6,2,0,IMG_20230512_145441_jpg.rf.6b7c2d8bfc0ced9198b112d0d6ade7e2.jpg
4_faster_rcnn,fold_7,11,10,7,3,-1,20230512_145235_jpg.rf.7588a0153c1b25a775a82b15cb976f2d.jpg
4_faster_rcnn,fold_7,1,1,1,0,0,IMG_20230512_151147_269_jpg.rf.6170f9ba05705d7d45cbb1c21073f67c.jpg
4_faster_rcnn,fold_7,3,3,2,1,0,20230512_150145_jpg.rf.8935abf1c95d41b2b953913a4d6f31f7.jpg
4_faster_rcnn,fold_7,14,13,11,2,-1,IMG_20230512_152216_096_jpg.rf.adf03897848531ce89d004439a8fa974.jpg
4_faster_rcnn,fold_7,13,13,9,4,0,IMG_20230512_150128_jpg.rf.4b6044488f522150e791a223d8868723.jpg
4_faster_rcnn,fold_7,15,14,11,3,-1,20230512_151529_jpg.rf.13e844f081c4efeefda4af063187f6d3.jpg
4_faster_rcnn,fold_7,1,2,1,1,1,20230512_151036_jpg.rf.f3b838a0faab4c3495dd44281c87539d.jpg
4_faster_rcnn,fold_7,1,2,1,1,1,IMG_20230512_150926_jpg.rf.592b75864e594302b259312be28a0792.jpg
4_faster_rcnn,fold_7,6,3,2,1,-3,IMG_20230512_150317_jpg.rf.ac25b1898213749cb0686c2bc3130301.jpg
4_faster_rcnn,fold_7,4,5,3,2,1,0004_jpg.rf.cad1f4f7c2a5a911d6d1cdfa5f75d055.jpg
4_faster_rcnn,fold_7,6,4,3,1,-2,20230512_150135_jpg.rf.d4fd2dcfb498280a8309f6f9fbf3b816.jpg
4_faster_rcnn,fold_7,11,7,7,0,-4,IMG_20230512_151556_798_jpg.rf.64e451fae797a84c7394203ef45fb0a5.jpg
4_faster_rcnn,fold_7,13,12,8,4,-1,IMG_20230512_152158_858_jpg.rf.1a8b5fd8c9168917604cd153b5720b1d.jpg
4_faster_rcnn,fold_7,37,21,17,4,-16,0512_150144_jpg.rf.eb6f48f566e7b2e533d3c169bb9783b0.jpg
4_faster_rcnn,fold_7,1,1,1,0,0,20230512_151643_jpg.rf.cd8dd51a7f1332798879f4e5d7e928f6.jpg
4_faster_rcnn,fold_7,3,0,0,0,-3,20230512_150301_jpg.rf.9f5a1e2491eb0f23ad2976622defdd66.jpg
4_faster_rcnn,fold_7,1,2,1,1,1,20230512_145434_jpg.rf.c6e724cc40d69fabc8ce6dc7f102385b.jpg
4_faster_rcnn,fold_7,3,3,3,0,0,0230512_145050_jpg.rf.2803b267b643801d5d6b63fa2d927f37.jpg
4_faster_rcnn,fold_7,1,1,1,0,0,IMG_20230512_144948_jpg.rf.982c926a32fe1a245ffd566259fcb9bb.jpg
4_faster_rcnn,fold_7,6,6,5,1,0,20230512_152308_jpg.rf.bfaaf2477f56005e5db4ac2d8a0dd0a7.jpg
4_faster_rcnn,fold_7,1,0,0,0,-1,20230512_144954_jpg.rf.b91c4aef38ae9c4f6e5c0bcc155cdbb9.jpg
4_faster_rcnn,fold_7,2,1,1,0,-1,20230512_145012_jpg.rf.7e7325fc33c5f9d9c92a4f4f8c48bd73.jpg
4_faster_rcnn,fold_7,3,3,3,0,0,20230512_151626_jpg.rf.ce9aac74e8994e1b51e9f517df6a0830.jpg
4_faster_rcnn,fold_7,6,6,5,1,0,IMG_20230512_145241_jpg.rf.298cf145f167e685da520bffba4d53a8.jpg
4_faster_rcnn,fold_7,4,3,3,0,-1,20230512_151307_jpg.rf.21fca3895ba4bf60b18eb9cd32d76ed9.jpg
4_faster_rcnn,fold_7,8,9,3,6,1,20230512_150035_jpg.rf.590e7ece3e6e94d92163049b218f2085.jpg
4_faster_rcnn,fold_7,11,10,7,3,-1,20230512_144943_jpg.rf.6e882f14ce6985046782f1fb925495d2.jpg
4_faster_rcnn,fold_7,1,0,0,0,-1,20230512_151231_jpg.rf.4dc10049f8ecfe04ad41c2d1b1428792.jpg
4_faster_rcnn,fold_7,46,31,22,9,-15,20230512_153213_jpg.rf.9ee2b7f723899fca4419bd4e0c4eec72.jpg
4_faster_rcnn,fold_7,16,13,9,4,-3,IMG_20230512_153426_jpg.rf.13530953faa743fa6763be6d0ab583af.jpg
4_faster_rcnn,fold_7,2,2,2,0,0,20230512_151459_jpg.rf.b5fc6223eb6e9549a2bed14367997348.jpg
4_faster_rcnn,fold_7,5,7,3,4,2,IMG_20230512_145052_jpg.rf.1f1d0e8ea8a62acdeb924c64ae560628.jpg
4_faster_rcnn,fold_7,1,1,0,1,0,20230512_152330_jpg.rf.d9a6f6c4784e57ad912b6182a3fd0211.jpg
4_faster_rcnn,fold_7,1,1,1,0,0,0017_jpg.rf.324871efad4024d500a23b82191808a8.jpg
4_faster_rcnn,fold_7,1,1,1,0,0,IMG_20230512_150908_jpg.rf.753a3cfb7ff38bc8300418f88dbf331c.jpg
4_faster_rcnn,fold_7,2,2,2,0,0,20230512_151703_jpg.rf.2faae265964e4a8dd7c48f882318b9e2.jpg
4_faster_rcnn,fold_7,5,4,4,0,-1,20230512_151812_jpg.rf.4e67fe81dff51295403e0c06c0621c2f.jpg
4_faster_rcnn,fold_7,1,1,1,0,0,20230512_153218_jpg.rf.64a3b9a40868420e3930fa153e76d395.jpg
4_faster_rcnn,fold_7,13,14,12,2,1,20230512_153010_jpg.rf.b8501fc8a709517e34e7cb69002aa015.jpg
4_faster_rcnn,fold_7,17,12,10,2,-5,0038_jpg.rf.3f55cd3c03a14d11b3849a2a910a3773.jpg
4_faster_rcnn,fold_7,1,1,1,0,0,20230512_145247_jpg.rf.9d204b8a475593430db82a060e2456d1.jpg
4_faster_rcnn,fold_7,9,10,9,1,1,20230512_151909_jpg.rf.aead0419a0a121c39fda16a03595ab78.jpg
4_faster_rcnn,fold_7,13,10,9,1,-3,20230512_153312-0-_jpg.rf.8f1668ec1eddb4c37aa8c4c6b04cdd81.jpg
4_faster_rcnn,fold_7,2,2,2,0,0,0002_jpg.rf.11a670be82fdde02b205d9929f761ed7.jpg
4_faster_rcnn,fold_7,17,6,6,0,-11,20230512_150002_jpg.rf.264d90b8bb0bb75c8bbe433b3c221545.jpg
4_faster_rcnn,fold_7,12,11,10,1,-1,20230512_150200_jpg.rf.2582038eca240736fe94eb2ed6cae31e.jpg
4_faster_rcnn,fold_7,7,10,6,4,3,20230512_150042_jpg.rf.613029bfbedc91e536387ccf8df16dd0.jpg
4_faster_rcnn,fold_7,2,2,2,0,0,20230512_152249_jpg.rf.04c1bebce986183bedd854bb677da384.jpg
4_faster_rcnn,fold_7,2,2,2,0,0,20230512_151701_jpg.rf.819108571877bfd9f9063c78d807263f.jpg
4_faster_rcnn,fold_7,13,12,10,2,-1,IMG_20230512_145142_jpg.rf.fb2156626619cc38cf3127f70d63b5f0.jpg
4_faster_rcnn,fold_7,10,10,7,3,0,20230512_145209_jpg.rf.2f0dfe951cb0a7165c942a2117e73f0d.jpg
4_faster_rcnn,fold_7,2,2,1,1,0,20230512_145136_jpg.rf.852bd73d66d536a7a4ffbed448466961.jpg
4_faster_rcnn,fold_7,5,5,5,0,0,IMG_20230512_151217_jpg.rf.04d3195207b1eb7346b1ba52c101a706.jpg
4_faster_rcnn,fold_7,8,7,6,1,-1,20230512_153130_jpg.rf.9b7bb97006640f6490a71f226200a2ca.jpg
4_faster_rcnn,fold_7,2,2,2,0,0,20230512_151638_jpg.rf.a0292d546f8d78bd93a8e0b8e16cdcad.jpg
4_faster_rcnn,fold_7,17,19,13,6,2,20230512_150154_jpg.rf.89a63f38c3d9a5091806e13ec9a0b9d0.jpg
4_faster_rcnn,fold_7,8,6,6,0,-2,20230512_151851-0-_jpg.rf.fb46950ff8ddbfa6d4406784eb5e22b5.jpg
4_faster_rcnn,fold_7,33,21,16,5,-12,IMG_20230512_150352_jpg.rf.c1ca8bf250991c89b762984231b93a22.jpg
4_faster_rcnn,fold_7,9,8,6,2,-1,230512_150136_jpg.rf.1e2f1e90c67eb7b8f01703f120072671.jpg
4_faster_rcnn,fold_7,2,1,1,0,-1,0230512_145303_jpg.rf.48b2ec4c0dbde15f8f5f8b3bd2b59378.jpg
4_faster_rcnn,fold_7,1,1,1,0,0,20230512_151014_jpg.rf.1daaabfd079316b6b36cd3f076521079.jpg
4_faster_rcnn,fold_7,7,5,4,1,-2,20230512_150115_jpg.rf.1e159ea5bb7c2543a1928c133ef9b549.jpg
4_faster_rcnn,fold_7,1,1,1,0,0,20230512_151753_jpg.rf.a14249ba89cecfaa73e632b588efdfd7.jpg
4_faster_rcnn,fold_7,2,3,2,1,1,20230512_151637_jpg.rf.a44f9c09520025824affd7d45589da18.jpg
4_faster_rcnn,fold_7,9,9,9,0,0,20230512_152217_jpg.rf.a958863ea2bb344fee3c8c7b29889838.jpg
4_faster_rcnn,fold_7,2,2,1,1,0,MG_20230512_145032_jpg.rf.043a11012a2a8dcb1cee1fc40482b97d.jpg
4_faster_rcnn,fold_7,6,6,6,0,0,IMG_3831_JPG.rf.5b9e206f11628659b685b91001a564e0.jpg
4_faster_rcnn,fold_7,10,11,9,2,1,IMG_20230512_150826_018_jpg.rf.6cdf008f2fd91c8d5a59ecb707eb0a93.jpg
4_faster_rcnn,fold_7,8,8,8,0,0,IMG_4096_JPG.rf.8be1b70c0cb24617e853855e4e345ebe.jpg
4_faster_rcnn,fold_7,7,5,5,0,-2,0047_jpg.rf.f81c0ac4631d37256a41aa0d36e49744.jpg
4_faster_rcnn,fold_7,8,6,6,0,-2,IMG_20230512_151221_jpg.rf.1eaad9c5a6a8acb495445f202d82d696.jpg
4_faster_rcnn,fold_7,2,2,2,0,0,230512_150056_jpg.rf.63fc419be91fa960c9fdd540582bc424.jpg
4_faster_rcnn,fold_7,1,1,1,0,0,20230512_145435_jpg.rf.0381cab4fa18f72340c2377d16cc9660.jpg
4_faster_rcnn,fold_7,21,2,2,0,-19,IMG_20230512_153447_jpg.rf.f9b2e4987e37b091be6072cae946d663.jpg
4_faster_rcnn,fold_7,14,7,6,1,-7,20230512_150101_jpg.rf.cc96a2d607d78ec899d39fd65e3ffcef.jpg
4_faster_rcnn,fold_7,5,6,3,3,1,0230512_145402_jpg.rf.b34ea25b1c9ac3f7cc8061e80027c857.jpg
4_faster_rcnn,fold_7,11,11,8,3,0,IMG_20230512_145018_jpg.rf.d1613b46f617939d055c5b8c109e9fa3.jpg
4_faster_rcnn,fold_7,3,3,3,0,0,IMG_20230512_145338_jpg.rf.079f726ce175cc710ca12b4c3caa612c.jpg
4_faster_rcnn,fold_7,6,6,5,1,0,20230512_145402_jpg.rf.2adab9c4657dc31e00e7139d61d9500a.jpg
4_faster_rcnn,fold_7,11,12,11,1,1,0046_jpg.rf.e1528b2cf27767ce9998ebd79d287f47.jpg
4_faster_rcnn,fold_7,1,0,0,0,-1,0023_jpg.rf.816619f3269b0637f700332186be4dc7.jpg
4_faster_rcnn,fold_7,5,5,5,0,0,IMG_3994_JPG.rf.3f53434cd9176d3f8187cface46b0ee0.jpg
4_faster_rcnn,fold_7,6,7,5,2,1,20230512_150209_jpg.rf.386fa5331924ef6713a22c58b720e320.jpg
4_faster_rcnn,fold_7,5,4,3,1,-1,230512_150029_jpg.rf.12bae245124889830af4fc74e9e52dc8.jpg
4_faster_rcnn,fold_7,4,6,4,2,2,20230512_152303_jpg.rf.51286f7b0969a38d9408ce913d70bf49.jpg
4_faster_rcnn,fold_7,5,5,5,0,0,20230512_145222_jpg.rf.fd35bc6270e794e1ad0a42037bded3b6.jpg
4_faster_rcnn,fold_7,9,7,7,0,-2,20230512_151906_jpg.rf.898831e6903935bdc29051a4dc1aec5d.jpg
4_faster_rcnn,fold_7,40,22,16,6,-18,IMG_20230512_153257_jpg.rf.d9dc811045c5a29bd9426b22f724b734.jpg
4_faster_rcnn,fold_7,3,3,3,0,0,20230512_151140_jpg.rf.7db6428b7e2bbbef7dd568e63b356863.jpg
4_faster_rcnn,fold_7,1,1,1,0,0,IMG_20230512_153421_jpg.rf.6158f971c571c6c40a9f73c5154fea7e.jpg
4_faster_rcnn,fold_7,3,2,2,0,-1,IMG_3991_JPG.rf.956960577cc9ffaab083d7a4f4c5bd11.jpg
4_faster_rcnn,fold_7,10,9,4,5,-1,20230512_150040_jpg.rf.aa50ac3e2a5a2042940711140afd2b9a.jpg
4_faster_rcnn,fold_7,1,0,0,0,-1,20230512_151227_jpg.rf.27d11f08dc002dbce0c7ab80e18ba38a.jpg
4_faster_rcnn,fold_7,4,5,4,1,1,IMG_20230512_151208_jpg.rf.be5e6b4532e99f11dd349cc77c5094ca.jpg
4_faster_rcnn,fold_7,1,1,1,0,0,IMG_20230512_150835_jpg.rf.5163b3bd6692963a73a0e71f347963cd.jpg
4_faster_rcnn,fold_7,1,1,1,0,0,20230512_153356_jpg.rf.4d48f88351e5397a697a75c05a09f970.jpg
4_faster_rcnn,fold_7,2,5,2,3,3,20230512_151054_jpg.rf.7c0b5c7091bc1f6a8f74bc553c645583.jpg
4_faster_rcnn,fold_7,8,4,4,0,-4,20230512_151856_jpg.rf.e796d63958aed52d331329de4229f784.jpg
4_faster_rcnn,fold_7,42,24,16,8,-18,20230512_150217_jpg.rf.43a34e583d3360fb03c78ebcf6334f2b.jpg
4_faster_rcnn,fold_7,1,0,0,0,-1,20230512_151616_jpg.rf.319cd6543513a0db4c94621f3c78c207.jpg
4_faster_rcnn,fold_7,1,1,1,0,0,20230512_145235_jpg.rf.609ee666fef18c181192a729599f029f.jpg
4_faster_rcnn,fold_7,17,13,9,4,-4,IMG_20230512_150105_jpg.rf.570debb8303e1ced483c9d4a2731ffec.jpg
4_faster_rcnn,fold_7,15,13,12,1,-2,IMG_20230512_153006_493_jpg.rf.8cb0e9085e5e5a8d382f8e2647075293.jpg
4_faster_rcnn,fold_7,1,1,1,0,0,20230512_151335_jpg.rf.28b2031d23e55f8020b7aa20b9efc752.jpg
4_faster_rcnn,fold_7,1,1,1,0,0,IMG_20230512_145233_jpg.rf.d273d9a04013a4fdb680069c5f2e4780.jpg
4_faster_rcnn,fold_7,1,2,1,1,1,IMG_3841_JPG.rf.adc4a928f5d56c89691b1d5525a2cb06.jpg
4_faster_rcnn,fold_7,23,18,10,8,-5,20230512_150127_jpg.rf.f6e969d7228c49f8b298a15c5ea0d88d.jpg
4_faster_rcnn,fold_7,8,6,0,6,-2,20230512_150319_jpg.rf.71d19e64b856b04c9ab111407595de18.jpg
4_faster_rcnn,fold_7,8,8,7,1,0,20230512_151037_jpg.rf.85e4a64b3db494811f84775d729cc9e7.jpg
4_faster_rcnn,fold_7,1,2,1,1,1,IMG_4393_JPG.rf.47566015c2485f15e5114808d8a0d4ed.jpg
4_faster_rcnn,fold_7,2,2,2,0,0,IMG_20230512_151816_jpg.rf.8fba275d23a787980bb56f34532a5efd.jpg
4_faster_rcnn,fold_7,6,7,5,2,1,20230512_151851_jpg.rf.96579435ffaa9d451e63a406f34fab4e.jpg
4_faster_rcnn,fold_7,3,3,3,0,0,IMG_4388_JPG.rf.1ddaadb8d3afe73ea7e33c9a29acec1e.jpg
4_faster_rcnn,fold_7,19,13,10,3,-6,IMG_20230512_150059_992_jpg.rf.b49a36b89c3ed0b8925e2ad7f1b905b9.jpg
4_faster_rcnn,fold_7,13,10,10,0,-3,230512_150153_jpg.rf.fb4c5b04651624464aee8747090f6cee.jpg
4_faster_rcnn,fold_7,9,6,5,1,-3,20230512_150329_jpg.rf.fd5367a6796a2fc3f0181a6e4c4b9513.jpg
4_faster_rcnn,fold_7,1,1,1,0,0,230512_150122_jpg.rf.d2ef84171022dfe6b7f85166ab202b72.jpg
4_faster_rcnn,fold_7,6,5,5,0,-1,IMG_20230512_151041_jpg.rf.eda52b9119a16dac9d1d2632ea4d34bd.jpg
4_faster_rcnn,fold_8,26,23,18,5,-3,20230512_153257_jpg.rf.b0ed75a4fd63f8fa4923e04bdb1c38e2.jpg
4_faster_rcnn,fold_8,7,7,7,0,0,20230512_152257_jpg.rf.25eef75e9cfc61b58dc03da8328d53ad.jpg
4_faster_rcnn,fold_8,9,10,8,2,1,230512_150137_jpg.rf.a07a63205732aea6ea773793a5a4e25c.jpg
4_faster_rcnn,fold_8,2,2,2,0,0,IMG_20230512_145254_jpg.rf.dfd1ca61f82842fe96ba39de8974f5d4.jpg
4_faster_rcnn,fold_8,13,12,9,3,-1,20230512_150244_jpg.rf.1ef934795ff31c5b43b6da861b2ac051.jpg
4_faster_rcnn,fold_8,4,4,2,2,0,IMG_20230512_145320_405_jpg.rf.143f083c59c1dedbd9f3f7f157927edf.jpg
4_faster_rcnn,fold_8,1,2,1,1,1,IMG_4050_JPG.rf.242fde50c6291117b6172ee1dc45f081.jpg
4_faster_rcnn,fold_8,1,1,1,0,0,20230512_145043_jpg.rf.943869aa154c2400192f3cbbf372a136.jpg
4_faster_rcnn,fold_8,1,1,1,0,0,20230512_145034_jpg.rf.1bf97c164c29fec5dca87d03670ab344.jpg
4_faster_rcnn,fold_8,2,2,2,0,0,IMG_4034_JPG.rf.92867b137f89f18d7bfc2034cbb1597f.jpg
4_faster_rcnn,fold_8,11,12,7,5,1,20230512_150131_jpg.rf.b7b4ef28a3d5833ddf815ebcf9a8b336.jpg
4_faster_rcnn,fold_8,1,1,1,0,0,20230512_145223_jpg.rf.e86673dc1e563853935de252c1c2a11e.jpg
4_faster_rcnn,fold_8,2,2,2,0,0,20230512_145313_jpg.rf.a52df235ea36832731aa90971489567a.jpg
4_faster_rcnn,fold_8,1,1,1,0,0,20230512_151654_jpg.rf.1ff5a5051a16402ce45fe6ca565c9239.jpg
4_faster_rcnn,fold_8,2,2,1,1,0,20230512_145135_jpg.rf.4d3af6f64064db39df70b1e3672a3f63.jpg
4_faster_rcnn,fold_8,1,1,0,1,0,IMG_20230512_153408_091_jpg.rf.d4b7f029dd191b0e3fc52b4b39bf8116.jpg
4_faster_rcnn,fold_8,2,1,1,0,-1,20230512_151619_jpg.rf.c7fb218f315f99ea72e78a520cc5dc68.jpg
4_faster_rcnn,fold_8,65,26,17,9,-39,IMG_20230512_153155_jpg.rf.348475844dfbdea71bac7dbce8198f44.jpg
4_faster_rcnn,fold_8,26,18,15,3,-8,IMG_3928_JPG.rf.b59dd1a245d0a61096acf104642a588f.jpg
4_faster_rcnn,fold_8,1,1,1,0,0,0230512_145026_jpg.rf.e1ea5177e0224a86904eddffb8258ab9.jpg
4_faster_rcnn,fold_8,3,3,1,2,0,IMG_3865_JPG.rf.85489cc903cddfc5bd27ee6328f5235e.jpg
4_faster_rcnn,fold_8,17,16,11,5,-1,IMG_20230512_145019_771_jpg.rf.d4b15f5b7869ffc05f7387247c4f82ae.jpg
4_faster_rcnn,fold_8,3,3,2,1,0,IMG_3909_JPG.rf.be7478f841f6abc72fcc654df3e13ada.jpg
4_faster_rcnn,fold_8,7,7,7,0,0,20230512_151849_jpg.rf.52b8fefba379829baeca592f085340cd.jpg
4_faster_rcnn,fold_8,8,9,7,2,1,IMG_20230512_151934_jpg.rf.543796bd925563f125516769b066b214.jpg
4_faster_rcnn,fold_8,2,2,2,0,0,0008_jpg.rf.058dbc5491e7240170841cbeb7cfebca.jpg
4_faster_rcnn,fold_8,2,2,2,0,0,20230512_151804-0-_jpg.rf.da37c80768423b2be325cf7dcf3b8efd.jpg
4_faster_rcnn,fold_8,4,2,2,0,-2,20230512_151138_jpg.rf.bd5d8d04a758d594acc2af15dc942b5f.jpg
4_faster_rcnn,fold_8,13,12,10,2,-1,20230512_152309_jpg.rf.e6272cf81ee3a89c98dea29c7ca87fde.jpg
4_faster_rcnn,fold_8,8,9,5,4,1,20230512_150137_jpg.rf.c6db7854f50b446566afe69c0e3bae6f.jpg
4_faster_rcnn,fold_8,1,2,1,1,1,IMG_3858_JPG.rf.10b8772deec081b08895efdc83efbfcc.jpg
4_faster_rcnn,fold_8,1,1,1,0,0,20230512_151447_jpg.rf.8a684005457ea3cadf9943d40014e87f.jpg
4_faster_rcnn,fold_8,9,7,7,0,-2,IMG_20230512_144959_jpg.rf.8d9a872947615acdbff5cf0776139cb9.jpg
4_faster_rcnn,fold_8,17,4,2,2,-13,20230512_153021_jpg.rf.6b38fba9b80543e229dc93ffb5e19695.jpg
4_faster_rcnn,fold_8,11,11,9,2,0,20230512_151051_jpg.rf.dcb4ee42b399c0d6007719e173f728b6.jpg
4_faster_rcnn,fold_8,10,9,9,0,-1,20230512_151854_jpg.rf.0809016c2e20da637cbac7d27e6fb6c0.jpg
4_faster_rcnn,fold_8,2,3,2,1,1,20230512_145219_jpg.rf.f22be001a717798eb8a2168d0d3421ab.jpg
4_faster_rcnn,fold_8,5,6,5,1,1,230512_150140_jpg.rf.7c74dbb84999f31492125730db986f40.jpg
4_faster_rcnn,fold_8,10,3,3,0,-7,20230512_151021_jpg.rf.de7c03d7cc7906d7c81bff3b479fd9e5.jpg
4_faster_rcnn,fold_8,11,11,7,4,0,20230512_145237_jpg.rf.d8f058e0b402e3d1e808be861e667173.jpg
4_faster_rcnn,fold_8,152,83,63,20,-69,0100_jpg.rf.05cd5bba5e3a338b9bab8b49b2c62230.jpg
4_faster_rcnn,fold_8,2,1,1,0,-1,20230512_151516_jpg.rf.4075925f758530db09c215e48201f510.jpg
4_faster_rcnn,fold_8,4,4,4,0,0,IMG_20230512_151322_jpg.rf.f87bdadf921aef8dde8daecc2efda877.jpg
4_faster_rcnn,fold_8,1,1,1,0,0,20230512_151310_jpg.rf.49e186e145599c0c576f88f77a48645f.jpg
4_faster_rcnn,fold_8,2,2,2,0,0,20230512_151840_jpg.rf.225d382469feb3893ab8adf440f0dcdd.jpg
4_faster_rcnn,fold_8,15,12,10,2,-3,IMG_20230512_150202_jpg.rf.605274560fcfde991ad3e82107d6fd8c.jpg
4_faster_rcnn,fold_8,28,26,19,7,-2,0512_150115_jpg.rf.572fa1a857240740ab2fd9c0bd962a84.jpg
4_faster_rcnn,fold_8,11,12,6,6,1,IMG_20230512_150135_011_jpg.rf.7d2abfcfbd33399d0709cdb1f6848e09.jpg
4_faster_rcnn,fold_8,1,1,1,0,0,20230512_145421_jpg.rf.3704320bbaa6e937ed0261aa404772f1.jpg
4_faster_rcnn,fold_8,14,13,13,0,-1,0042_jpg.rf.7ffcac34c8b8720199d793d39ebf099c.jpg
4_faster_rcnn,fold_8,34,15,10,5,-19,0512_150108_jpg.rf.2a2b0446e2345745280376767e5d1b27.jpg
4_faster_rcnn,fold_8,3,5,4,1,2,IMG_20230512_152407_jpg.rf.987c14f960c413f0e6ece4c99d516916.jpg
4_faster_rcnn,fold_8,7,7,5,2,0,20230512_150116_jpg.rf.4cdde848ca21f7424c94dada8a3603c8.jpg
4_faster_rcnn,fold_8,1,1,1,0,0,20230512_151642_jpg.rf.8d7807db8a2c50e7601e595cb8e4d441.jpg
4_faster_rcnn,fold_8,1,1,1,0,0,IMG_20230512_161346_jpg.rf.f2d66ae86a3dee44e0234f6002702110.jpg
4_faster_rcnn,fold_8,3,3,3,0,0,20230512_151340_jpg.rf.1e7341de1b15f16ffc701c3b53542fe7.jpg
4_faster_rcnn,fold_8,5,5,3,2,0,20230512_145411_jpg.rf.962646db69e6629f3a045dc737b54f0c.jpg
4_faster_rcnn,fold_8,12,11,3,8,-1,20230512_145240_jpg.rf.a5091d10c5393608b704fe2d2a846263.jpg
4_faster_rcnn,fold_8,12,9,9,0,-3,IMG_20230512_152002_jpg.rf.0e50ad947bcac786ec04e7adf1df3e90.jpg
4_faster_rcnn,fold_8,8,8,7,1,0,IMG_4207_JPG.rf.330747e746ba1f08f12c25a697df8506.jpg
4_faster_rcnn,fold_8,24,15,10,5,-9,IMG_20230512_150022_jpg.rf.951e0e5b24bd9b0e9ad93c5f8e19127d.jpg
4_faster_rcnn,fold_8,1,1,1,0,0,20230512_151445_jpg.rf.7d699391bb3084d81ea03299229ab140.jpg
4_faster_rcnn,fold_8,3,2,2,0,-1,IMG_20230512_145332_184_jpg.rf.332c2aa459e521d0576953fca1e0a03f.jpg
4_faster_rcnn,fold_8,3,3,2,1,0,20230512_145052_jpg.rf.e4d9741a91ef6c0f9f053feb1ffe1df5.jpg
4_faster_rcnn,fold_8,12,12,10,2,0,0032_jpg.rf.bbf27b122201c3fdb2fa22a360b64846.jpg
4_faster_rcnn,fold_8,4,4,3,1,0,20230512_151300_jpg.rf.f994d9472b1ee1ddd3ac8ab3a3cc2a12.jpg
4_faster_rcnn,fold_8,7,3,1,2,-4,20230512_150036_jpg.rf.409641b85ef17642977736d9dc873ae4.jpg
4_faster_rcnn,fold_8,1,0,0,0,-1,IMG_20230512_144910_997_jpg.rf.93aca80524806445b3dfb1818fa4806a.jpg
4_faster_rcnn,fold_8,7,7,6,1,0,IMG_20230512_152357_jpg.rf.77160d5f48db0fa53a72198288557af6.jpg
4_faster_rcnn,fold_8,7,8,6,2,1,20230512_145341_jpg.rf.85ffc7a18e0ad722dbf476743313df02.jpg
4_faster_rcnn,fold_8,16,15,14,1,-1,IMG_20230512_151902_jpg.rf.86d659e2d2eb4651a989633ff7c3cb87.jpg
4_faster_rcnn,fold_8,17,14,12,2,-3,230512_150202_jpg.rf.ea33cf5fe5f6662c3682e389e8685dfb.jpg
4_faster_rcnn,fold_8,12,14,11,3,2,0048_jpg.rf.ec48089b3f18d5818c04f71cecd05f38.jpg
4_faster_rcnn,fold_8,2,4,2,2,2,IMG_4091_JPG.rf.a9405bd034e33eacf6b2883c9ed04e2e.jpg
4_faster_rcnn,fold_8,13,10,8,2,-3,IMG_20230512_150158_jpg.rf.c8fd099b0d72b4e29fc1807382e042b1.jpg
4_faster_rcnn,fold_8,2,2,2,0,0,20230512_144932_jpg.rf.a725c2a7e9c0d34d34a6abd7d299f6df.jpg
4_faster_rcnn,fold_8,16,12,11,1,-4,20230512_151039_jpg.rf.bb11ca2d78a6f005bcb2f521dfcf0dce.jpg
4_faster_rcnn,fold_8,5,4,4,0,-1,20230512_152301_jpg.rf.3701d53ed7c06271583a063371e238d1.jpg
4_faster_rcnn,fold_8,7,5,3,2,-2,IMG_20230512_145108_jpg.rf.5b77832e2c70819f5a5de9e318768425.jpg
4_faster_rcnn,fold_8,3,3,2,1,0,IMG_3849_JPG.rf.7ce1df74f4ca793d89d2042ccc5766ef.jpg
4_faster_rcnn,fold_8,10,10,5,5,0,20230512_145206_jpg.rf.4cf9a1bcd726515460c68ec0b753f06a.jpg
4_faster_rcnn,fold_8,21,17,13,4,-4,IMG_20230512_150057_jpg.rf.1d901fec112c2705325b5b23647b5cfe.jpg
4_faster_rcnn,fold_8,5,5,5,0,0,20230512_151846_jpg.rf.aaa6e44ba0c35df5988efcf5a4f2510c.jpg
4_faster_rcnn,fold_8,22,17,12,5,-5,IMG_20230512_153211_jpg.rf.8b8c95e482643af377a9a4d7a0182777.jpg
4_faster_rcnn,fold_8,3,3,3,0,0,0230512_145440_jpg.rf.26be693a65087ccb13d4129f4c93b786.jpg
4_faster_rcnn,fold_8,9,5,0,5,-4,IMG_3931_JPG.rf.fcba871e1d94de33741779717c57137f.jpg
4_faster_rcnn,fold_8,1,1,1,0,0,20230512_145025_jpg.rf.15940c55814fd494ff830db5a9061d30.jpg
4_faster_rcnn,fold_8,1,1,1,0,0,IMG_20230512_145352_jpg.rf.1c96dea3488a61099952ab7250fce4b2.jpg
4_faster_rcnn,fold_8,3,3,2,1,0,20230512_145231_jpg.rf.77f03cc3c54cff48c03e24558d36189b.jpg
4_faster_rcnn,fold_8,16,12,10,2,-4,IMG_20230512_151508_jpg.rf.c78520025916588a7657b75ae388cb8f.jpg
4_faster_rcnn,fold_8,12,16,8,8,4,IMG_20230512_145022_866_jpg.rf.245d67f93e45a020eb21fdd8f4124767.jpg
4_faster_rcnn,fold_8,4,4,2,2,0,20230512_145329_jpg.rf.0c0d42d6e893d6efcd4b3119ce990d0e.jpg
4_faster_rcnn,fold_8,2,2,2,0,0,20230512_145433_jpg.rf.5924d4f1a47105e53efa0a08085450a7.jpg
4_faster_rcnn,fold_8,3,3,3,0,0,IMG_20230512_152405_jpg.rf.ebe5f63b7b940c8d9a74c8fb5839d39b.jpg
4_faster_rcnn,fold_8,6,8,5,3,2,20230512_150204_jpg.rf.87f7c1141bc54dad9c82b36c8beb1bb9.jpg
4_faster_rcnn,fold_8,1,1,0,1,0,230512_150118_jpg.rf.ecc50b57dabc83b04e792a7ddde388f8.jpg
4_faster_rcnn,fold_8,2,1,1,0,-1,20230512_150052_jpg.rf.9bdf107fc37c37b05aa46914e8882f17.jpg
4_faster_rcnn,fold_8,5,1,0,1,-4,20230512_151135_jpg.rf.3b3e99725d0ae8b34747d0ed51687a4a.jpg
4_faster_rcnn,fold_8,2,1,0,1,-1,230512_145056_jpg.rf.cb3d61bce2d4e0686bc0310ab76413a2.jpg
4_faster_rcnn,fold_8,25,15,13,2,-10,IMG_20230512_150208_jpg.rf.14a0d0d16b6d32327bcec6959b738634.jpg
4_faster_rcnn,fold_8,30,18,15,3,-12,IMG_20230512_150210_524_jpg.rf.476d8805b0160b5143ad37609399dc72.jpg
4_faster_rcnn,fold_8,1,1,1,0,0,20230512_151455_jpg.rf.ea02e305291eae5ae85ae54d0ebfe26d.jpg
4_faster_rcnn,fold_8,19,12,6,6,-7,IMG_20230512_150024_jpg.rf.5425ded2475701fa14408062843212ec.jpg
4_faster_rcnn,fold_8,10,10,9,1,0,20230512_153132_jpg.rf.cac6aa1f1a0f028046df980276b5e4e6.jpg
4_faster_rcnn,fold_8,1,1,0,1,0,MG_20230512_145316_jpg.rf.4d66c8eb78cdd81e04686ee0f7aa4fdf.jpg
4_faster_rcnn,fold_8,12,16,13,3,4,20230512_152311_jpg.rf.7f2da0009f2fa07600b981c50d8d6ebf.jpg
4_faster_rcnn,fold_8,1,1,1,0,0,20230512_145036_jpg.rf.1ecc4ae3f81e22aac59d8b3b9c1034cd.jpg
4_faster_rcnn,fold_8,1,1,1,0,0,IMG_4390_JPG.rf.2018de24c221ce01e2c3239735a272af.jpg
4_faster_rcnn,fold_8,14,12,9,3,-2,IMG_20230512_145158_jpg.rf.6d28bd6cb232ef60feeaaa2d893d7326.jpg
4_faster_rcnn,fold_8,4,7,3,4,3,IMG_20230512_150225_jpg.rf.5e6e4781174588e28c95f110bb49edf2.jpg
4_faster_rcnn,fold_8,17,12,11,1,-5,20230512_151035_jpg.rf.7593703cffcf4a6285b53ddb6e104d39.jpg
4_faster_rcnn,fold_8,5,5,5,0,0,_20230512_150252_jpg.rf.c7786b04a48eca5fec5127b90d27efc6.jpg
4_faster_rcnn,fold_8,10,10,9,1,0,IMG_20230512_161908_jpg.rf.c3138f9567f619fcdc8eb8c700bfcff8.jpg
4_faster_rcnn,fold_8,8,9,5,4,1,20230512_150001_jpg.rf.74ea9697c92aedc234993b5551f7f1b4.jpg
4_faster_rcnn,fold_8,5,7,5,2,2,IMG_20230512_151249_373_jpg.rf.f2dd29bba78783f6fbe29e66675bd321.jpg
4_faster_rcnn,fold_8,3,2,2,0,-1,IMG_20230512_151542_635_jpg.rf.1e2c1e872c81db1f473f8c586f3ce9d9.jpg
4_faster_rcnn,fold_8,3,1,1,0,-2,20230512_151619-0-_jpg.rf.5d6f8d7a8176754cc78ef08a707b7ea8.jpg
4_faster_rcnn,fold_8,8,7,6,1,-1,IMG_20230512_145253_jpg.rf.7d0a492e681439db3a20eb64e356d8ff.jpg
4_faster_rcnn,fold_8,2,2,2,0,0,20230512_151636_jpg.rf.0e80ecb006eb88d60de9b99c0fac2245.jpg
4_faster_rcnn,fold_8,11,10,7,3,-1,IMG_3926_JPG.rf.769c3267365e5531dec34c648a73f597.jpg
4_faster_rcnn,fold_8,13,12,10,2,-1,IMG_20230512_145120_jpg.rf.3ecb5837a329b79ac20997cfe24d3124.jpg
4_faster_rcnn,fold_8,3,3,2,1,0,230512_150054_jpg.rf.ec6dcd9709fc100d27b3f2f4937b7712.jpg
4_faster_rcnn,fold_8,7,6,5,1,-1,IMG_20230512_150945_jpg.rf.26027cad843e4a3c904d281bd5e443ab.jpg
4_faster_rcnn,fold_8,2,3,2,1,1,20230512_151755_jpg.rf.f2aa85c403e0f77cda500046a0fd667f.jpg
4_faster_rcnn,fold_8,7,8,7,1,1,20230512_152237_jpg.rf.dceb042d25e3e44ad022b7c4330f1dcf.jpg
4_faster_rcnn,fold_8,19,20,18,2,1,20230512_153013_jpg.rf.ebf5724207d5fe9aba867759ed6ae350.jpg
4_faster_rcnn,fold_8,3,3,3,0,0,230512_150143_jpg.rf.b686af9ba8be8219e2e0a152ff0123f1.jpg
4_faster_rcnn,fold_8,1,1,1,0,0,IMG_20230512_151231_jpg.rf.f19d35ba554c9c3e62efe863fb1dd098.jpg
4_faster_rcnn,fold_8,1,2,1,1,1,20230512_151451-0-_jpg.rf.352f3ab1f1271f1dc2c7503413d5072b.jpg
4_faster_rcnn,fold_8,13,7,7,0,-6,IMG_20230512_151640_056_jpg.rf.69bbb5903a2369e6d01c4fd2bef65e1f.jpg
4_faster_rcnn,fold_8,5,4,3,1,-1,230512_150033_jpg.rf.ceea84e0a6184331d2af5a24cba9a7d0.jpg
4_faster_rcnn,fold_8,11,11,11,0,0,0053_jpg.rf.09112cd43c7e1f0da4351e79ab49af2f.jpg
4_faster_rcnn,fold_8,12,10,10,0,-2,IMG_20230512_151339_jpg.rf.13ce8b9b66953b0f57413fa693a3dc35.jpg
4_faster_rcnn,fold_8,2,3,2,1,1,IMG_20230512_151240_565_jpg.rf.fdf2f78ec041a34d2611406b29953d18.jpg
4_faster_rcnn,fold_8,23,22,19,3,-1,IMG_20230512_150201_jpg.rf.81da174bcf14fd53b844cf7cae9f7a28.jpg
4_faster_rcnn,fold_8,27,20,7,13,-7,20230512_153207_jpg.rf.81b28e88b96ae01a62cb2b2cdc468e08.jpg
4_faster_rcnn,fold_8,3,4,4,0,1,20230512_151625_jpg.rf.6d8f8d5fffad59d6ccff118606bdd771.jpg
4_faster_rcnn,fold_8,8,6,6,0,-2,IMG_20230512_145440_jpg.rf.4fae61f59dfa2249c388f714b68ca784.jpg
4_faster_rcnn,fold_8,2,2,1,1,0,IMG_4191_JPG.rf.f40d8980877c6222a068ed1ef1102afa.jpg
4_faster_rcnn,fold_8,1,0,0,0,-1,20230512_153345_jpg.rf.7d2374802dfa67e187bded47020403c1.jpg
4_faster_rcnn,fold_8,1,1,1,0,0,20230512_150733_jpg.rf.dfdc2eb0d94519616a7ec9cf127c8f8a.jpg
4_faster_rcnn,fold_8,1,1,1,0,0,IMG_4028_JPG.rf.c7571b8910b4228b0179b0ffc703ee1e.jpg
4_faster_rcnn,fold_8,9,8,6,2,-1,0230512_150115_jpg.rf.50a5de1d8e046395fd6c82509eb7d363.jpg
4_faster_rcnn,fold_8,2,1,1,0,-1,20230512_145355_jpg.rf.67799c9783b1beeb42aebdae40eac27d.jpg
4_faster_rcnn,fold_8,9,6,6,0,-3,IMG_3989_JPG.rf.51b8252c5f0a8196d379e91fcc91ad06.jpg
4_faster_rcnn,fold_8,1,1,1,0,0,20230512_145111_jpg.rf.ab829e89e439dc4aa65d413090f00b2d.jpg
4_faster_rcnn,fold_8,5,4,4,0,-1,20230512_152259_jpg.rf.fef7e558f14c303ecfa184eb656375ce.jpg
4_faster_rcnn,fold_8,1,1,1,0,0,IMG_20230512_151033_jpg.rf.4872ff92d415a45e16c1f52f8b7ae6db.jpg
4_faster_rcnn,fold_8,32,26,23,3,-6,IMG_20230512_153350_jpg.rf.cc68f1c6759992fe198286f32b0171ec.jpg
4_faster_rcnn,fold_8,2,2,1,1,0,20230512_151506_jpg.rf.2d22a2b23e3853093943da42a80fc17b.jpg
4_faster_rcnn,fold_8,1,1,1,0,0,IMG_4015_JPG.rf.8f40d2d78e19693b5d38d76ffd50d286.jpg
4_faster_rcnn,fold_8,10,10,10,0,0,20230512_152217_jpg.rf.a3962f3838250709a368b8f241c7bcad.jpg
4_faster_rcnn,fold_8,3,2,2,0,-1,230512_150048_jpg.rf.2a601f5dc5ab605aa2563bcbc35c41e1.jpg
4_faster_rcnn,fold_8,14,14,13,1,0,IMG_20230512_152954_jpg.rf.6f297f29021342f064430fb1e8d22587.jpg
4_faster_rcnn,fold_8,2,2,2,0,0,IMG_4053_JPG.rf.307ece37dd62cbaea82bfd7b14f0ee36.jpg
4_faster_rcnn,fold_8,17,16,16,0,-1,20230512_152942_jpg.rf.cc3d43f0d1f322fa8da500d78ce3a8be.jpg
4_faster_rcnn,fold_8,3,5,3,2,2,IMG_20230512_151637_jpg.rf.e79b46fd14d5a0af0846c34d1a920413.jpg
4_faster_rcnn,fold_9,7,6,4,2,-1,20230512_152158_jpg.rf.02f9c3c00108d9da3f80f2943458d80a.jpg
4_faster_rcnn,fold_9,4,4,4,0,0,IMG_20230512_145312_784_jpg.rf.58023d0721ac49469db4e79c05fb5cba.jpg
4_faster_rcnn,fold_9,25,18,17,1,-7,20230512_150144_jpg.rf.ecf1f47bccdedeca682aab00e68f4fbf.jpg
4_faster_rcnn,fold_9,4,4,3,1,0,20230512_145408-0-_jpg.rf.7d30c64c68760c899eab7f27576adaec.jpg
4_faster_rcnn,fold_9,17,13,10,3,-4,IMG_20230512_153014_136_jpg.rf.ac9f2fc67a44db81aef730e99a1dba0a.jpg
4_faster_rcnn,fold_9,20,13,10,3,-7,20230512_153043_jpg.rf.5cddf43df464d99390a41596bf2ccdf2.jpg
4_faster_rcnn,fold_9,8,6,6,0,-2,20230512_153242_jpg.rf.5d53d7e395b76d25f2510396dec3f47a.jpg
4_faster_rcnn,fold_9,7,5,5,0,-2,20230512_151538_jpg.rf.d5df90d6db920f66f1d45e4cfa70a411.jpg
4_faster_rcnn,fold_9,5,4,4,0,-1,0050_jpg.rf.47c1ed097ad14e52c46f19b2b3e3f5a2.jpg
4_faster_rcnn,fold_9,3,9,1,8,6,20230512_150109_jpg.rf.4d2c542089703d638847cefe3c0e0669.jpg
4_faster_rcnn,fold_9,12,9,7,2,-3,IMG_20230512_151658_955_jpg.rf.6f77aded32a46d8083d7d4e54c112bb9.jpg
4_faster_rcnn,fold_9,5,5,5,0,0,IMG_20230512_145258_492_jpg.rf.3ae44ee592a82ee046166d1017a1f348.jpg
4_faster_rcnn,fold_9,3,3,3,0,0,IMG_20230512_152403_jpg.rf.708a0e8a856b9c4ca92a84e1450a3e60.jpg
4_faster_rcnn,fold_9,7,5,5,0,-2,20230512_151548_jpg.rf.de9bfd82e4ede57511bc911fc34f5695.jpg
4_faster_rcnn,fold_9,1,1,1,0,0,IMG_20230512_151202_728_jpg.rf.1d8a1071a58b84a0628884454a63ef8a.jpg
4_faster_rcnn,fold_9,11,11,10,1,0,20230512_152251_jpg.rf.f4cd881ef463deae8c6458635e8849ac.jpg
4_faster_rcnn,fold_9,4,4,3,1,0,IMG_3835_JPG.rf.e405f9fb7ccfe92ed96a553465aa1ec9.jpg
4_faster_rcnn,fold_9,18,17,12,5,-1,20230512_144934_jpg.rf.03898f9c31f25d3ec984bc32b412d5af.jpg
4_faster_rcnn,fold_9,4,2,2,0,-2,IMG_3867_JPG.rf.ec5d38e5d6681088aaa0d2786eb3bb2b.jpg
4_faster_rcnn,fold_9,13,7,6,1,-6,IMG_20230512_152345_469_jpg.rf.3dde8c68a98233421212da59bcbe366e.jpg
4_faster_rcnn,fold_9,19,17,15,2,-2,IMG_20230512_152322_jpg.rf.190afc8c001b1a757ff0cc847eea784d.jpg
4_faster_rcnn,fold_9,15,14,8,6,-1,0230512_145001_jpg.rf.da230b3dcac925c28f8c0273b5776c9a.jpg
4_faster_rcnn,fold_9,8,9,8,1,1,20230512_151900_jpg.rf.1250b5103b69822786ae601e0a5c5f68.jpg
4_faster_rcnn,fold_9,3,3,2,1,0,IMG_20230512_145043_jpg.rf.3d90edfd5a365d1ec3876fca50ab884d.jpg
4_faster_rcnn,fold_9,2,2,2,0,0,IMG_20230512_145345_250_jpg.rf.15fc60af583ce168515577f073866f5f.jpg
4_faster_rcnn,fold_9,14,10,10,0,-4,20230512_152217_jpg.rf.2fdd5053b538b85b1941d0bb5e4261ca.jpg
4_faster_rcnn,fold_9,5,3,0,3,-2,230512_150109_jpg.rf.fe44d8827f0b8ae246022ca47b5c4c2c.jpg
4_faster_rcnn,fold_9,9,11,9,2,2,20230512_152318_jpg.rf.15ef28475daedc6fc4e098af4a1459e5.jpg
4_faster_rcnn,fold_9,11,8,8,0,-3,IMG_20230512_151554_209_jpg.rf.f15eb1b2793910f53035e241375725c8.jpg
4_faster_rcnn,fold_9,1,1,1,0,0,20230512_151039_jpg.rf.12dc8e8ab83bd9d6e1e941c7a0c05874.jpg
4_faster_rcnn,fold_9,1,2,1,1,1,IMG_3908_JPG.rf.04ee0448a5e502f1d8c821cea701a7e1.jpg
4_faster_rcnn,fold_9,2,2,2,0,0,20230512_150227_jpg.rf.4d20daf17aea8771758821741496ecfd.jpg
4_faster_rcnn,fold_9,1,1,1,0,0,20230512_153412_jpg.rf.86821476b6a03cfd46882b168695fa0b.jpg
4_faster_rcnn,fold_9,11,5,4,1,-6,20230512_153437_jpg.rf.be3d60256eef37a332523d849f2754c6.jpg
4_faster_rcnn,fold_9,1,0,0,0,-1,20230512_150221_jpg.rf.16f1f40fdbd20de3345eed95661a9875.jpg
4_faster_rcnn,fold_9,6,5,5,0,-1,20230512_145324_jpg.rf.20601749525cadde15c78b46cd0fd934.jpg
4_faster_rcnn,fold_9,11,5,5,0,-6,IMG_20230512_151501_jpg.rf.050803adc8687422b6d0ca0c55649365.jpg
4_faster_rcnn,fold_9,8,9,8,1,1,0041_jpg.rf.dc9ba1dc663668cabb27474922349a17.jpg
4_faster_rcnn,fold_9,8,10,6,4,2,20230512_145208_jpg.rf.b8ad2aec57651698bef6edfad1ced014.jpg
4_faster_rcnn,fold_9,1,1,1,0,0,20230512_151617_jpg.rf.f876cceb3568353e640a6506b3aa8b6a.jpg
4_faster_rcnn,fold_9,16,11,11,0,-5,0043_jpg.rf.af436235ce1f5e4c84b661d4b30ac97f.jpg
4_faster_rcnn,fold_9,6,6,5,1,0,IMG_4102_JPG.rf.988b30b26acf51017cd5b3ff16762a2b.jpg
4_faster_rcnn,fold_9,5,5,4,1,0,IMG_20230512_145425_638_jpg.rf.661f8dc69f407743144410705f4450c9.jpg
4_faster_rcnn,fold_9,14,12,8,4,-2,20230512_151015_jpg.rf.3c8da9af03482ee1020db88de8cd53f5.jpg
4_faster_rcnn,fold_9,6,6,5,1,0,20230512_151814_jpg.rf.63e5823ef6a38da9206064b1975681af.jpg
4_faster_rcnn,fold_9,6,4,4,0,-2,20230512_151556_jpg.rf.e585c8603435630ba81c916c0f5e3ad0.jpg
4_faster_rcnn,fold_9,7,8,6,2,1,20230512_150112_jpg.rf.91cd81f1887a38818d08e2f659a19d98.jpg
4_faster_rcnn,fold_9,6,7,5,2,1,20230512_144948_jpg.rf.f0802f30adda8942f990e793b5836607.jpg
4_faster_rcnn,fold_9,1,1,1,0,0,20230512_145029_jpg.rf.d7839e9fea72e8e69ba8fd36d0e4fb46.jpg
4_faster_rcnn,fold_9,18,17,15,2,-1,IMG_3904_JPG.rf.bd3a38163bc8779f0e934e0ae4ddadcf.jpg
4_faster_rcnn,fold_9,1,2,1,1,1,IMG_20230512_153207_221_jpg.rf.1f2a32c755bbb2f6a4de873cb32a38fd.jpg
4_faster_rcnn,fold_9,6,5,3,2,-1,IMG_20230512_150226_jpg.rf.0f75578652c746be4186e389de366a0e.jpg
4_faster_rcnn,fold_9,2,1,0,1,-1,IMG_3906_JPG.rf.489fadb71a83983d81ed44a70d0060f4.jpg
4_faster_rcnn,fold_9,7,7,5,2,0,20230512_150041_jpg.rf.77c6bf2c7e0b5d7af7cc6bad355e9df1.jpg
4_faster_rcnn,fold_9,1,1,1,0,0,0230512_145030_jpg.rf.6c6efdb679aaba04919e4f2fbe75cc41.jpg
4_faster_rcnn,fold_9,5,1,1,0,-4,230512_150321_jpg.rf.623a3367577becef7953f663a60a519b.jpg
4_faster_rcnn,fold_9,5,2,0,2,-3,MG_20230512_145134_jpg.rf.23612ad15c705c682dff7447cb294722.jpg
4_faster_rcnn,fold_9,27,8,3,5,-19,20230512_153521_jpg.rf.91f440ee7bd1d39009cef4ad201c6fc3.jpg
4_faster_rcnn,fold_9,0,9,0,9,9,IMG_4213_JPG.rf.778fa8d9b6925e2bc9f653dd198513f2.jpg
4_faster_rcnn,fold_9,6,6,6,0,0,20230512_152211_jpg.rf.f8ab5359b2be0312cf7788fc199a7cfb.jpg
4_faster_rcnn,fold_9,3,1,1,0,-2,20230512_151750_jpg.rf.d25aa4eadcd0f88bad307f1be9834da7.jpg
4_faster_rcnn,fold_9,14,14,7,7,0,IMG_20230512_145200_jpg.rf.071fa9592bc47982ce5ace6be3fc1cac.jpg
4_faster_rcnn,fold_9,11,8,5,3,-3,20230512_150021_jpg.rf.e7014c35e8c40fcb7fa7884ea70952ae.jpg
4_faster_rcnn,fold_9,15,13,6,7,-2,IMG_20230512_150047_070_jpg.rf.473b1fece6373583075f5a81e7cd25b1.jpg
4_faster_rcnn,fold_9,12,13,12,1,1,IMG_20230512_152350_jpg.rf.e5327c93655bbe8c35427b0ce8c7c897.jpg
4_faster_rcnn,fold_9,7,7,6,1,0,20230512_153033_jpg.rf.02462baf8941d1800bd6cd7071ac2700.jpg
4_faster_rcnn,fold_9,5,4,3,1,-1,20230512_145350_jpg.rf.1ea30b4048e0f19948f3a1c49f936262.jpg
4_faster_rcnn,fold_9,20,18,13,5,-2,20230512_153245_jpg.rf.9c9fb8ddd3ba260eca53499188a58fd5.jpg
4_faster_rcnn,fold_9,2,1,1,0,-1,20230512_151451_jpg.rf.0a8434d6a9efa22ee048c8273b62b68d.jpg
4_faster_rcnn,fold_9,5,4,2,2,-1,20230512_151436_jpg.rf.554d34d9ea0ee09cf2c15f0b2df8ebb2.jpg
4_faster_rcnn,fold_9,6,7,5,2,1,IMG_3910_JPG.rf.33d9bdf28a4dfeab746c5a00ebede622.jpg
4_faster_rcnn,fold_9,1,1,1,0,0,20230512_145422_jpg.rf.855806965c417ddd5e1b836f01dc61f4.jpg
4_faster_rcnn,fold_9,18,18,15,3,0,IMG_4182_JPG.rf.9c42af3692f7bbaef5a89c980112be66.jpg
4_faster_rcnn,fold_9,2,1,1,0,-1,20230512_151553_jpg.rf.eb27fb285f9f9e115b16ae58308b4a33.jpg
4_faster_rcnn,fold_9,1,1,1,0,0,IMG_20230512_151942_jpg.rf.44e3a3ca4b79e01e3532e938c985d467.jpg
4_faster_rcnn,fold_9,1,0,0,0,-1,20230512_145026_jpg.rf.dbca47de186a8c26308fd5d82af2ccef.jpg
4_faster_rcnn,fold_9,8,4,3,1,-4,IMG_20230512_151456_jpg.rf.85840748681315fe5ab4e0d0318d07ef.jpg
4_faster_rcnn,fold_9,5,4,3,1,-1,20230512_145129_jpg.rf.5f78acb483122a7da1a71444f23c5e85.jpg
4_faster_rcnn,fold_9,3,3,3,0,0,IMG_4049_JPG.rf.69a02eacb4e8dea786daf7ac53eff115.jpg
4_faster_rcnn,fold_9,3,3,2,1,0,20230512_151128_jpg.rf.a8a2c544627fbc40d82ac1408de83acf.jpg
4_faster_rcnn,fold_9,1,1,1,0,0,0022_jpg.rf.392b7e000cd5e1b178fd42a324c62fa9.jpg
4_faster_rcnn,fold_9,17,15,12,3,-2,IMG_4214_JPG.rf.342cb36b8889ed055af6630becc0a92b.jpg
4_faster_rcnn,fold_9,4,3,3,0,-1,IMG_3992_JPG.rf.7e1e103b7399a2f459d53d6a310a7ee0.jpg
4_faster_rcnn,fold_9,23,25,23,2,2,IMG_20230512_152955_591_jpg.rf.0aef108570178c062fc410980092f3ee.jpg
4_faster_rcnn,fold_9,32,21,17,4,-11,IMG_20230512_150325_jpg.rf.9a0b14f916539972a32ed40c795a77e2.jpg
4_faster_rcnn,fold_9,2,2,1,1,0,20230512_150043_jpg.rf.c937683d3c7cefe87855391dceb56509.jpg
4_faster_rcnn,fold_9,3,4,3,1,1,IMG_4038_JPG.rf.53f27c280fb9536f67b0f3bce749cded.jpg
4_faster_rcnn,fold_9,1,1,1,0,0,IMG_4218_JPG.rf.776b234254cad41083ae7a7013512ded.jpg
4_faster_rcnn,fold_9,3,4,3,1,1,20230512_152323_jpg.rf.f87e4ec47644402832bf9ed280233bd6.jpg
4_faster_rcnn,fold_9,5,4,4,0,-1,20230512_151434_jpg.rf.6e770d46c3e9773c996335b4220cab85.jpg
4_faster_rcnn,fold_9,10,10,7,3,0,0230512_145012_jpg.rf.0f087c91d690727635837b56dc1725f3.jpg
4_faster_rcnn,fold_9,1,0,0,0,-1,20230512_151257_jpg.rf.0a6cd5b01b2f5eb142626849e1aa59dd.jpg
4_faster_rcnn,fold_9,5,5,5,0,0,IMG_20230512_151930_jpg.rf.b1cb9853e8645a3ba38d93ab637f6627.jpg
4_faster_rcnn,fold_9,14,11,10,1,-3,20230512_151038-0-_jpg.rf.b58c6345da65332e25d3fdda064694ee.jpg
4_faster_rcnn,fold_9,1,1,1,0,0,20230512_145221_jpg.rf.29bff38b4873d27c522654186744b290.jpg
4_faster_rcnn,fold_9,15,14,14,0,-1,IMG_20230512_152316_jpg.rf.7f4d2253d0ea3147244a7a36b4392e3c.jpg
4_faster_rcnn,fold_9,1,1,1,0,0,20230512_145046_jpg.rf.43cb9d49dc86e3ae870df966e6b2b7b1.jpg
4_faster_rcnn,fold_9,6,4,4,0,-2,IMG_20230512_151246_jpg.rf.0cb0203d04b163b091b29c2f755a7f65.jpg
4_faster_rcnn,fold_9,8,8,8,0,0,20230512_150900_jpg.rf.7c05ba2842680f1a240b6f0a28f08dad.jpg
4_faster_rcnn,fold_9,1,1,1,0,0,20230512_151614_jpg.rf.ceb493d7d9f840a198a0413f2b423ce2.jpg
4_faster_rcnn,fold_9,1,1,1,0,0,IMG_20230512_151807_jpg.rf.c8207f2bdebe5ee316d9b9a0529d1efe.jpg
4_faster_rcnn,fold_9,3,3,3,0,0,20230512_153403_jpg.rf.90c6c42ac826af51ce764bcff3b6923f.jpg
4_faster_rcnn,fold_9,4,2,1,1,-2,IMG_20230512_145038_jpg.rf.3da21846aa05a88c16affc46ab268cfc.jpg
4_faster_rcnn,fold_9,12,10,9,1,-2,IMG_20230512_151433_jpg.rf.d9b4366826ebd2bd7917e1cb46c50ed4.jpg
4_faster_rcnn,fold_9,4,6,4,2,2,20230512_145336_jpg.rf.28de2a53875dce1e728e5a0c0cb97aad.jpg
4_faster_rcnn,fold_9,2,2,2,0,0,20230512_145253_jpg.rf.c6fbf385d5f1b3ae20b0ef540f9e84b5.jpg
4_faster_rcnn,fold_9,19,17,16,1,-2,20230512_153250_jpg.rf.b3c0a5af0f8dd45ec4fe90ed8e62c274.jpg
4_faster_rcnn,fold_9,2,3,2,1,1,20230512_151637-0-_jpg.rf.57d42a7eaecae72323f8868de4088574.jpg
4_faster_rcnn,fold_9,5,2,2,0,-3,IMG_3982_JPG.rf.084073c997ce2761c02b36ef237261da.jpg
4_faster_rcnn,fold_9,2,1,1,0,-1,20230512_145050_jpg.rf.ae125a7aa3a0b2c6f41bc879a36698ce.jpg
4_faster_rcnn,fold_9,10,10,10,0,0,20230512_151905-0-_jpg.rf.270832f78fc4546ac9758205aad2a837.jpg
4_faster_rcnn,fold_9,2,3,2,1,1,20230512_150048_jpg.rf.bdbae272f798a54cd79cfc08bd2da41e.jpg
4_faster_rcnn,fold_9,13,14,9,5,1,20230512_145159_jpg.rf.a9f2125d1fdfa80946c0b272e36cb621.jpg
4_faster_rcnn,fold_9,2,2,2,0,0,20230512_151541_jpg.rf.1a96f83831f9956a1c5cd8cb7987ee61.jpg
4_faster_rcnn,fold_9,1,0,0,0,-1,20230512_151118_jpg.rf.2bf6dd63d6a65371da02c372efde8ba3.jpg
4_faster_rcnn,fold_9,2,1,1,0,-1,IMG_3862_JPG.rf.a37466cc240bba5feaeef8019ddd0e55.jpg
4_faster_rcnn,fold_9,4,3,2,1,-1,IMG_3843_JPG.rf.3b04ef87c1af95cd756b57595eb39e72.jpg
4_faster_rcnn,fold_9,16,15,7,8,-1,IMG_20230512_145144_jpg.rf.4c14218fadac19f6b4d5270f23587de8.jpg
4_faster_rcnn,fold_9,2,2,2,0,0,20230512_151759_jpg.rf.04ce83457ca436da1fc767b75f695b6b.jpg
4_faster_rcnn,fold_9,1,2,1,1,1,IMG_20230512_145257_jpg.rf.453736b6f9bd9250f595d3afd851de1f.jpg
4_faster_rcnn,fold_9,2,2,2,0,0,230512_150129_jpg.rf.10e62e193f0a96333642eeae2d068d57.jpg
4_faster_rcnn,fold_9,1,2,1,1,1,IMG_3932_JPG.rf.42e9d2a10f9734e5a4bc91d0d9eb642c.jpg
4_faster_rcnn,fold_9,63,26,20,6,-37,0512_150200_jpg.rf.8539b7a73e953ce0ea7f67784fcb2b58.jpg
4_faster_rcnn,fold_9,6,5,5,0,-1,IMG_20230512_145254_217_jpg.rf.4e2eb97449efdb3bab4662c35a288482.jpg
4_faster_rcnn,fold_9,4,4,3,1,0,20230512_150253_jpg.rf.a852fcb9c971bcf0f4b4b6c07b3a1e7e.jpg
4_faster_rcnn,fold_9,15,9,9,0,-6,IMG_20230512_151900_jpg.rf.fad29398cd9611cef06c98d97c2dc00c.jpg
4_faster_rcnn,fold_9,1,2,0,2,1,IMG_3840_JPG.rf.263bceb78886d3833883706e095d5293.jpg
4_faster_rcnn,fold_9,5,6,4,2,1,IMG_20230512_150955_jpg.rf.2011788cab5844089b8e6b7902ac846b.jpg
4_faster_rcnn,fold_9,2,2,2,0,0,20230512_151440_jpg.rf.386c9f0ed80e964393660a1d9c01d9ed.jpg
4_faster_rcnn,fold_9,4,4,4,0,0,20230512_152247_jpg.rf.bdbffc243ed1383af5410f7bac53699a.jpg
4_faster_rcnn,fold_9,19,13,13,0,-6,20230512_152211_jpg.rf.c54aefeead1c1b68600e1ae65c10b527.jpg
4_faster_rcnn,fold_9,4,2,2,0,-2,20230512_152232_jpg.rf.01102a74dddfc813f9188dc90bff647f.jpg
4_faster_rcnn,fold_9,3,3,2,1,0,IMG_20230512_151701_jpg.rf.0d3314dfd579b4e13828bb386bfee49b.jpg
4_faster_rcnn,fold_9,10,9,9,0,-1,IMG_20230512_152339_jpg.rf.4d50232667e59a45a8f02b1dc00c36ea.jpg
4_faster_rcnn,fold_9,5,6,5,1,1,IMG_20230512_153347_022_jpg.rf.eca10caf5bcd60d00f0f197496dabd1c.jpg
4_faster_rcnn,fold_9,12,13,12,1,1,IMG_20230512_152353_jpg.rf.74eba0461c089d0aea3691aee4afbac9.jpg
4_faster_rcnn,fold_9,2,1,1,0,-1,20230512_150825_jpg.rf.04725a59554eac4f344acef56d3fb6fe.jpg
4_faster_rcnn,fold_9,5,5,5,0,0,20230512_151056_jpg.rf.3214ae92a59425896458690934fb5d39.jpg
4_faster_rcnn,fold_9,1,2,1,1,1,230512_150046_jpg.rf.a453bfc60f25c0a831415acaf760061b.jpg
4_faster_rcnn,fold_9,6,6,6,0,0,IMG_20230512_145419_jpg.rf.605cea1a83f727c0d545999a0d6e6e84.jpg
4_faster_rcnn,fold_9,24,21,16,5,-3,0512_150049_jpg.rf.4c2d31120db48096f79c8d147d016509.jpg
4_faster_rcnn,fold_9,1,2,0,2,1,0052_jpg.rf.11b9f0f1317ccd80a627cd52e3e7c819.jpg
4_faster_rcnn,fold_9,4,3,0,3,-1,230512_150113_jpg.rf.491cf8e16672678e5500d8eb3e1bc404.jpg
4_faster_rcnn,fold_9,11,10,6,4,-1,20230512_145204_jpg.rf.c52942b0bcdcd04cafca718031f2ab26.jpg
4_faster_rcnn,fold_9,2,2,2,0,0,IMG_20230512_150931_jpg.rf.2ce16e755fe6e9b894d7d449fafbd463.jpg
4_faster_rcnn,fold_9,1,1,1,0,0,20230512_145348_jpg.rf.a9486de8293f423be4b7c903a6adf9d6.jpg
4_faster_rcnn,fold_9,1,1,1,0,0,20230512_151644_jpg.rf.3bb96898f1cf4f86f3720f45fe4a4ce1.jpg
4_faster_rcnn,fold_9,3,3,3,0,0,IMG_4093_JPG.rf.ebedb6000fb84b714cc74fef511c31aa.jpg
4_faster_rcnn,fold_9,4,1,1,0,-3,20230512_145002_jpg.rf.97109db1b99cc660d69da24c9747f303.jpg
4_faster_rcnn,fold_9,2,2,2,0,0,20230512_151640_jpg.rf.f22b10e3e5f15d07706b85eb0b969f91.jpg
4_faster_rcnn,fold_9,2,2,2,0,0,20230512_151631_jpg.rf.4e69595c48be79bb26b1487f3e19266e.jpg
4_faster_rcnn,fold_9,6,6,4,2,0,20230512_153330_jpg.rf.462ae2c6301c8971d155ebb9a3378c36.jpg
4_faster_rcnn,fold_9,8,8,6,2,0,IMG_4189_JPG.rf.ef51bea3fc4ec3eb14a9abaa4902f277.jpg
4_faster_rcnn,fold_9,21,22,20,2,1,20230512_150126_jpg.rf.fa9718948fbb766a50fee0608d280d14.jpg
4_faster_rcnn,fold_9,37,35,34,1,-2,IMG_20230512_153238_678_jpg.rf.9b33a9187212479d779bf15d553e8efc.jpg
4_faster_rcnn,fold_9,2,3,1,2,1,IMG_4219_JPG.rf.81654d924a576c094f3f57b813e83fa9.jpg
4_faster_rcnn,fold_9,6,6,5,1,0,IMG_20230512_153107_jpg.rf.1ec84b2b739232a85f9ad467ee8a214f.jpg
4_faster_rcnn,fold_10,14,15,9,6,1,IMG_20230512_150109_804_jpg.rf.e638755720658c18627b68883d0270d6.jpg
4_faster_rcnn,fold_10,13,14,11,3,1,IMG_4205_JPG.rf.e6945a0f8c8342f636251e46e904f729.jpg
4_faster_rcnn,fold_10,1,1,1,0,0,IMG_20230512_145046_815_jpg.rf.bccba2de087b0c29681bdd4ff7c199f1.jpg
4_faster_rcnn,fold_10,12,14,12,2,2,20230512_153030_jpg.rf.447a01796d662b57a717346a6885bdc7.jpg
4_faster_rcnn,fold_10,29,15,13,2,-14,20230512_153308_jpg.rf.1f2393c128a7608a2a6b40892e5c576d.jpg
4_faster_rcnn,fold_10,21,14,12,2,-7,20230512_150151_jpg.rf.73a61752872f6ef725371184031d1666.jpg
4_faster_rcnn,fold_10,1,1,1,0,0,20230512_151711_jpg.rf.10c1db788e52a7dfc81744f4936a3ef0.jpg
4_faster_rcnn,fold_10,5,5,5,0,0,20230512_152341_jpg.rf.67a7bff5a653064d0fbb2dfa8b1f90ce.jpg
4_faster_rcnn,fold_10,1,1,1,0,0,20230512_150750_jpg.rf.e86dd1819063fd640c2ba43c41a741f8.jpg
4_faster_rcnn,fold_10,10,11,9,2,1,IMG_20230512_145121_jpg.rf.690688dd9055bfc063e326aa4fef07f4.jpg
4_faster_rcnn,fold_10,3,7,3,4,4,20230512_152340_jpg.rf.cfcfb6148dee3cdf12d6d85f1d247895.jpg
4_faster_rcnn,fold_10,5,5,5,0,0,20230512_152235_jpg.rf.08f40afdb24635f6dcfbb88615a2f9f7.jpg
4_faster_rcnn,fold_10,9,8,8,0,-1,20230512_152302_jpg.rf.6925e24fe61ef38107dc845cce1a2d60.jpg
4_faster_rcnn,fold_10,1,2,1,1,1,IMG_20230512_151207_jpg.rf.ae49ac5f1949da487c30a4f4ba31817b.jpg
4_faster_rcnn,fold_10,16,15,8,7,-1,20230512_150011_jpg.rf.1da3e5f3e295949ab4854def4bdbd922.jpg
4_faster_rcnn,fold_10,3,1,1,0,-2,IMG_20230512_145025_jpg.rf.c0282883e0ec5ffed07135f0bda0ecfa.jpg
4_faster_rcnn,fold_10,4,6,4,2,2,20230512_151843_jpg.rf.b93560c5fdb00199587ea962c11d4103.jpg
4_faster_rcnn,fold_10,4,3,1,2,-1,20230512_145326_jpg.rf.e57a46b969b04ee9d16c309181d71fe7.jpg
4_faster_rcnn,fold_10,1,1,1,0,0,20230512_153428_jpg.rf.ebef48003f439c4f546df0dab6aff50b.jpg
4_faster_rcnn,fold_10,23,16,14,2,-7,IMG_20230512_150120_jpg.rf.4b23fdc5feb46ad8a31de385747c52bc.jpg
4_faster_rcnn,fold_10,4,3,3,0,-1,IMG_3990_JPG.rf.7d3c75f1558f8f5fc9ac7eb6789e10dc.jpg
4_faster_rcnn,fold_10,8,8,7,1,0,20230512_150819_jpg.rf.d1513f98969bc1b7ac4e870d3cdb41e6.jpg
4_faster_rcnn,fold_10,12,9,7,2,-3,20230512_151038_jpg.rf.6caba5860602aa931872edf19ec2b6c5.jpg
4_faster_rcnn,fold_10,1,1,0,1,0,IMG_20230512_145146_354_jpg.rf.6de83b52b9e3abba9866d24be95f4c4d.jpg
4_faster_rcnn,fold_10,7,5,5,0,-2,IMG_4190_JPG.rf.7081f39db6690560b3a2bdd4cbc00d86.jpg
4_faster_rcnn,fold_10,3,3,3,0,0,IMG_20230512_145252_021_jpg.rf.1779d92134a07ec7f57f4438113bb031.jpg
4_faster_rcnn,fold_10,12,10,10,0,-2,230512_150135_jpg.rf.cc24c1ff5e0e940d16df6a7b71d2eabd.jpg
4_faster_rcnn,fold_10,5,5,3,2,0,IMG_20230512_151042_jpg.rf.15dee8949138ef80373228e81079c023.jpg
4_faster_rcnn,fold_10,6,6,4,2,0,IMG_20230512_151950_jpg.rf.c8c0371384e1a2262fdd3d8a53e11fa3.jpg
4_faster_rcnn,fold_10,1,2,1,1,1,IMG_20230512_151703_jpg.rf.28a7fdeaae4d54d7cf2de4be9ed4df40.jpg
4_faster_rcnn,fold_10,11,11,9,2,0,20230512_150147_jpg.rf.55aa66e580136cb844b6c51dff5d3fed.jpg
4_faster_rcnn,fold_10,37,20,13,7,-17,20230512_150235_jpg.rf.4361e97cfeccf708272ffe4ece69dbfd.jpg
4_faster_rcnn,fold_10,2,2,1,1,0,IMG_20230512_144940_500_jpg.rf.75e33e87c9ad9b74dd1e4b3091ba269f.jpg
4_faster_rcnn,fold_10,5,5,5,0,0,20230512_145410_jpg.rf.56000063a0c914b346f9cd7261abac1e.jpg
4_faster_rcnn,fold_10,1,1,1,0,0,IMG_4033_JPG.rf.d1e341639e4e7d193425664e20325a4c.jpg
4_faster_rcnn,fold_10,14,13,9,4,-1,IMG_20230512_150125_134_jpg.rf.88679af4628e0ef4675fe385a333d31c.jpg
4_faster_rcnn,fold_10,13,13,13,0,0,20230512_151904_jpg.rf.7f72f44e41b8a58e5db1391fa2b35a42.jpg
4_faster_rcnn,fold_10,2,2,2,0,0,20230512_151841-0-_jpg.rf.601490af90bd9514d0d590298e1f0255.jpg
4_faster_rcnn,fold_10,5,2,2,0,-3,20230512_145357_jpg.rf.90422bd2b26f6dd0bd566293b4b30bb5.jpg
4_faster_rcnn,fold_10,9,7,7,0,-2,IMG_20230512_151951_jpg.rf.31e79520ea845227f969872a61796113.jpg
4_faster_rcnn,fold_10,1,1,1,0,0,20230512_151646_jpg.rf.6320d2328bf6de098fff781bcffac0cb.jpg
4_faster_rcnn,fold_10,20,15,15,0,-5,IMG_3903_JPG.rf.7c248f88ef915e14444c5c43dc048c82.jpg
4_faster_rcnn,fold_10,3,2,2,0,-1,IMG_20230512_151830_jpg.rf.c0f3338eb7af1f0e178971c38c7dec04.jpg
4_faster_rcnn,fold_10,9,6,6,0,-3,IMG_20230512_144958_jpg.rf.0a6117e6c2ebbfabe543484d7a8056db.jpg
4_faster_rcnn,fold_10,4,4,4,0,0,IMG_4095_JPG.rf.58645f8fad94bdb38886e47695cfd8cd.jpg
4_faster_rcnn,fold_10,4,4,4,0,0,20230512_152345_jpg.rf.2717f971fd14976a3492abb509e947cb.jpg
4_faster_rcnn,fold_10,2,2,2,0,0,IMG_3920_JPG.rf.24878eeb02230840f60014978ff530d7.jpg
4_faster_rcnn,fold_10,9,7,5,2,-2,IMG_20230512_150046_jpg.rf.6e840be1f4fa3a56d132b04b6e288480.jpg
4_faster_rcnn,fold_10,9,9,6,3,0,IMG_20230512_145258_jpg.rf.a062df356e44019699d3c53596d3540e.jpg
4_faster_rcnn,fold_10,1,1,1,0,0,IMG_20230512_161348_jpg.rf.aea1bf3794b2d077c45245810c001a1c.jpg
4_faster_rcnn,fold_10,8,10,8,2,2,230512_150139_jpg.rf.2d8a8d2ed426f1cb21935b033da8b2f6.jpg
4_faster_rcnn,fold_10,14,11,11,0,-3,IMG_20230512_151610_001_jpg.rf.88fda6a270dac232937c53d6188fa5a9.jpg
4_faster_rcnn,fold_10,1,1,0,1,0,230512_145108_jpg.rf.cf20720f57cffcf1f9fa31cecfe67fbf.jpg
4_faster_rcnn,fold_10,1,0,0,0,-1,IMG_3857_JPG.rf.c98e2825881d870a7242c7271763f36b.jpg
4_faster_rcnn,fold_10,4,1,1,0,-3,20230512_151024_jpg.rf.a0cfadc35d426648ee3656824927c11e.jpg
4_faster_rcnn,fold_10,1,1,1,0,0,0036_jpg.rf.6d90090548975dc2e489ef2ff1546863.jpg
4_faster_rcnn,fold_10,2,1,1,0,-1,20230512_152306_jpg.rf.a7141e38fe1a72a82a763e55d71fd0b5.jpg
4_faster_rcnn,fold_10,15,10,9,1,-5,20230512_150018_jpg.rf.3bc690cd3af7d48b107dc3a68930fc2f.jpg
4_faster_rcnn,fold_10,7,5,4,1,-2,IMG_20230512_151112_jpg.rf.6600a13c525e7d830908b03b8a0d3526.jpg
4_faster_rcnn,fold_10,14,14,14,0,0,0057_jpg.rf.850f7a1e0cc045be1a9326878338232a.jpg
4_faster_rcnn,fold_10,7,7,7,0,0,0051_jpg.rf.e81d23e22a72795f3bbc83a62bd65cae.jpg
4_faster_rcnn,fold_10,4,4,4,0,0,0006_jpg.rf.ea818ccdacee9dd00131e372a19cf0d0.jpg
4_faster_rcnn,fold_10,22,15,12,3,-7,20230512_150013_jpg.rf.88f9a3a7e9a79d06352d99a9a40fcfb5.jpg
4_faster_rcnn,fold_10,1,1,1,0,0,IMG_20230512_151605_jpg.rf.cd36cb9aab7833e1d827ed72719f9742.jpg
4_faster_rcnn,fold_10,7,3,3,0,-4,20230512_150940_jpg.rf.a642f28b441714d9d9e22de0ad22f124.jpg
4_faster_rcnn,fold_10,24,20,15,5,-4,0512_150306_jpg.rf.b16cedf3571182816f46e3a952d5c39a.jpg
4_faster_rcnn,fold_10,3,6,3,3,3,20230512_152308_jpg.rf.f4dc38f04cbc5fd664dec02e3ed16103.jpg
4_faster_rcnn,fold_10,2,2,2,0,0,IMG_20230512_151812_jpg.rf.86425b9d53f765e1b77d6eba211405fe.jpg
4_faster_rcnn,fold_10,12,11,10,1,-1,20230512_152316_jpg.rf.dd8d1d54a326eb9ed9a63bc5520eadad.jpg
4_faster_rcnn,fold_10,2,2,2,0,0,20230512_152213_jpg.rf.1125dc3c4a87888cb65b2d513aa9df85.jpg
4_faster_rcnn,fold_10,17,10,10,0,-7,IMG_20230512_150147_169_jpg.rf.df6bd6535b4bdd11e20a358e10a11c09.jpg
4_faster_rcnn,fold_10,10,9,9,0,-1,IMG_4100_JPG.rf.f55f9f2afb5f41daaa63474d6df30725.jpg
4_faster_rcnn,fold_10,23,22,21,1,-1,IMG_20230512_153004_jpg.rf.19c27a824e3c2f07149751bcaaa47c7f.jpg
4_faster_rcnn,fold_10,1,1,1,0,0,20230512_151648_jpg.rf.f5ddd2e522a504da5dc723bdc2dec390.jpg
4_faster_rcnn,fold_10,2,3,1,2,1,0005_jpg.rf.79044c26eeb52526a25a3f38e1aa840d.jpg
4_faster_rcnn,fold_10,4,2,0,2,-2,IMG_20230512_145001_113_jpg.rf.5ea2af9825ef6b6ebe2436d89dbe79ca.jpg
4_faster_rcnn,fold_10,1,1,1,0,0,IMG_4183_JPG.rf.1c0ab4bee811c122c1ef5f9131477050.jpg
4_faster_rcnn,fold_10,2,1,1,0,-1,20230512_151124_jpg.rf.250cebbf32ee5a6ab788e62fd50ecf2c.jpg
4_faster_rcnn,fold_10,3,2,2,0,-1,IMG_4022_JPG.rf.e15de99fae6d1e74eb63284f3616a75f.jpg
4_faster_rcnn,fold_10,7,7,7,0,0,20230512_152319_jpg.rf.abeccdd8fbdc8f18e24c3acdf6c07d48.jpg
4_faster_rcnn,fold_10,25,19,18,1,-6,IMG_3911_JPG.rf.1bb0ec60809450d49cc43c3d8a1265de.jpg
4_faster_rcnn,fold_10,6,11,6,5,5,20230512_151418_jpg.rf.90e438577c310e46b8a21f2ae0b85242.jpg
4_faster_rcnn,fold_10,9,7,7,0,-2,20230512_153311_jpg.rf.3ecbca1f6ffb06d59119f6627139da8a.jpg
4_faster_rcnn,fold_10,5,6,4,2,1,20230512_150206_jpg.rf.8ae1878e1b65e9920f1a99af4f941d9c.jpg
4_faster_rcnn,fold_10,3,4,4,0,1,IMG_4389_JPG.rf.d64ad350bc28019aa4851039e73dfdfa.jpg
4_faster_rcnn,fold_10,10,5,2,3,-5,0512_150317_jpg.rf.a70fbe5816d46c9fa83979febbeb753f.jpg
4_faster_rcnn,fold_10,7,7,7,0,0,20230512_145440_jpg.rf.faac237167337f22dcbfb3879916747e.jpg
4_faster_rcnn,fold_10,14,14,9,5,0,20230512_150138_jpg.rf.baad1e97bbf234f37489ac66f024a808.jpg
4_faster_rcnn,fold_10,12,10,8,2,-2,20230512_150159_jpg.rf.15a7a075343358e808fef60d09b7b8c3.jpg
4_faster_rcnn,fold_10,2,2,0,2,0,IMG_20230512_151004_jpg.rf.fa632ed53260b0c0873743bd4155a490.jpg
4_faster_rcnn,fold_10,6,6,6,0,0,IMG_20230512_151929_jpg.rf.8916d2cec0ed6feba243725d4795cee6.jpg
4_faster_rcnn,fold_10,6,7,3,4,1,20230512_150108_jpg.rf.114d86f5dc5d95e4469bf960bc7c0a4f.jpg
4_faster_rcnn,fold_10,10,9,8,1,-1,0014_jpg.rf.69fba8cc80a5714926e6841f224baffc.jpg
4_faster_rcnn,fold_10,1,1,1,0,0,IMG_20230512_145359_479_jpg.rf.6b65f34991508137d8d33789257462e4.jpg
4_faster_rcnn,fold_10,5,5,2,3,0,MG_20230512_145100_jpg.rf.2fac7875b124670b96ab0a3b253f2e29.jpg
4_faster_rcnn,fold_10,6,7,6,1,1,20230512_151747_jpg.rf.f2ca78e158d0f2965152169425291a5a.jpg
4_faster_rcnn,fold_10,9,8,7,1,-1,230512_150154_jpg.rf.6b065a843e8b776c3731c23f8a875399.jpg
4_faster_rcnn,fold_10,1,1,1,0,0,20230512_145117_jpg.rf.1ad15540d0fbbd6bac016639ff1c07a3.jpg
4_faster_rcnn,fold_10,4,3,2,1,-1,20230512_145248_jpg.rf.8a3953be78b4c9d70df1b12fd15d4939.jpg
4_faster_rcnn,fold_10,2,3,2,1,1,IMG_3836_JPG.rf.434cd50ae74cfc4c9d1e3085a73a905b.jpg
4_faster_rcnn,fold_10,8,7,6,1,-1,20230512_150949_jpg.rf.81b6e460185cb992a26ccccb5e72b394.jpg
4_faster_rcnn,fold_10,11,12,10,2,1,IMG_20230512_152452_jpg.rf.849169ae208c086f88f01686f87e3c82.jpg
4_faster_rcnn,fold_10,12,11,10,1,-1,IMG_aaaa_jpg.rf.6f8cea923b21b011dca38cdc115eaf80.jpg
4_faster_rcnn,fold_10,1,1,1,0,0,IMG_20230512_145313_jpg.rf.3ae2ff3ddf2bb75af26203bf8cca362c.jpg
4_faster_rcnn,fold_10,14,12,12,0,-2,IMG_20230512_151605_536_jpg.rf.39cf087a8f42f961dca0c0caa4dfa17d.jpg
4_faster_rcnn,fold_10,8,9,8,1,1,20230512_145342_jpg.rf.b956dcb9a2579c2e8f754353e1d00c75.jpg
4_faster_rcnn,fold_10,8,6,6,0,-2,IMG_4193_JPG.rf.ee7ebd7c653b26c381990c2e3f69556f.jpg
4_faster_rcnn,fold_10,5,5,4,1,0,IMG_20230512_151457_jpg.rf.49e2e6a56131fab5a439e78b087a3b8a.jpg
4_faster_rcnn,fold_10,1,1,1,0,0,20230512_145224_jpg.rf.b8204cbb29051890879b714634f912b6.jpg
4_faster_rcnn,fold_10,11,11,9,2,0,IMG_20230512_152257_409_jpg.rf.8463210402c73719c09f0b2210f7cfb4.jpg
4_faster_rcnn,fold_10,16,14,11,3,-2,20230512_152313_jpg.rf.cae2b30990ff4679b62bdf438fbd8044.jpg
4_faster_rcnn,fold_10,1,1,0,1,0,0230512_145347_jpg.rf.58a6f73f43efb9705bb2978f49927337.jpg
4_faster_rcnn,fold_10,9,9,9,0,0,0034_jpg.rf.d4c6d4e1816e57648e3dbb1782385073.jpg
4_faster_rcnn,fold_10,2,3,1,2,1,IMG_20230512_151611_jpg.rf.b44877740f7dd0dc052351bbded2044b.jpg
4_faster_rcnn,fold_10,17,15,14,1,-2,230512_150149_jpg.rf.b74d07f3292d3144d25facf3dde243dc.jpg
4_faster_rcnn,fold_10,59,48,18,30,-11,IMG_20230512_153218_jpg.rf.cac514c0d5c15fe1628359a5bfa2dacb.jpg
4_faster_rcnn,fold_10,6,8,5,3,2,IMG_20230512_145054_075_jpg.rf.5e98b15c8a4633098064286c64be239e.jpg
4_faster_rcnn,fold_10,5,0,0,0,-5,IMG_20230512_151259_jpg.rf.7b57c2547bbd877ef1243a2ab325c2fa.jpg
4_faster_rcnn,fold_10,70,24,20,4,-46,20230512_153220_jpg.rf.660dfd8464712797760cfa3b49fef4e7.jpg
4_faster_rcnn,fold_10,9,6,5,1,-3,IMG_4186_JPG.rf.c6b51e615ccecf25291d4d3bd703172a.jpg
4_faster_rcnn,fold_10,4,2,1,1,-2,20230512_144950_jpg.rf.b105c1ba7257a4da1b17c9f42de1770a.jpg
4_faster_rcnn,fold_10,9,9,7,2,0,IMG_20230512_145304_jpg.rf.7de02525de42506dbd7eda7365fd0065.jpg
4_faster_rcnn,fold_10,4,3,2,1,-1,20230512_145209_jpg.rf.c73d398c69a90599525e2c2a8cb51f2c.jpg
4_faster_rcnn,fold_10,3,4,3,1,1,20230512_151741_jpg.rf.989b1ddb73b99e41bd2bddfcf1c60e1d.jpg
4_faster_rcnn,fold_10,2,2,2,0,0,20230512_152209_jpg.rf.c79a1a42b4846b485a9b00d575fb1626.jpg
4_faster_rcnn,fold_10,17,14,13,1,-3,20230512_152258_jpg.rf.485967412d3788c1a657a3be4d77671e.jpg
4_faster_rcnn,fold_10,2,2,2,0,0,IMG_20230512_151818_jpg.rf.593796b492f80d2ddd3e0449eec86414.jpg
4_faster_rcnn,fold_10,1,1,1,0,0,20230512_145110_jpg.rf.02ac7002fe460313bbf3d2c9d99f8ba7.jpg
4_faster_rcnn,fold_10,4,6,3,3,2,IMG_3907_JPG.rf.b1def63b2acf54c44c0c502aca5f4d44.jpg
4_faster_rcnn,fold_10,1,1,1,0,0,20230512_150722_jpg.rf.811e652f271c46d6a3e10299f1a6b7d9.jpg
4_faster_rcnn,fold_10,1,1,0,1,0,20230512_145243_jpg.rf.6f06c25acca67180648bf428a474f0b3.jpg
4_faster_rcnn,fold_10,2,2,2,0,0,20230512_145053_jpg.rf.dd5c06f85a2f9673d635a3b60256df27.jpg
4_faster_rcnn,fold_10,1,1,1,0,0,IMG_20230512_151236_jpg.rf.697c89d65f7f53a2cf18544c923eb896.jpg
4_faster_rcnn,fold_10,1,1,1,0,0,0230512_145425_jpg.rf.f4fcff283a6f3d5ea4f0275a52a87728.jpg
4_faster_rcnn,fold_10,24,24,20,4,0,0001_jpg.rf.0c630bace393ba8970fa7c3c8fd7c235.jpg
4_faster_rcnn,fold_10,8,10,8,2,2,20230512_152317_jpg.rf.fddebbf7fe2a035df51e17bb0c14e2b4.jpg
4_faster_rcnn,fold_10,9,4,4,0,-5,IMG_4209_JPG.rf.093053ef31116bcee7646b801c678d5b.jpg
4_faster_rcnn,fold_10,23,15,13,2,-8,20230512_150122_jpg.rf.cb6d477ccda3127b4d473101af503eb3.jpg
4_faster_rcnn,fold_10,4,4,4,0,0,20230512_152326_jpg.rf.8ca5737543dbfcb717b333d32cc18f8b.jpg
4_faster_rcnn,fold_10,1,0,0,0,-1,20230512_145056_jpg.rf.2bbf028730f3b9804aa416234c6db613.jpg
4_faster_rcnn,fold_10,6,5,5,0,-1,0037_jpg.rf.e51421425c8718d498a1cc958bfeeb2b.jpg
4_faster_rcnn,fold_10,10,9,5,4,-1,IMG_20230512_153400_jpg.rf.5f42ce4759cb794127f4f23098e0ff58.jpg
4_faster_rcnn,fold_10,8,7,7,0,-1,20230512_151848_jpg.rf.2c6000bd3b3f3ae44c8e672b08aec3b5.jpg
4_faster_rcnn,fold_10,23,7,4,3,-16,IMG_20230512_153450_jpg.rf.af0e93ea32d0b17c0b616de937189066.jpg
4_faster_rcnn,fold_10,3,3,3,0,0,IMG_3921_JPG.rf.e8186af83ff3af27612213a05a7c5177.jpg
4_faster_rcnn,fold_10,10,9,8,1,-1,IMG_20230512_145056_jpg.rf.340c9781ae519c2a173e9014c5be4072.jpg
4_faster_rcnn,fold_10,5,1,1,0,-4,20230512_145001_jpg.rf.ac3499ee309bec2035194be16f5da378.jpg
4_faster_rcnn,fold_10,1,0,0,0,-1,20230512_145104_jpg.rf.a25f0f63e3b58e348bedb4aa97e67394.jpg
4_faster_rcnn,fold_10,38,14,6,8,-24,0512_150303_jpg.rf.54131a2e7501a146e0d64448ccb7d595.jpg
4_faster_rcnn,fold_10,1,0,0,0,-1,20230512_145308_jpg.rf.692ac823c338ea1cdf326339c51eb5b1.jpg
4_faster_rcnn,fold_10,7,7,7,0,0,0060_jpg.rf.a0b1380ab0b6548c6335a9f12bb9f9f5.jpg
4_faster_rcnn,fold_10,1,1,1,0,0,IMG_20230512_150846_jpg.rf.f9a1c340f4f40ffecf79883a50c53a30.jpg
4_faster_rcnn,fold_10,11,11,11,0,0,20230512_151902_jpg.rf.0d916693ef179e70195af9fd22402789.jpg
4_faster_rcnn,fold_10,13,9,7,2,-4,IMG_4211_JPG.rf.76ca0821ebf56f29d1009eb9ff45a384.jpg
4_faster_rcnn,fold_10,10,12,9,3,2,IMG_20230512_153020_jpg.rf.e9080cc66a8631a1e9e4e610e61bc6a4.jpg
4_faster_rcnn,fold_10,14,11,10,1,-3,20230512_153059_jpg.rf.48d36662c46f21f6e2c61dbaa81b1253.jpg
4_faster_rcnn,fold_10,6,6,6,0,0,IMG_20230512_145113_jpg.rf.0828a4e83c0458a5f8bc5967b29e1db1.jpg
4_faster_rcnn,fold_10,1,1,1,0,0,20230512_145418_jpg.rf.8af049af1c5b2eb413647f320a119a74.jpg
5_atss,fold_1,2,1,1,0,-1,20230512_153003_jpg.rf.3e11918b7e073ed9642c3d889f82a10b.jpg
5_atss,fold_1,3,0,0,0,-3,20230512_152344_jpg.rf.9cdeba0a7faf9c91db6a1bec355cd79f.jpg
5_atss,fold_1,8,5,5,0,-3,20230512_150202_jpg.rf.2d354a6afba7660a4bdb4422aacb0bf1.jpg
5_atss,fold_1,2,0,0,0,-2,20230512_151842_jpg.rf.0400a2b89be930a6aee77dd6416cc317.jpg
5_atss,fold_1,1,0,0,0,-1,20230512_153001_jpg.rf.9e1933e066ac83bf9fbd01b8def6158d.jpg
5_atss,fold_1,6,4,4,0,-2,IMG_4052_JPG.rf.a484ba8b08f647c9d706f26a2c1bdd88.jpg
5_atss,fold_1,1,0,0,0,-1,IMG_3933_JPG.rf.b0d6e8cf999e8234386ed5bb6107f61a.jpg
5_atss,fold_1,23,0,0,0,-23,20230512_153423_jpg.rf.199d17397bc75e4b3c997992a9469adb.jpg
5_atss,fold_1,1,0,0,0,-1,230512_150115_jpg.rf.048aa47fa124320a4fa8a5c30506622b.jpg
5_atss,fold_1,8,4,4,0,-4,20230512_152239_jpg.rf.5270f7fe5715e9e4db1967390d36c76d.jpg
5_atss,fold_1,7,5,5,0,-2,IMG_20230512_152358_jpg.rf.14382fa8e1d185e8ecd9b6b625021b8f.jpg
5_atss,fold_1,1,1,1,0,0,20230512_151657_jpg.rf.ae916e776287bd8044bda6da1e1dec7e.jpg
5_atss,fold_1,2,0,0,0,-2,IMG_4202_JPG.rf.389eb0baa38b2b42b82e272dae53dd7b.jpg
5_atss,fold_1,10,2,1,1,-8,20230512_150031_jpg.rf.5b7cf141f46aecb85b2c9e4f6977aa4c.jpg
5_atss,fold_1,4,3,3,0,-1,IMG_20230512_151251_jpg.rf.13115516a78a5324e008f7864789fbec.jpg
5_atss,fold_1,17,0,0,0,-17,20230512_150005_jpg.rf.77d140d77f3f48953c783c2d50e6f910.jpg
5_atss,fold_1,1,0,0,0,-1,20230512_150058_jpg.rf.daa9ab4c09a0e2a557b1e8bb54702ecb.jpg
5_atss,fold_1,6,1,1,0,-5,20230512_152201_jpg.rf.3c9e01b2433736fc6ee290b90dd42684.jpg
5_atss,fold_1,6,4,4,0,-2,IMG_20230512_151219_jpg.rf.6d76721a015ae20af4047ec2607a62e0.jpg
5_atss,fold_1,19,2,2,0,-17,IMG_20230512_150136_jpg.rf.004497d9e0b84ae3cd5c8e7e5e9f30d7.jpg
5_atss,fold_1,32,6,6,0,-26,0008_jpg.rf.94e89ad01289e8cfda380621151bf1bb.jpg
5_atss,fold_1,1,1,1,0,0,IMG_4027_JPG.rf.02fde7996d0a3e63cd8727ba35b98fbd.jpg
5_atss,fold_1,7,4,4,0,-3,IMG_4051_JPG.rf.1f19a2adfb075e1a7c5d3d9567879ae2.jpg
5_atss,fold_1,3,1,1,0,-2,IMG_20230512_145126_jpg.rf.0493bac7dcca35f2a361df2325097b88.jpg
5_atss,fold_1,4,2,2,0,-2,0004_jpg.rf.7a14cc5ff08b5ee1437266474bc51865.jpg
5_atss,fold_1,1,0,0,0,-1,20230512_151446_jpg.rf.801ee52ac482b80a6b7e2c7a7a896dc7.jpg
5_atss,fold_1,1,0,0,0,-1,20230512_153217_jpg.rf.3d66bba80f697d614260fc56dd593486.jpg
5_atss,fold_1,23,0,0,0,-23,20230512_150312_jpg.rf.2040a566a6e8aa7d77563942d16e3907.jpg
5_atss,fold_1,4,0,0,0,-4,20230512_153409_jpg.rf.b9be0a0b5dc71b17d03a58db2af65fd3.jpg
5_atss,fold_1,1,1,1,0,0,20230512_145140_jpg.rf.3d71f74b4ed8a93a636f79ef1a9a7e9c.jpg
5_atss,fold_1,7,2,2,0,-5,0002_jpg.rf.d16d3de92655da222f9470322637f0a1.jpg
5_atss,fold_1,2,0,0,0,-2,IMG_20230512_153111_jpg.rf.71fdfa6f08329e5d2412e86bf6870b02.jpg
5_atss,fold_1,3,1,1,0,-2,IMG_20230512_151306_jpg.rf.e4b348fae9b8d16d80a5be211e9e39a1.jpg
5_atss,fold_1,7,0,0,0,-7,20230512_150132_jpg.rf.b204b63d3e3f8ef2920b32f1e0b6ab50.jpg
5_atss,fold_1,3,1,1,0,-2,IMG_20230512_151314_jpg.rf.231b8a97bc932aa622a2b27c80ee878b.jpg
5_atss,fold_1,1,1,1,0,0,20230512_145419_jpg.rf.cf9776dd6ff86988e3d4a8734ba6f15c.jpg
5_atss,fold_1,1,1,1,0,0,IMG_20230512_161355_jpg.rf.f1c1af37db10bfc139da92a922fa83a2.jpg
5_atss,fold_1,1,2,1,1,1,IMG_20230512_151815_jpg.rf.fad6e45cfa5e7c506e9fbad254cef9e0.jpg
5_atss,fold_1,6,2,2,0,-4,IMG_3922_JPG.rf.4fa3ab6d4b090dd6a9114495e5b5a468.jpg
5_atss,fold_1,37,0,0,0,-37,IMG_20230512_150214_jpg.rf.0a3e70748a25dbc7ca5305e84da8d3cd.jpg
5_atss,fold_1,5,4,4,0,-1,20230512_152251_jpg.rf.ebcf28d3c9a35107daa9beb28ae3475b.jpg
5_atss,fold_1,2,0,0,0,-2,20230512_151110_jpg.rf.53961421a4e7bd7511e281309a72a2c9.jpg
5_atss,fold_1,2,1,1,0,-1,20230512_151630_jpg.rf.ecc81d9067cb1ce5be1c14f9a6d71d9d.jpg
5_atss,fold_1,11,1,1,0,-10,IMG_20230512_145044_jpg.rf.d79716a7705a23a496d5d4896dbcf506.jpg
5_atss,fold_1,1,1,1,0,0,20230512_145031_jpg.rf.0c829f489393188e9f1ecc0ff78d8324.jpg
5_atss,fold_1,1,1,1,0,0,20230512_151712_jpg.rf.c494c6b379e948f9f084efcd40c0619d.jpg
5_atss,fold_1,13,5,5,0,-8,20230512_153109_jpg.rf.930610a4b0e78acb8ed778e44b9d5922.jpg
5_atss,fold_1,4,4,4,0,0,IMG_20230512_151205_jpg.rf.2bbe055a56edab8e820150d32613da40.jpg
5_atss,fold_1,2,0,0,0,-2,20230512_150059-0-_jpg.rf.641cecd96312dfe886a8bf287b5916db.jpg
5_atss,fold_1,2,1,1,0,-1,20230512_145234_jpg.rf.d7e55e93d9f98a6de3d20ef7221babc8.jpg
5_atss,fold_1,4,1,1,0,-3,IMG_20230512_145359_jpg.rf.c0fb243e34926596f7a71595884ae8c5.jpg
5_atss,fold_1,6,1,1,0,-5,20230512_145334_jpg.rf.0b72b785a7b59d3a4217025c7e5a2423.jpg
5_atss,fold_1,10,6,6,0,-4,20230512_152402_jpg.rf.2af7283a541e5a9a5150707a47c4be20.jpg
5_atss,fold_1,2,2,2,0,0,20230512_145352_jpg.rf.c846cb3c36e5363cfaa577a44b6913d8.jpg
5_atss,fold_1,23,4,4,0,-19,20230512_150226_jpg.rf.f79017b16f1532730f31cb325d6ab86e.jpg
5_atss,fold_1,1,1,0,1,0,20230512_153345-0-_jpg.rf.6e0b5b843ebfea1138cb759960e1bafc.jpg
5_atss,fold_1,2,0,0,0,-2,0036_jpg.rf.95bf6e3cde891a0e422157eafa8da143.jpg
5_atss,fold_1,1,0,0,0,-1,20230512_150121_jpg.rf.b7f710edf2464cb4724d24c65bae04b4.jpg
5_atss,fold_1,1,1,1,0,0,20230512_150720_jpg.rf.a18892cc876f35236d2a20ba37b6efd8.jpg
5_atss,fold_1,13,3,3,0,-10,20230512_153007_jpg.rf.d3b0e4362c8dc7fde7b007165efdd07e.jpg
5_atss,fold_1,1,0,0,0,-1,20230512_144958_jpg.rf.bd51a27225a9ddf5ef21b54512e10b9b.jpg
5_atss,fold_1,2,0,0,0,-2,20230512_151201_jpg.rf.003d9f32250e51b928c51a05b230f55a.jpg
5_atss,fold_1,5,0,0,0,-5,IMG_20230512_145247_597_jpg.rf.464f6c3eb3265be95f2f08e2d0bdd91a.jpg
5_atss,fold_1,8,3,3,0,-5,20230512_152159_jpg.rf.f9d372b7fdee9c83d543f19d83accc75.jpg
5_atss,fold_1,17,1,1,0,-16,IMG_20230512_150133_jpg.rf.e1213a79a5060e17585ebc484a3c63d6.jpg
5_atss,fold_1,4,0,0,0,-4,20230512_145007_jpg.rf.b9641853c4144bc1d5622b022182ed4b.jpg
5_atss,fold_1,1,1,0,1,0,IMG_20230512_145057_967_jpg.rf.680792c5520fea6605bcf774a290cd8f.jpg
5_atss,fold_1,2,1,1,0,-1,20230512_151633_jpg.rf.a660ff615450152ab9fbed4d02eeb6d7.jpg
5_atss,fold_1,8,6,6,0,-2,IMG_4090_JPG.rf.677923e65dcfcc46588eee4c2c2c9e46.jpg
5_atss,fold_1,10,6,6,0,-4,20230512_152258_jpg.rf.2e43ef7a91920046b900730064da408d.jpg
5_atss,fold_1,18,8,8,0,-10,20230512_152402_jpg.rf.5f60c1b7e4703f63b61c50a74049302f.jpg
5_atss,fold_1,4,2,2,0,-2,20230512_151121_jpg.rf.d9f5fd5a912436d588c2e8a3681b8643.jpg
5_atss,fold_1,15,6,5,1,-9,20230512_152310_jpg.rf.22fd13a135de99870e2b9f19a9dbd566.jpg
5_atss,fold_1,15,9,9,0,-6,IMG_4206_JPG.rf.86dc764134fcaa91fd5246c96808ba7a.jpg
5_atss,fold_1,1,1,1,0,0,20230512_145233_jpg.rf.9e2d494cc8579c52d6794c0fb5af14b7.jpg
5_atss,fold_1,1,0,0,0,-1,IMG_4014_JPG.rf.67af8816872a56054c245e272bdd23db.jpg
5_atss,fold_1,11,5,5,0,-6,IMG_20230512_151956_jpg.rf.accb7456b90404e99398a8475aa5f074.jpg
5_atss,fold_1,5,4,4,0,-1,20230512_152221_jpg.rf.dfe82842e573d8a1a7ff0d4519256b1d.jpg
5_atss,fold_1,35,1,1,0,-34,0512_150052_jpg.rf.6838fe76e0e5f7752c388cea428a676b.jpg
5_atss,fold_1,3,1,0,1,-2,IMG_20230512_150949_jpg.rf.0a7b1aca0bc2e95e7b33b4409d5f03e1.jpg
5_atss,fold_1,5,3,2,1,-2,20230512_145412_jpg.rf.9224a9f695664a7b936da6fb81af36c9.jpg
5_atss,fold_1,10,9,9,0,-1,20230512_151907_jpg.rf.8b3da1939d33aa65bfb85cb4ba33d685.jpg
5_atss,fold_1,1,1,1,0,0,20230512_151037_jpg.rf.57044d376bf29efab4142e6e059723d3.jpg
5_atss,fold_1,1,0,0,0,-1,20230512_151510-0-_jpg.rf.8fdff95c003658062d05e4285948dcbb.jpg
5_atss,fold_1,10,7,7,0,-3,20230512_151857_jpg.rf.d5917286f02e07a5305d7b858c6244ec.jpg
5_atss,fold_1,2,1,1,0,-1,IMG_20230512_151822_jpg.rf.cd5ee7cbb4e275377fc3e1ca11bd6a01.jpg
5_atss,fold_1,18,11,11,0,-7,20230512_152223_jpg.rf.7b4c9b6ebd76c6c1084f1453a97610d9.jpg
5_atss,fold_1,2,2,2,0,0,0015_jpg.rf.a767e21c0a0684765afe242b8052602a.jpg
5_atss,fold_1,2,1,1,0,-1,IMG_20230512_145027_jpg.rf.16a85daab3bfea64be4f44d4de24d8b4.jpg
5_atss,fold_1,2,0,0,0,-2,IMG_20230512_145337_jpg.rf.04c6c7ecd50fc9cd76f28da038eea12a.jpg
5_atss,fold_1,4,0,0,0,-4,20230512_145119_jpg.rf.f0411939c238246ea7d83cb97f4b291a.jpg
5_atss,fold_1,1,1,1,0,0,20230512_151618_jpg.rf.9cfdd92f0dd263ec71adc25e0966b10d.jpg
5_atss,fold_1,21,3,3,0,-18,20230512_150123_jpg.rf.ca38530fba79c2eea723776f3cb9701e.jpg
5_atss,fold_1,8,6,6,0,-2,IMG_20230512_151954_jpg.rf.1f74638dd64a022c7ddbc6b607ebb63f.jpg
5_atss,fold_1,2,1,1,0,-1,20230512_153358_jpg.rf.000b91eaf995cb7029bac19a97ae0eab.jpg
5_atss,fold_1,3,2,2,0,-1,0030_jpg.rf.92e747a4b264c12a0f5bd7b7fff47c97.jpg
5_atss,fold_1,2,1,1,0,-1,IMG_3838_JPG.rf.6259d7b6f664061333ba70518ffa409a.jpg
5_atss,fold_1,47,0,0,0,-47,20230512_153205_jpg.rf.a397edfe98870b927aac7d426225215e.jpg
5_atss,fold_1,3,1,1,0,-2,20230512_151421_jpg.rf.32f90f849ffd68e483c8af1c30cd3e88.jpg
5_atss,fold_1,4,0,0,0,-4,20230512_150228_jpg.rf.bdef78abc0510427f86904d310db4ffe.jpg
5_atss,fold_1,1,1,1,0,0,20230512_150729_jpg.rf.8d31acfa9500f54af8d12c1ddbddbd65.jpg
5_atss,fold_1,1,0,0,0,-1,IMG_4221_JPG.rf.c34edb7d27501d2bebad754740f2c36d.jpg
5_atss,fold_1,91,3,2,1,-88,20230512_153222_jpg.rf.02d4e5f1788464607b60d200b123696a.jpg
5_atss,fold_1,15,7,7,0,-8,20230512_152343_jpg.rf.b78ec2e1eb5a82ab22cb447b29e60a37.jpg
5_atss,fold_1,4,2,2,0,-2,20230512_145420_jpg.rf.63f8530ad3e9147d791de1d4a62e2845.jpg
5_atss,fold_1,3,2,2,0,-1,IMG_20230512_145129_jpg.rf.7c57fcf634dd12adb9bd6bfb5ab72307.jpg
5_atss,fold_1,3,2,2,0,-1,IMG_20230512_152950_jpg.rf.7b0419faa0e6c3e396abcf1d3db70ba2.jpg
5_atss,fold_1,7,2,2,0,-5,IMG_20230512_145458_jpg.rf.0869453997d27a12e193c3576f5be50f.jpg
5_atss,fold_1,2,0,0,0,-2,20230512_150320_jpg.rf.f00816162e753a50c482ccbb2723a8bb.jpg
5_atss,fold_1,2,0,0,0,-2,20230512_151501-0-_jpg.rf.ac937acab812f79dd846ec10e9eb794f.jpg
5_atss,fold_1,4,4,4,0,0,IMG_20230512_151857_jpg.rf.f3b0a248067ce9c5df43e8eb1b7b8f48.jpg
5_atss,fold_1,1,0,0,0,-1,20230512_151507_jpg.rf.83b7b0f7341f0c68f2169ab2e25d50af.jpg
5_atss,fold_1,4,3,3,0,-1,IMG_4098_JPG.rf.d05c322cd8fa2c89a0d093e8e91666a2.jpg
5_atss,fold_1,5,3,3,0,-2,IMG_20230512_144938_jpg.rf.61fbc5c9c8be89bcb4b1529921428829.jpg
5_atss,fold_1,9,6,6,0,-3,20230512_152348_jpg.rf.9a9f308e6e3d3ff1b666f67b5196d238.jpg
5_atss,fold_1,2,0,0,0,-2,20230512_151131_jpg.rf.62d78c2e91ff2133e0623bbd8de03bda.jpg
5_atss,fold_1,1,0,0,0,-1,IMG_20230512_150905_jpg.rf.498fdb5cdf1e78cfffa9005586c25d1b.jpg
5_atss,fold_1,1,1,1,0,0,20230512_145033_jpg.rf.5a4b7044f38311bf91bd61b2107f6208.jpg
5_atss,fold_1,2,1,0,1,-1,0002_jpg.rf.244244e268805e9279e2778f66f93c67.jpg
5_atss,fold_1,9,2,2,0,-7,IMG_20230512_145357_jpg.rf.65481eda27afaba20ecf66958bd1a415.jpg
5_atss,fold_1,40,0,0,0,-40,IMG_20230512_150251_jpg.rf.2318a91c9b0a0d0c74b337b923e9e074.jpg
5_atss,fold_1,4,1,1,0,-3,IMG_20230512_145134_jpg.rf.084766d54cd58d09cacfc92914a1a5c7.jpg
5_atss,fold_1,9,5,5,0,-4,IMG_20230512_152000_jpg.rf.af9cbaac286010743e1eabfda3ff16fd.jpg
5_atss,fold_1,3,1,0,1,-2,20230512_145302_jpg.rf.52f6bff4360f5a174eb1a21d91490e2f.jpg
5_atss,fold_1,4,1,1,0,-3,0013_jpg.rf.46c0cfad5d61b22f1717205aab02e682.jpg
5_atss,fold_1,13,6,5,1,-7,20230512_152958_jpg.rf.43cafd5762e96ebdaf2638b5e2e5ede5.jpg
5_atss,fold_1,1,0,0,0,-1,IMG_20230512_145002_jpg.rf.a16310bc3cbd1bce46d8e207260f6d2f.jpg
5_atss,fold_1,20,3,3,0,-17,20230512_150157_jpg.rf.8b6ad4dda7ad6b93ac57bd92f16dcdcd.jpg
5_atss,fold_1,6,2,1,1,-4,IMG_20230512_144908_684_jpg.rf.89a536225f1a283e12d5bb8970ee31cb.jpg
5_atss,fold_1,2,0,0,0,-2,20230512_151455_jpg.rf.eb853c4caca8daef122f54e54ffa44ce.jpg
5_atss,fold_1,3,2,2,0,-1,IMG_20230512_151214_jpg.rf.885e6d5e144fd3b97b6ab96da191a928.jpg
5_atss,fold_1,2,1,1,0,-1,20230512_151744_jpg.rf.b461e1fdf32cd5c1232cf11220a2bef4.jpg
5_atss,fold_1,7,4,3,1,-3,IMG_3868_JPG.rf.1770b3eda4aaec864f7cf0d27d04888b.jpg
5_atss,fold_1,7,3,3,0,-4,20230512_151845_jpg.rf.8dee8031c86ff6697d6d671e32b55f55.jpg
5_atss,fold_1,17,1,1,0,-16,20230512_150009_jpg.rf.5eaca93499ee2328bb5b204bc086fa0e.jpg
5_atss,fold_1,4,2,2,0,-2,IMG_4055_JPG.rf.a1d3f9eab20829bc4aab9b5d5b3db316.jpg
5_atss,fold_1,3,0,0,0,-3,20230512_145429_jpg.rf.df99f30a99cc1af30b8fe3054ff8d8af.jpg
5_atss,fold_1,3,1,1,0,-2,IMG_20230512_150829_549_jpg.rf.017095633151bc8caa1cad24d2d1f6bd.jpg
5_atss,fold_1,10,3,3,0,-7,0230512_150206_jpg.rf.e404633a283ca64c43725aeb3181ac5b.jpg
5_atss,fold_1,1,1,1,0,0,20230512_145044_jpg.rf.2dd273c7dcfa2783f4fc1f356c3e0fe1.jpg
5_atss,fold_1,18,4,4,0,-14,IMG_20230512_153031_jpg.rf.5fce0e233ead5453574fecd0d970a691.jpg
5_atss,fold_1,3,1,1,0,-2,IMG_4197_JPG.rf.f240386fc9d9d286399404892833ad93.jpg
5_atss,fold_1,2,0,0,0,-2,MG_20230512_145132_jpg.rf.f7010b407a0b401d833ccbcf5807b8c7.jpg
5_atss,fold_1,15,2,2,0,-13,20230512_151046_jpg.rf.8feca45b0b1694e2250d447c5e17a7e5.jpg
5_atss,fold_1,21,0,0,0,-21,20230512_153045_jpg.rf.8ee689d2bb2062ede3d6c1a97a93cb0b.jpg
5_atss,fold_1,2,1,1,0,-1,0024_jpg.rf.d7ace9e90a7a9b7f0bac8fa590936bec.jpg
5_atss,fold_1,1,0,0,0,-1,20230512_151452_jpg.rf.f764099c780fa1069a9d911e32493b58.jpg
5_atss,fold_1,2,2,2,0,0,0040_jpg.rf.510a2eea8b97902d00189cee85d647f2.jpg
5_atss,fold_1,14,1,1,0,-13,IMG_20230512_144941_jpg.rf.26b2e56c21b9d1f982031b1a6c82b0cf.jpg
5_atss,fold_1,6,2,2,0,-4,0230512_145304_jpg.rf.923a0f42aba114205181e2b5316865df.jpg
5_atss,fold_1,14,0,0,0,-14,20230512_153445_jpg.rf.a406add89c229073e8dc9da3e87a1125.jpg
5_atss,fold_1,11,1,0,1,-10,IMG_20230512_144945_690_jpg.rf.8f6c97bc8ba7a4170c6509fdaf6dcb51.jpg
5_atss,fold_1,3,0,0,0,-3,20230512_150255_jpg.rf.06d14e4c4625afe9d0a55233a17ba81c.jpg
5_atss,fold_1,1,1,1,0,0,20230512_145220_jpg.rf.9fc82d7b84c8883df1efc1dd7d51252b.jpg
5_atss,fold_1,8,0,0,0,-8,IMG_20230512_151110_jpg.rf.43411da66d27f6993f2c94b13a408a1c.jpg
5_atss,fold_1,1,0,0,0,-1,IMG_20230512_151305_326_jpg.rf.11e52599cf79be602d4d4480bd5cddda.jpg
5_atss,fold_1,2,0,0,0,-2,0230512_145048_jpg.rf.17eaa837f3d144d8a30470f44f61f75d.jpg
5_atss,fold_2,11,0,0,0,-11,20230512_152307_jpg.rf.5ed444510318293300b04fc766ce4222.jpg
5_atss,fold_2,1,0,0,0,-1,20230512_144953_jpg.rf.8283a702fcffd9d6223570436e1bf3fa.jpg
5_atss,fold_2,6,0,0,0,-6,20230512_145403_jpg.rf.8df05cb3790b7b04d25d1e08e98dc443.jpg
5_atss,fold_2,5,0,0,0,-5,20230512_145345_jpg.rf.04a7df632b86568b244790bc2612f409.jpg
5_atss,fold_2,1,0,0,0,-1,IMG_20230512_151805_jpg.rf.394aa2e3fd7a17a935ec0df1f3258c2f.jpg
5_atss,fold_2,1,0,0,0,-1,20230512_151500_jpg.rf.e32b98c8b02b5d583e07193899344442.jpg
5_atss,fold_2,2,0,0,0,-2,0230512_145313_jpg.rf.776dc937578790f899ad676b7712df5d.jpg
5_atss,fold_2,1,0,0,0,-1,20230512_145047_jpg.rf.95f8311e427ec6f1226783bcfa8aaeb0.jpg
5_atss,fold_2,17,0,0,0,-17,IMG_20230512_152302_jpg.rf.e72dde5d8164d8312cbc60cf674ac1cc.jpg
5_atss,fold_2,3,0,0,0,-3,20230512_145143_jpg.rf.e512219fc0a6a155cdc8d6e5375509c0.jpg
5_atss,fold_2,17,0,0,0,-17,20230512_153128_jpg.rf.ea6f913ebe278f58559dcfc65c663e1e.jpg
5_atss,fold_2,1,0,0,0,-1,20230512_151801_jpg.rf.2c3c8c1015e6fae6858f400374255844.jpg
5_atss,fold_2,2,0,0,0,-2,IMG_20230512_150319_jpg.rf.3ae187984f18f173dbb37b3a87dc2edc.jpg
5_atss,fold_2,2,0,0,0,-2,IMG_20230512_145035_jpg.rf.e406d6ea6e2142bf078dc5712097970d.jpg
5_atss,fold_2,11,0,0,0,-11,20230512_151045_jpg.rf.a6671c33872e0aa76aa195da177cfb2d.jpg
5_atss,fold_2,6,0,0,0,-6,20230512_153159_jpg.rf.d07176029cb6d818c3ec89f10bf105eb.jpg
5_atss,fold_2,2,0,0,0,-2,20230512_145258_jpg.rf.36afe6d426851a363b2a6a7d0c059a06.jpg
5_atss,fold_2,9,0,0,0,-9,0230512_145016_jpg.rf.c06fc10372ac7c1831d2d51452a8b3e8.jpg
5_atss,fold_2,5,0,0,0,-5,20230512_151002_jpg.rf.948c61535288e6ba60980bb8fd2b67a6.jpg
5_atss,fold_2,5,0,0,0,-5,IMG_20230512_150036_jpg.rf.6e167fde12f866a555cb292420cc966c.jpg
5_atss,fold_2,21,0,0,0,-21,IMG_20230512_150108_jpg.rf.010507bacbd8da808ace5e119e09b182.jpg
5_atss,fold_2,1,0,0,0,-1,IMG_20230512_151210_354_jpg.rf.8bd99e3d531a171119a6ce1f73298053.jpg
5_atss,fold_2,16,0,0,0,-16,0058_jpg.rf.0a179a6a2aa1a22cf6d0c2490fc3cca2.jpg
5_atss,fold_2,2,0,0,0,-2,20230512_150805_jpg.rf.c936fd2cb76b51c90f6b1886c1d67b07.jpg
5_atss,fold_2,38,0,0,0,-38,0512_150128_jpg.rf.2af323c722a16ccc0c5aa34b5e501664.jpg
5_atss,fold_2,7,0,0,0,-7,20230512_150107_jpg.rf.5e11723e84aa6da5755cf3c63cf34d7e.jpg
5_atss,fold_2,5,0,0,0,-5,IMG_20230512_152210_460_jpg.rf.ab8278e1877e151e4ae555c6237762a4.jpg
5_atss,fold_2,1,0,0,0,-1,IMG_20230512_161352_jpg.rf.55bade867ee284f39237788ac06b0acc.jpg
5_atss,fold_2,1,0,0,0,-1,IMG_3833_JPG.rf.abe8bed2e2a60f385c89c035ed2e7754.jpg
5_atss,fold_2,4,0,0,0,-4,20230512_145400_jpg.rf.487d472b7875668199199822410b27fa.jpg
5_atss,fold_2,3,0,0,0,-3,0006_jpg.rf.4286dc69c06dcdbaf0df817343256a21.jpg
5_atss,fold_2,4,0,0,0,-4,20230512_151752_jpg.rf.c6abd13d3824e552c45d2ae43cd156c3.jpg
5_atss,fold_2,6,0,0,0,-6,20230512_145358_jpg.rf.42f74f37b3baefb9f8cb08628d322a69.jpg
5_atss,fold_2,1,0,0,0,-1,0230512_145420_jpg.rf.e077901cc39df12e7031754a04b4216f.jpg
5_atss,fold_2,2,0,0,0,-2,20230512_151441_jpg.rf.01b614d64de666a58fed8b8feea9004a.jpg
5_atss,fold_2,12,0,0,0,-12,20230512_153315_jpg.rf.7906c060598957a1e622c50902191cc1.jpg
5_atss,fold_2,4,0,0,0,-4,0025_jpg.rf.f5d46a7f5f498531cada47eed608a3e7.jpg
5_atss,fold_2,6,0,0,0,-6,IMG_3832_JPG.rf.4a27d40741e9e24a57b4d4409e5bf699.jpg
5_atss,fold_2,4,0,0,0,-4,IMG_20230512_145422_423_jpg.rf.a2f634b682eede423e27173c65e298dc.jpg
5_atss,fold_2,3,0,0,0,-3,IMG_20230512_145034_jpg.rf.b7070d4f3b8615f07e606e417094950b.jpg
5_atss,fold_2,6,0,0,0,-6,20230512_151810-0-_jpg.rf.5bab122233efd5d6e060c2de01ae9475.jpg
5_atss,fold_2,1,0,0,0,-1,20230512_151649_jpg.rf.62f6a7ef7962197e1933352c3cf07e1d.jpg
5_atss,fold_2,5,0,0,0,-5,20230512_151315_jpg.rf.7d9aa1fa6aeea9c557900122bb89076d.jpg
5_atss,fold_2,1,0,0,0,-1,230512_150043_jpg.rf.997b92cbbb33f969daf86ff1c0a48495.jpg
5_atss,fold_2,18,0,0,0,-18,IMG_4215_JPG.rf.f586481a5ed49d1952135b51b94a258f.jpg
5_atss,fold_2,15,0,0,0,-15,IMG_20230512_152253_596_jpg.rf.e1455dadb47781b4e95ce4f0479c4643.jpg
5_atss,fold_2,18,0,0,0,-18,IMG_20230512_150056_181_jpg.rf.337f1b254575b10ba95ca7a5b1e7e5aa.jpg
5_atss,fold_2,13,0,0,0,-13,20230512_150029_jpg.rf.29ca99ad8a2b5956fdc7e21d1601c79f.jpg
5_atss,fold_2,1,0,0,0,-1,20230512_145239_jpg.rf.0d14eff09fc5186a9eccb0c477759e6b.jpg
5_atss,fold_2,20,0,0,0,-20,20230512_153255_jpg.rf.72d8abd35f45fdaa52da9b99aa3daf48.jpg
5_atss,fold_2,24,0,0,0,-24,0106_jpg.rf.ea3d3d53b74e632d3112cfd4b25da4de.jpg
5_atss,fold_2,2,0,0,0,-2,0230512_145006_jpg.rf.eb1d6247f79c4ed2e093c5fcaf73e407.jpg
5_atss,fold_2,4,0,0,0,-4,IMG_20230512_145316_jpg.rf.250aaba6ef305223c5dec100c738233c.jpg
5_atss,fold_2,11,0,0,0,-11,20230512_145205_jpg.rf.8be964bf86f6306b95645b3e8b4177aa.jpg
5_atss,fold_2,2,0,0,0,-2,20230512_145125_jpg.rf.c0d2af11ce72a4bb0c259d23b2700862.jpg
5_atss,fold_2,5,0,0,0,-5,20230512_151810_jpg.rf.b4a391d3bd61afb0cff6f47e49a1736e.jpg
5_atss,fold_2,8,0,0,0,-8,IMG_20230512_151240_jpg.rf.21dc1955fc3611fdbde01fb2d3db23e3.jpg
5_atss,fold_2,1,0,0,0,-1,IMG_20230512_151233_jpg.rf.75f4efffa9f2c8ddf8c60930c30caa50.jpg
5_atss,fold_2,2,0,0,0,-2,20230512_145245_jpg.rf.23b906c05c2822f1a0f5a97d26511473.jpg
5_atss,fold_2,5,0,0,0,-5,20230512_145335-0-_jpg.rf.e11b1b03b49524f5174370062e01b4f7.jpg
5_atss,fold_2,25,0,0,0,-25,IMG_20230512_150137_686_jpg.rf.87a512bdf05b800f446ab29f4925d265.jpg
5_atss,fold_2,2,0,0,0,-2,IMG_3837_JPG.rf.6f942021a4fd687376ae5b9b4d970b40.jpg
5_atss,fold_2,17,0,0,0,-17,20230512_144951_jpg.rf.9ab67b54e372e2d5fcc0ba78e49718cf.jpg
5_atss,fold_2,1,0,0,0,-1,20230512_153216_jpg.rf.eb0c9677e99c15c65103ae3a612d52d8.jpg
5_atss,fold_2,16,0,0,0,-16,20230512_144957_jpg.rf.edf44bd7d8feadfc28a3389bd946b805.jpg
5_atss,fold_2,3,0,0,0,-3,IMG_20230512_145032_jpg.rf.d9c71446c077191b543ca5691d58f022.jpg
5_atss,fold_2,40,0,0,0,-40,20230512_150324_jpg.rf.3ff2950eb65ac5c31086e53bc4e56ed5.jpg
5_atss,fold_2,1,0,0,0,-1,20230512_151651-0-_jpg.rf.b824f35100b3f7edb1d2a6095c5dfaa2.jpg
5_atss,fold_2,23,0,0,0,-23,20230512_153141_jpg.rf.613e5b5025183f2520937d9596cdd56a.jpg
5_atss,fold_2,1,0,0,0,-1,IMG_3846_JPG.rf.6ac47067db06f4b0377dc758d0af3e6e.jpg
5_atss,fold_2,13,0,0,0,-13,IMG_20230512_145059_jpg.rf.ca7ed19e9dee72856eedaac64c143c22.jpg
5_atss,fold_2,7,0,0,0,-7,20230512_150118_jpg.rf.995a1787a6672b3228e543351c485407.jpg
5_atss,fold_2,29,0,0,0,-29,20230512_150102_jpg.rf.992c8db88e8e711f38b63308f2f2ceb0.jpg
5_atss,fold_2,1,0,0,0,-1,IMG_20230512_153419_jpg.rf.9224e0b2559139217bdba3afdc04378c.jpg
5_atss,fold_2,13,0,0,0,-13,20230512_153022_jpg.rf.863e7532bc45f9f8755c15b6a24dda83.jpg
5_atss,fold_2,59,0,0,0,-59,20230512_153358_jpg.rf.97d1a8ba190dcaf1d26753099c80dac6.jpg
5_atss,fold_2,3,0,0,0,-3,20230512_145406_jpg.rf.b6c696ca3ffd7789f8655f344c1ccd98.jpg
5_atss,fold_2,3,0,0,0,-3,IMG_4387_JPG.rf.3205816644d251fe12961d17cfe8b818.jpg
5_atss,fold_2,10,0,0,0,-10,20230512_150020_jpg.rf.6a0dfe027260521f3168f7985b48272f.jpg
5_atss,fold_2,1,0,0,0,-1,0011_jpg.rf.ef78555de2ee0947227176b9c9b4319b.jpg
5_atss,fold_2,10,0,0,0,-10,20230512_150229_jpg.rf.db8357bef31fe081f8e5059cfd0c9fb4.jpg
5_atss,fold_2,2,0,0,0,-2,20230512_151743_jpg.rf.6203480990e7a828e8c8e3f743a0053b.jpg
5_atss,fold_2,6,0,0,0,-6,20230512_145157_jpg.rf.459cfae5642460c5c30e67dd372cadcc.jpg
5_atss,fold_2,2,0,0,0,-2,20230512_145122_jpg.rf.f302914da7ccad75fb2edfd9b9ec0efd.jpg
5_atss,fold_2,13,0,0,0,-13,IMG_20230512_145118_jpg.rf.d1ef05f6a7704db2945116a966e5bd70.jpg
5_atss,fold_2,6,0,0,0,-6,20230512_153037_jpg.rf.b93a210f722c0d5464f223e099ec3dce.jpg
5_atss,fold_2,3,0,0,0,-3,20230512_150758_jpg.rf.8a907872529b09fec41c34fbc4a3c85b.jpg
5_atss,fold_2,3,0,0,0,-3,20230512_145126_jpg.rf.76790ff28fba433b2868c3becc799204.jpg
5_atss,fold_2,111,0,0,0,-111,0105_jpg.rf.21f79c1f08ac725f3eafce77e52091e8.jpg
5_atss,fold_2,3,0,0,0,-3,20230512_145438_jpg.rf.c1caee1e341cc9a711b6cf640a2a8509.jpg
5_atss,fold_2,4,0,0,0,-4,IMG_20230512_145346_jpg.rf.515d73a420cc0607f0a677c3ec22ea14.jpg
5_atss,fold_2,4,0,0,0,-4,20230512_145144_jpg.rf.f15cd7a8e403d35924c9a9953ceb0ed2.jpg
5_atss,fold_2,11,0,0,0,-11,20230512_150030_jpg.rf.6f76526d3409cadbfe960092b45d99ff.jpg
5_atss,fold_2,14,0,0,0,-14,20230512_151050_jpg.rf.bb1678e3a1546f2d4b401bf96df99936.jpg
5_atss,fold_2,1,0,0,0,-1,230512_150038_jpg.rf.9ebbdcccc679c75c9dceb5b2e686d104.jpg
5_atss,fold_2,8,0,0,0,-8,20230512_151748_jpg.rf.fdcf266c293fa03554fecbec46885bcf.jpg
5_atss,fold_2,4,0,0,0,-4,20230512_145131_jpg.rf.05acfd31fb743167b9795df743ef22b4.jpg
5_atss,fold_2,5,0,0,0,-5,IMG_20230512_150030_jpg.rf.eb7e32ee807e4ad675ec4b1f485d1194.jpg
5_atss,fold_2,3,0,0,0,-3,20230512_151026-copia-1-_jpg.rf.25048c6b13b3d64d8a468f548967f5d4.jpg
5_atss,fold_2,1,0,0,0,-1,IMG_4042_JPG.rf.3b0722af6ff7f5abfc5b80296e0e51a4.jpg
5_atss,fold_2,1,0,0,0,-1,0230512_145106_jpg.rf.f11d7922f45bb3e9056a0274e877bd6f.jpg
5_atss,fold_2,4,0,0,0,-4,20230512_145152_jpg.rf.c078905785bf4f39e87ab4dbfeb67b79.jpg
5_atss,fold_2,2,0,0,0,-2,IMG_20230512_151751_jpg.rf.86507ee6252cc7d41c2fa99c5f84bbc9.jpg
5_atss,fold_2,8,0,0,0,-8,20230512_145155_jpg.rf.483609701afa99b05a432395c2a1dc59.jpg
5_atss,fold_2,1,0,0,0,-1,20230512_151501_jpg.rf.16af334ffaad29022c4afa8eda4bbb5b.jpg
5_atss,fold_2,4,0,0,0,-4,20230512_150208_jpg.rf.5e82906cb9373103e9e98ed6a4338a1e.jpg
5_atss,fold_2,2,0,0,0,-2,20230512_151704_jpg.rf.fd83532c35f591e140a380aa12cd8530.jpg
5_atss,fold_2,4,0,0,0,-4,0230512_145310_jpg.rf.58da36115ae6f33dda807758d87657c9.jpg
5_atss,fold_2,8,0,0,0,-8,20230512_145134_jpg.rf.5d0f231790df81ba4a0051d2b6752135.jpg
5_atss,fold_2,4,0,0,0,-4,20230512_150055_jpg.rf.4cc48b2b47552b6368afa5d3491ee008.jpg
5_atss,fold_2,19,0,0,0,-19,IMG_20230512_150053_jpg.rf.0df30dcd2353d3b9fb7a7df012361881.jpg
5_atss,fold_2,10,0,0,0,-10,20230512_152215_jpg.rf.a4d9425dfde22fcd54004debebaf80ce.jpg
5_atss,fold_2,6,0,0,0,-6,20230512_145408_jpg.rf.3d8eeed18535cb95a6e8d1931052f34c.jpg
5_atss,fold_2,8,0,0,0,-8,20230512_152941_jpg.rf.a2201e1690ef639f51bfe7ce95cec221.jpg
5_atss,fold_2,3,0,0,0,-3,20230512_151306_jpg.rf.cfe45d7efb4a4c29beccc71f36871b48.jpg
5_atss,fold_2,1,0,0,0,-1,IMG_20230512_151234_jpg.rf.b19f52712286d372282ee90e4f3a8c24.jpg
5_atss,fold_2,6,0,0,0,-6,IMG_20230512_145136_jpg.rf.a268e723779ce1a1a30472767d3788c0.jpg
5_atss,fold_2,4,0,0,0,-4,20230512_145405_jpg.rf.583b8e88a9d9542c857773d30f074199.jpg
5_atss,fold_2,1,0,0,0,-1,20230512_151808_jpg.rf.88493c8cb7d1ddd67bcbdd48f290be76.jpg
5_atss,fold_2,2,0,0,0,-2,IMG_20230512_151255_jpg.rf.085333bc247d4e08cfef9873bd98d250.jpg
5_atss,fold_2,14,0,0,0,-14,20230512_145200_jpg.rf.a6508f9b4a5dc4d2e37a648f6f58cad7.jpg
5_atss,fold_2,5,0,0,0,-5,IMG_20230512_150153_jpg.rf.21455b2b84261cf0a3ce6dd9147d31c2.jpg
5_atss,fold_2,9,0,0,0,-9,0230512_145438_jpg.rf.8d0faa32dac3b0a8d27ae1876a0db052.jpg
5_atss,fold_2,1,0,0,0,-1,20230512_145023_jpg.rf.b2955fd5ab715016af10f2efa47feb0c.jpg
5_atss,fold_2,4,0,0,0,-4,IMG_3986_JPG.rf.5f1e1a04a780c294057b3aeb49ce1327.jpg
5_atss,fold_2,2,0,0,0,-2,20230512_151639_jpg.rf.2e5a4b318c40ab84158ba5ef4ab1ae75.jpg
5_atss,fold_2,2,0,0,0,-2,0010_jpg.rf.5d4cbd2e216fb4306b05f3a979d801a6.jpg
5_atss,fold_2,61,0,0,0,-61,20230512_153154_jpg.rf.8e0789e24006a0265466d9bf9fdd2d5d.jpg
5_atss,fold_2,3,0,0,0,-3,IMG_3866_JPG.rf.9976a97a1422b88843b54c8cfe8f8cef.jpg
5_atss,fold_2,2,0,0,0,-2,20230512_145123_jpg.rf.7c684cfce69e0678a5f37aceb8e58703.jpg
5_atss,fold_2,2,0,0,0,-2,20230512_151634_jpg.rf.4af8920897c95556710f5d66b8848580.jpg
5_atss,fold_2,1,0,0,0,-1,20230512_151253_jpg.rf.b5e989a50a5c70e0f8911ebb246c4bd9.jpg
5_atss,fold_2,6,0,0,0,-6,20230512_153108_jpg.rf.d3d27e961d217f62f45c29eec6d6c2ed.jpg
5_atss,fold_2,31,0,0,0,-31,0512_150045_jpg.rf.097128a0f4dc3739d053c017dd7fd643.jpg
5_atss,fold_2,2,0,0,0,-2,20230512_145217_jpg.rf.8b4c9e235361be21ec1ef0addc99dc7a.jpg
5_atss,fold_2,13,0,0,0,-13,20230512_153057_jpg.rf.4d29da76e8c70adbe3707715c3333882.jpg
5_atss,fold_2,1,0,0,0,-1,20230512_145040_jpg.rf.c652c89ab18a37e582fa39fe9f7abdc6.jpg
5_atss,fold_2,10,0,0,0,-10,IMG_20230512_145100_jpg.rf.e7b035adf2c640d6a600846236b01b19.jpg
5_atss,fold_2,1,0,0,0,-1,20230512_151458_jpg.rf.44033d4e267440e0172a403e2c9b2c2f.jpg
5_atss,fold_2,1,0,0,0,-1,IMG_4039_JPG.rf.3f78f739ca76cba4136559eee15bdd94.jpg
5_atss,fold_2,15,0,0,0,-15,IMG_20230512_150039_1_jpg.rf.ffd13d7440dc972309a1f58f33063648.jpg
5_atss,fold_2,2,0,0,0,-2,0230512_145340_jpg.rf.beb3f9c554344398d6f6007f748edd63.jpg
5_atss,fold_2,8,0,0,0,-8,IMG_4188_JPG.rf.2b1e9cc2bc82b3d05861cab7bdbfb235.jpg
5_atss,fold_2,4,0,0,0,-4,IMG_20230512_145231_804_jpg.rf.35d239e095afd813f22e568b66281c10.jpg
5_atss,fold_2,8,0,0,0,-8,20230512_152333_jpg.rf.901f79538b04a75cfd995edb99dba147.jpg
5_atss,fold_2,1,0,0,0,-1,IMG_20230512_151122_744_jpg.rf.0203c58a683248c6ba3e7ca2baa5ee22.jpg
5_atss,fold_2,9,0,0,0,-9,20230512_152403_jpg.rf.21f06ac205b62518bb4ac1c1d05a2bce.jpg
5_atss,fold_2,21,0,0,0,-21,20230512_150012_jpg.rf.5bc4d2f31a26aab541fdbeb4a437985a.jpg
5_atss,fold_2,8,0,0,0,-8,20230512_150920_jpg.rf.5224cc7eab4f53f93bdec2d81bba5f0e.jpg
5_atss,fold_2,7,0,0,0,-7,20230512_145404_jpg.rf.91d448b69a976705a98b28002a84c842.jpg
5_atss,fold_2,1,0,0,0,-1,0003_jpg.rf.bf7cde9cd5a6dc0cc2ee160ef4121efe.jpg
5_atss,fold_2,7,0,0,0,-7,IMG_20230512_145054_jpg.rf.b241c4cdeabfff0793bff4970cd95da2.jpg
5_atss,fold_2,1,0,0,0,-1,20230512_145032-0-_jpg.rf.dc8b664d3fb1425d1783c11f8bcb0068.jpg
5_atss,fold_2,2,0,0,0,-2,20230512_145316-0-_jpg.rf.6c2d352bf056f852f59df415c04c3b73.jpg
5_atss,fold_2,6,0,0,0,-6,IMG_4037_JPG.rf.c2e2f236825c2dff84efbeb902eeb29d.jpg
5_atss,fold_2,2,0,0,0,-2,IMG_3916_JPG.rf.250aee83d82e083052118d5322edb81e.jpg
5_atss,fold_2,3,0,0,0,-3,20230512_150045_jpg.rf.56868f65f25cf730ad8340c6a67caa9b.jpg
5_atss,fold_3,3,0,0,0,-3,20230512_145409_jpg.rf.d09685c8c603cbe9e1a20305c3a191ef.jpg
5_atss,fold_3,6,1,1,0,-5,20230512_150944_jpg.rf.eaecb1ecef20585ed9293d182792536f.jpg
5_atss,fold_3,9,4,3,1,-5,IMG_20230512_152206_244_jpg.rf.39d59820f61b06056f549a4d3442ac7b.jpg
5_atss,fold_3,5,3,3,0,-2,20230512_151749_jpg.rf.05c1da9e8ad61457f7836f667088adf9.jpg
5_atss,fold_3,5,3,3,0,-2,0004_jpg.rf.851243b8e41e3a1bd722c5b177c9bf93.jpg
5_atss,fold_3,1,0,0,0,-1,20230512_151806_jpg.rf.26383849e96ac2c96291e0c7409e44d2.jpg
5_atss,fold_3,1,1,1,0,0,0012_jpg.rf.48d09ce5c069b09d1c9d6cf497ff9a97.jpg
5_atss,fold_3,5,3,3,0,-2,20230512_151026_jpg.rf.d30352bb19624c98cae22d002974b61a.jpg
5_atss,fold_3,9,5,5,0,-4,20230512_151855_jpg.rf.e3fa630bb03de4788e09724f320ec036.jpg
5_atss,fold_3,2,0,0,0,-2,20230512_145316_jpg.rf.496d4ed779e1450c242495fa46e36987.jpg
5_atss,fold_3,4,2,2,0,-2,20230512_153116_jpg.rf.cdd42e1383bc6c130d47f65e21bcc4e6.jpg
5_atss,fold_3,5,2,2,0,-3,20230512_145437_jpg.rf.0909c9ccb332356410c1a52743b7c7bf.jpg
5_atss,fold_3,4,0,0,0,-4,20230512_153139_jpg.rf.c012da59f33e990f927df57e0a6a7f6c.jpg
5_atss,fold_3,3,1,1,0,-2,0031_jpg.rf.895d9050f9dc5640677a308629b20ad8.jpg
5_atss,fold_3,21,1,1,0,-20,IMG_20230512_152944_jpg.rf.cda9c2160b066ef7e220cf96a991f737.jpg
5_atss,fold_3,8,1,1,0,-7,IMG_4187_JPG.rf.f301f6508b0e93d82808ac4e2f80dab0.jpg
5_atss,fold_3,1,0,0,0,-1,230512_150212_jpg.rf.3e63a63731d99962cf04897093c61c0e.jpg
5_atss,fold_3,3,0,0,0,-3,20230512_150056_jpg.rf.c9ae963578e609418dc9e533e5a26adf.jpg
5_atss,fold_3,7,4,4,0,-3,IMG_20230512_153337_765_jpg.rf.f1a04e6d77f25605da1438e3829fd581.jpg
5_atss,fold_3,10,1,0,1,-9,0200_jpg.rf.72e8b4790e76291a0c9e6877dd61eef5.jpg
5_atss,fold_3,4,1,1,0,-3,IMG_20230512_151438_jpg.rf.ff747d9ae06e7829a2e860bb43baf295.jpg
5_atss,fold_3,1,1,1,0,0,IMG_20230512_145007_395_jpg.rf.b8b6b70654f786328e3fe2f85e949a6f.jpg
5_atss,fold_3,1,0,0,0,-1,0014_jpg.rf.edb35667570fa3a23afcb19d179ea59d.jpg
5_atss,fold_3,2,0,0,0,-2,20230512_151640_jpg.rf.4b7574d0b6f05544e5a43a5be4589a6f.jpg
5_atss,fold_3,1,1,1,0,0,20230512_151616_jpg.rf.73b54fe227f3ac8f3da41b5fba2b170a.jpg
5_atss,fold_3,43,0,0,0,-43,IMG_20230512_150354_jpg.rf.1ed97bfbf8670ca6750d76619dac51ef.jpg
5_atss,fold_3,1,0,0,0,-1,20230512_145009_jpg.rf.9f8f641e028bed4b2706301af0fb27ee.jpg
5_atss,fold_3,3,1,1,0,-2,20230512_152204_jpg.rf.b0b665cf50c6b54094f4fe1a4a01ecce.jpg
5_atss,fold_3,4,2,2,0,-2,20230512_145348-0-_jpg.rf.a616aa6a3ced888f83d2044dbd9ec726.jpg
5_atss,fold_3,9,4,4,0,-5,IMG_20230512_145301_jpg.rf.71b506460c51cef84cbbfdc651695e13.jpg
5_atss,fold_3,9,1,1,0,-8,20230512_145156_jpg.rf.85e178453eba594f6ce65cebf40de3fb.jpg
5_atss,fold_3,3,0,0,0,-3,20230512_150025_jpg.rf.0bef8a6273605277f912993bceb28c2c.jpg
5_atss,fold_3,4,0,0,0,-4,20230512_145130_jpg.rf.51678843234545aa7f95a07feefbe048.jpg
5_atss,fold_3,1,0,0,0,-1,0230512_145124_jpg.rf.24447141d50bf7957914c622cb19bbc6.jpg
5_atss,fold_3,1,1,1,0,0,20230512_151656_jpg.rf.581bfb229dea559f67a2aa2ac578db62.jpg
5_atss,fold_3,2,0,0,0,-2,IMG_20230512_145127_jpg.rf.d2db7f78af8d459d1ccab501da8c6fcd.jpg
5_atss,fold_3,3,2,2,0,-1,IMG_20230512_145110_jpg.rf.d1d01bf0ca4a3344a6bf7d4b94e63c96.jpg
5_atss,fold_3,2,0,0,0,-2,230512_150052_jpg.rf.495fe344c6875f2116d1ef5a0bd92daf.jpg
5_atss,fold_3,3,0,0,0,-3,IMG_3934_JPG.rf.1b359ac7d45ac33c7623f668cb9731d0.jpg
5_atss,fold_3,8,0,0,0,-8,IMG_20230512_150231_jpg.rf.764af7adf374d2dee3739d99e3a0d56a.jpg
5_atss,fold_3,7,1,1,0,-6,IMG_20230512_145110_246_jpg.rf.153877ddf43d3d76a37f64fb0aa5f617.jpg
5_atss,fold_3,15,1,1,0,-14,20230512_150106_jpg.rf.3025eeb24b28ae43f2ad27872636bbbf.jpg
5_atss,fold_3,1,0,0,0,-1,20230512_151113_jpg.rf.b6cd4222d666bbace543a8c77d865f35.jpg
5_atss,fold_3,2,2,2,0,0,20230512_151756_jpg.rf.6e05ac20e235330456b0b0d06c00138c.jpg
5_atss,fold_3,1,1,1,0,0,20230512_151035_jpg.rf.103e19cb70bac5049a33c63e773d1a79.jpg
5_atss,fold_3,6,2,2,0,-4,230512_145340_jpg.rf.9fdd58e2d10ba1375e278a07b95c337c.jpg
5_atss,fold_3,12,0,0,0,-12,20230512_145203_jpg.rf.35ba545e195d0af402a018f91a322dab.jpg
5_atss,fold_3,11,1,1,0,-10,IMG_20230512_153029_jpg.rf.80e951915c88eafeea885e5fb27b45e8.jpg
5_atss,fold_3,2,0,0,0,-2,0230512_145130_jpg.rf.faddf96f4d26a63f9284354dd447afd4.jpg
5_atss,fold_3,13,1,1,0,-12,20230512_145238_jpg.rf.b85535f8851b826fe2e42e26692f5635.jpg
5_atss,fold_3,9,1,0,1,-8,20230512_153316_jpg.rf.24b77c461257ba1bd947e731de450708.jpg
5_atss,fold_3,27,0,0,0,-27,20230512_150125_jpg.rf.d10c3232f4247c5514953cf92c7083c5.jpg
5_atss,fold_3,3,1,1,0,-2,20230512_151438_jpg.rf.9d2b9be770df6ec4ba79d984fe00b8b4.jpg
5_atss,fold_3,50,0,0,0,-50,0512_150210_jpg.rf.a172e8c839e22e596b7db396b08d63d1.jpg
5_atss,fold_3,17,3,3,0,-14,20230512_150321_jpg.rf.a5e551cbda2cf857d53bcbd4d60b92c5.jpg
5_atss,fold_3,1,0,0,0,-1,20230512_151213_jpg.rf.419a445cd8b3392ce737e6b1c6cb0d88.jpg
5_atss,fold_3,7,4,4,0,-3,IMG_20230512_152958_116_jpg.rf.12bbdfc4e9ae5914029f9e97d0fcd224.jpg
5_atss,fold_3,8,1,1,0,-7,0230512_145231_jpg.rf.f02c6f94b7286a6b59a1c8b2423f5ba8.jpg
5_atss,fold_3,20,1,1,0,-19,20230512_152944_jpg.rf.3c5b2edc21ab50f9893441607f43f699.jpg
5_atss,fold_3,10,5,5,0,-5,20230512_152328_jpg.rf.9afc7b5536cb56c41fedd9c22fd78fe4.jpg
5_atss,fold_3,1,1,1,0,0,20230512_151448_jpg.rf.83cf709cf0b2547d212be3a377779599.jpg
5_atss,fold_3,4,0,0,0,-4,20230512_145151_jpg.rf.1c7cdb8ed83d156aba9a1e8e94becd21.jpg
5_atss,fold_3,2,1,1,0,-1,0230512_145009_jpg.rf.027a2f31eb1269ab45f13bf35444b96c.jpg
5_atss,fold_3,24,9,9,0,-15,20230512_153310_jpg.rf.4207c4421e3464536cb4bd47453058d2.jpg
5_atss,fold_3,1,0,0,0,-1,20230512_145103_jpg.rf.62604473c5e590c815e5d908b8d354a0.jpg
5_atss,fold_3,2,0,0,0,-2,IMG_20230512_145351_839_jpg.rf.676aa37e025296713a6e39f90d91aa3b.jpg
5_atss,fold_3,4,3,3,0,-1,20230512_152301-0-_jpg.rf.1afa46256fa26afe6cd36253d167878e.jpg
5_atss,fold_3,5,2,2,0,-3,IMG_20230512_145310_230_jpg.rf.a3b7f15bfc867ece22ea5c289b0d4b74.jpg
5_atss,fold_3,12,1,1,0,-11,20230512_150153_jpg.rf.330fb945dbe64ad88c012d6c611ab4e9.jpg
5_atss,fold_3,9,6,6,0,-3,20230512_152315_jpg.rf.e5aebd25c65f9475f8256b49c71ff68a.jpg
5_atss,fold_3,1,0,0,0,-1,20230512_151304_jpg.rf.820f387501b1325203f72b034ae1ff0a.jpg
5_atss,fold_3,5,0,0,0,-5,IMG_3842_JPG.rf.4a4a46be5bc0098c5e1314e61ddc11de.jpg
5_atss,fold_3,1,1,1,0,0,20230512_145219_jpg.rf.0755ac5ed17a2444b92a33aaea06d7a3.jpg
5_atss,fold_3,16,2,2,0,-14,20230512_150148_jpg.rf.0d501896a72c41b99bfcd956b0436fb3.jpg
5_atss,fold_3,5,2,2,0,-3,IMG_20230512_145011_556_jpg.rf.00fbb204260504401d5042a1e1cd5b8d.jpg
5_atss,fold_3,1,0,0,0,-1,IMG_20230512_145336_167_jpg.rf.b667487bd924e740ebac74f50e1e463d.jpg
5_atss,fold_3,11,3,3,0,-8,20230512_150201_jpg.rf.c4784605e4e8290a39a5a8546b8daf34.jpg
5_atss,fold_3,14,10,10,0,-4,0056_jpg.rf.de05042e164d7742536e2b31f92d3670.jpg
5_atss,fold_3,1,1,1,0,0,0034_jpg.rf.32acf93f344bd74d2605e49ed3db9e0e.jpg
5_atss,fold_3,9,2,1,1,-7,0230512_150100_jpg.rf.bac5d1418079223e898fdae8b34c9b0d.jpg
5_atss,fold_3,2,0,0,0,-2,IMG_3983_JPG.rf.9148c9d4463c4afaf34c762d4c53ead6.jpg
5_atss,fold_3,13,1,1,0,-12,20230512_150105_jpg.rf.9bb4f73900fecf656a093f8eac337860.jpg
5_atss,fold_3,4,0,0,0,-4,20230512_145124_jpg.rf.b61b648c127689b8eeb3a43495c3df3e.jpg
5_atss,fold_3,16,11,11,0,-5,IMG_20230512_152416_jpg.rf.924528612413e225894a24fc2dec0a36.jpg
5_atss,fold_3,1,1,1,0,0,20230512_152207_jpg.rf.61fece27ba33f3c6fc069a211008dab5.jpg
5_atss,fold_3,23,1,0,1,-22,_20230512_150225_jpg.rf.9718d11f60b7e396ae6928ae7f14c90b.jpg
5_atss,fold_3,19,0,0,0,-19,20230512_150239_jpg.rf.e13a84d4d7ec0f7e070c7ccb4fb737b3.jpg
5_atss,fold_3,4,2,2,0,-2,20230512_152346_jpg.rf.a8c2948d3e9aa465d912f3465556eb90.jpg
5_atss,fold_3,6,3,3,0,-3,20230512_150818_jpg.rf.58c0f3208c48520ddc0588916be6397c.jpg
5_atss,fold_3,1,1,1,0,0,IMG_20230512_150843_jpg.rf.3c9dacc8aa8ae98bcec98a6b950df819.jpg
5_atss,fold_3,1,0,0,0,-1,IMG_3839_JPG.rf.2b8f533bc337b2b41e4aa08d82c895f0.jpg
5_atss,fold_3,13,0,0,0,-13,IMG_20230512_150401_jpg.rf.0f4c64f7dd592050ecd9a38797714f40.jpg
5_atss,fold_3,4,0,0,0,-4,0008_jpg.rf.3fe730c41fdc7b3704f6885ae667338f.jpg
5_atss,fold_3,7,3,3,0,-4,IMG_20230512_150236_jpg.rf.b127381341df0777f6b90c3d6193ab5f.jpg
5_atss,fold_3,13,0,0,0,-13,20230512_153104_jpg.rf.e6b0a044d9369e49df9c83ed02c5f924.jpg
5_atss,fold_3,1,0,0,0,-1,20230512_151446_jpg.rf.e46015a969282d2959dba6262188eb21.jpg
5_atss,fold_3,1,0,0,0,-1,IMG_4046_JPG.rf.5365cbd02513c386b454d943407c56e0.jpg
5_atss,fold_3,7,1,1,0,-6,IMG_20230512_150841_155_jpg.rf.8f074ff9aa19c6cf12ce37edaace8c77.jpg
5_atss,fold_3,3,0,0,0,-3,20230512_145122-0-_jpg.rf.7f7266ca36660b1ab4d0a4f2a704a54e.jpg
5_atss,fold_3,3,1,1,0,-2,20230512_151620_jpg.rf.ced9071f82dc586dd5ac71f5fae00dc4.jpg
5_atss,fold_3,1,1,1,0,0,20230512_151655_jpg.rf.1681dccfc685ad40e584cad62c4f6b8e.jpg
5_atss,fold_3,8,1,1,0,-7,0230512_145235_jpg.rf.20bb212232c9b2421611218796835da2.jpg
5_atss,fold_3,13,2,2,0,-11,20230512_151008_jpg.rf.0cd6367e8494296811c3d1a88e22360b.jpg
5_atss,fold_3,12,6,6,0,-6,IMG_20230512_152352_jpg.rf.2c7ab0d8791aacf1c20aa134ddf7f9ed.jpg
5_atss,fold_3,2,1,1,0,-1,IMG_20230512_151034_jpg.rf.d8d2ab03b8a59931929429b4bc8c7106.jpg
5_atss,fold_3,12,1,1,0,-11,IMG_20230512_150124_jpg.rf.fef0579e7a6b4c283294de15512f524a.jpg
5_atss,fold_3,7,0,0,0,-7,20230512_150027_jpg.rf.787439d34fc22269c3ab90e55ea595ed.jpg
5_atss,fold_3,3,1,1,0,-2,20230512_151627_jpg.rf.9dc28340fd04ffea8cf28dd5e51283d6.jpg
5_atss,fold_3,4,3,2,1,-1,IMG_20230512_151218_jpg.rf.10b21ddd648ad67d1f264e8b99ead4d4.jpg
5_atss,fold_3,37,0,0,0,-37,IMG_20230512_150249_jpg.rf.61bc4fbd0c49a88a29443f72cc742e3b.jpg
5_atss,fold_3,6,0,0,0,-6,20230512_150023_jpg.rf.06c0ade806a1d3e688bc144ef13dbaf8.jpg
5_atss,fold_3,8,2,2,0,-6,20230512_150210_jpg.rf.e4435f297c285583a73370f97d9cef80.jpg
5_atss,fold_3,8,5,5,0,-3,IMG_4089_JPG.rf.7967cd5700ba2e9b62aa13ecaa3a28b1.jpg
5_atss,fold_3,0,3,0,3,3,0031_jpg.rf.00b387ba75b602a79b19e9003038b8ea.jpg
5_atss,fold_3,3,1,1,0,-2,IMG_4196_JPG.rf.66adce382a697aad33bcbc7ab8814677.jpg
5_atss,fold_3,26,0,0,0,-26,0512_150111_jpg.rf.d4cf10c518eff125048b590e0a4605cb.jpg
5_atss,fold_3,2,0,0,0,-2,IMG_20230512_151827_jpg.rf.e428f11ebc690c01de13c493aaf89f10.jpg
5_atss,fold_3,4,0,0,0,-4,0009_jpg.rf.14ae6cb384f301625cca9baa804d99e2.jpg
5_atss,fold_3,6,2,2,0,-4,IMG_20230512_145423_jpg.rf.f32325604574f1dc3efee2c645d2272b.jpg
5_atss,fold_3,8,0,0,0,-8,20230512_150140_jpg.rf.b2c7162d38d1696ac9436b4c5de3c5bd.jpg
5_atss,fold_3,3,0,0,0,-3,20230512_145132_jpg.rf.b2c282982621d398e0a5b6f181a8e8c1.jpg
5_atss,fold_3,18,3,3,0,-15,20230512_153054_jpg.rf.acae07a63d6f22a0dc7fca55cf6b2d89.jpg
5_atss,fold_3,5,2,2,0,-3,0005_jpg.rf.619937b06bbe7d217806b697a9eaf55e.jpg
5_atss,fold_3,2,0,0,0,-2,230512_150120_jpg.rf.1f7889194211bdac4259fdcd65e2af46.jpg
5_atss,fold_3,17,0,0,0,-17,IMG_20230512_150215_jpg.rf.9b54f4c34af6ee37c5ada817e2111c19.jpg
5_atss,fold_3,3,1,0,1,-2,20230512_145242_jpg.rf.88c3024b1c64b0b6b0db5dddea0bbe0e.jpg
5_atss,fold_3,17,0,0,0,-17,0230512_145032_jpg.rf.e9aeb44392fbee708cc4bb450582bc0f.jpg
5_atss,fold_3,1,0,0,0,-1,0001_jpg.rf.a9b41d3e1ed49082f175c1d3de0b732e.jpg
5_atss,fold_3,19,2,2,0,-17,IMG_20230512_150300_jpg.rf.4a9882ab0ad5a15acf150bad52ccf7d8.jpg
5_atss,fold_3,26,1,0,1,-25,IMG_20230512_150103_353_jpg.rf.eaad90385ad647d1df922a626623f903.jpg
5_atss,fold_3,7,0,0,0,-7,20230512_150022_jpg.rf.5a680d2814abd10e92a1f6ddf628a4b0.jpg
5_atss,fold_3,2,0,0,0,-2,0015_jpg.rf.1f8e46b5b78af1818a40afacf5a7fe1f.jpg
5_atss,fold_3,4,0,0,0,-4,IMG_20230512_144918_793_jpg.rf.fe7a52b8285a2a10f29948f41ac02b51.jpg
5_atss,fold_3,3,1,1,0,-2,20230512_145233_jpg.rf.8a9f06089b7122f3b71b6b1b537d6310.jpg
5_atss,fold_3,1,1,1,0,0,20230512_151802_jpg.rf.9a715b86b471f00ddc7bd3a521537317.jpg
5_atss,fold_3,18,3,3,0,-15,20230512_153055_jpg.rf.0b63692f9c79fad5834fab15740f4292.jpg
5_atss,fold_3,2,1,1,0,-1,20230512_151739_jpg.rf.fecdc818de88f0d7b449820f099a729b.jpg
5_atss,fold_3,4,0,0,0,-4,20230512_150313_jpg.rf.7d2a23518189f8dfc49022c0bb08346b.jpg
5_atss,fold_3,6,0,0,0,-6,20230512_153401_jpg.rf.1ded42782d8fd0ae0793add50267e0f5.jpg
5_atss,fold_3,3,2,2,0,-1,20230512_152321_jpg.rf.b0515ed603d5d83688c8ee2dfedeaa66.jpg
5_atss,fold_3,1,0,0,0,-1,20230512_151233_jpg.rf.57d77820fe4dbc49f59fbae1adba2530.jpg
5_atss,fold_3,8,0,0,0,-8,IMG_20230512_145010_jpg.rf.ba751af01c38c7678521f2c4ac49568d.jpg
5_atss,fold_3,11,2,2,0,-9,20230512_150957_jpg.rf.2c85fc69db682fcfa08ad10362437bf3.jpg
5_atss,fold_3,2,1,1,0,-1,0026_jpg.rf.10b0037e1af1fddb19365505a0710c5e.jpg
5_atss,fold_3,1,0,0,0,-1,0230512_145119_jpg.rf.a6362e13240d8879ce6e61258d8292ff.jpg
5_atss,fold_3,12,3,2,1,-9,IMG_20230512_152237_316_jpg.rf.d5f18e3c135f2f386671e759efda8b69.jpg
5_atss,fold_3,13,7,7,0,-6,20230512_152314_jpg.rf.6c3a181a30741b0f98140ba02a523656.jpg
5_atss,fold_3,21,1,1,0,-20,IMG_20230512_150127_jpg.rf.93acf533bedd75541341479d4df15bde.jpg
5_atss,fold_3,10,1,1,0,-9,IMG_4194_JPG.rf.4cdca480fa2d46704cadc5840d0238b9.jpg
5_atss,fold_3,2,1,1,0,-1,20230512_145425_jpg.rf.8c9689378836a9437ec8ca49c37064b8.jpg
5_atss,fold_3,9,0,0,0,-9,20230512_150034_jpg.rf.d8c7b9720feb16c5a52d002b7d3fdbec.jpg
5_atss,fold_3,2,2,2,0,0,20230512_151800_jpg.rf.60975505aa8c8066f47f273831b23407.jpg
5_atss,fold_3,15,10,10,0,-5,IMG_20230512_152327_jpg.rf.9a4db2d219a086a344f3eb954ba715b9.jpg
5_atss,fold_3,8,3,3,0,-5,20230512_153038_jpg.rf.263cbf9b4c15ef94a433b3b4d9c52ad6.jpg
5_atss,fold_3,2,2,2,0,0,20230512_151740_jpg.rf.bfe7cb62c2579413cf5790e5fdbe33bc.jpg
5_atss,fold_3,3,0,0,0,-3,20230512_151622_jpg.rf.99d95c55959b0e321e3679e87f923922.jpg
5_atss,fold_3,1,1,1,0,0,0007_jpg.rf.2f8d48ecd0ea275fbd9f39696545a7de.jpg
5_atss,fold_4,8,0,0,0,-8,20230512_152304_jpg.rf.af417071e5055ff7a21c7e5c8a36b6b4.jpg
5_atss,fold_4,2,0,0,0,-2,IMG_4032_JPG.rf.24900b5575b9992102af280f6bba47e6.jpg
5_atss,fold_4,2,0,0,0,-2,0230512_145348_jpg.rf.cdc212bd3fb2bf4f176382d869092c48.jpg
5_atss,fold_4,3,0,0,0,-3,20230512_151623_jpg.rf.72bb569548154b9cacef8ad44ea34cbb.jpg
5_atss,fold_4,16,0,0,0,-16,20230512_150033_jpg.rf.187d7f8b3b10fd4c55a59ca829ef7fc8.jpg
5_atss,fold_4,5,0,0,0,-5,20230512_151847_jpg.rf.bd70f9e3dff9227488b4ca7adbf77b50.jpg
5_atss,fold_4,17,0,0,0,-17,0230512_145037_jpg.rf.043bbe5a69ebdbfca0307a4e11b0ac63.jpg
5_atss,fold_4,35,0,0,0,-35,20230512_150150_jpg.rf.7c6e4ba9b7c81892495bdb947e71e7bc.jpg
5_atss,fold_4,12,0,0,0,-12,20230512_151910_jpg.rf.83e74c185917f56390fb7c632f1ddbb8.jpg
5_atss,fold_4,13,0,0,0,-13,IMG_20230512_153056_jpg.rf.ce869252548200602c656449cd5652e5.jpg
5_atss,fold_4,6,0,0,0,-6,20230512_152218_jpg.rf.93c255ace7ac5cb6c518b519f276c38a.jpg
5_atss,fold_4,1,0,0,0,-1,IMG_20230512_150858_jpg.rf.0c886d7a0228ac541d46c5461d00eaa9.jpg
5_atss,fold_4,8,0,0,0,-8,IMG_20230512_153026_jpg.rf.8b55b13a2be603023efcf36910819c5c.jpg
5_atss,fold_4,20,0,0,0,-20,IMG_20230512_162026_jpg.rf.5b2e0930b83dcdad9e4b2c7dc2220ad8.jpg
5_atss,fold_4,3,0,0,0,-3,20230512_152203_jpg.rf.f37f9576053c5dda9448b82302e0a353.jpg
5_atss,fold_4,7,0,0,0,-7,20230512_150912_jpg.rf.18152396c31db59c1819409ba319c0aa.jpg
5_atss,fold_4,1,0,0,0,-1,20230512_151104_jpg.rf.68db94fa29d48c9461b06ea1012225cb.jpg
5_atss,fold_4,9,0,0,0,-9,IMG_4184_JPG.rf.c3ce659fb0267eb11d28871cd003f680.jpg
5_atss,fold_4,8,0,0,0,-8,IMG_20230512_152244_576_jpg.rf.97d6ebe9005d26f9e1a4c40801745b3f.jpg
5_atss,fold_4,6,0,0,0,-6,IMG_20230512_144951_654_jpg.rf.73864ab361d6a49bef8ae0582378dcd8.jpg
5_atss,fold_4,4,0,0,0,-4,20230512_152245_jpg.rf.ad9c9eed13ca805362ff37a6409c22f1.jpg
5_atss,fold_4,7,0,0,0,-7,0230512_145259_jpg.rf.a81f0fe30e13f9985ea29fbb8c3ca4bb.jpg
5_atss,fold_4,1,0,0,0,-1,20230512_151444_jpg.rf.d7d4a6ea41d6e0b978df16189a7ef0b7.jpg
5_atss,fold_4,3,0,0,0,-3,IMG_20230512_145249_jpg.rf.3fc3e8c98a6aad287c04adaf81f76d80.jpg
5_atss,fold_4,13,0,0,0,-13,20230512_152301_jpg.rf.13169aad5cc03cf2c0524d6515d1d94b.jpg
5_atss,fold_4,8,0,0,0,-8,20230512_150133_jpg.rf.959f58c55ea7f14e5d45aefc1a142e65.jpg
5_atss,fold_4,5,0,0,0,-5,IMG_20230512_145102_470_jpg.rf.a4be99517dd9cf481f2fb0f577967e6e.jpg
5_atss,fold_4,16,0,0,0,-16,IMG_3905_JPG.rf.442064c53f4baafe2a90c8d4533175cf.jpg
5_atss,fold_4,3,0,0,0,-3,20230512_151752-0-_jpg.rf.adde6111e2c01f49d300871eeeeaf43b.jpg
5_atss,fold_4,15,0,0,0,-15,IMG_20230512_153244_jpg.rf.fd36ed68885d906d1bfe0772308714e1.jpg
5_atss,fold_4,45,0,0,0,-45,IMG_20230512_150252_jpg.rf.91876ddbae7daf47c170e3510196d23c.jpg
5_atss,fold_4,15,0,0,0,-15,0230512_144954_jpg.rf.9e07b2d4ee27051f0fa96e46105520b2.jpg
5_atss,fold_4,9,0,0,0,-9,20230512_151010_jpg.rf.ff0a6fa0a1930269ecf709bdd00cc6b8.jpg
5_atss,fold_4,1,0,0,0,-1,20230512_145011_jpg.rf.85e961b884fe88c3056ad6c5a04daafb.jpg
5_atss,fold_4,1,0,0,0,-1,20230512_151659_jpg.rf.d533f433ef4f94da44e6019d93e2f69d.jpg
5_atss,fold_4,6,0,0,0,-6,20230512_144945_jpg.rf.49417903dca45c5adf0a0717d2a3dda5.jpg
5_atss,fold_4,6,0,0,0,-6,20230512_152305_jpg.rf.b263e7fe5ca0aa0ae073ef44c4d6ad63.jpg
5_atss,fold_4,2,0,0,0,-2,20230512_152256_jpg.rf.414a0a8bdcc3eb0a766f8a87f6a30f22.jpg
5_atss,fold_4,5,0,0,0,-5,20230512_151844_jpg.rf.b9cd7c0869b5dcad46ed7aa755549a1d.jpg
5_atss,fold_4,12,0,0,0,-12,20230512_145238-0-_jpg.rf.a0bc376d8aa6c21ae201e90cd541ddca.jpg
5_atss,fold_4,11,0,0,0,-11,IMG_20230512_152349_jpg.rf.76f8813a71224f65490c6d1d4faea02e.jpg
5_atss,fold_4,8,0,0,0,-8,20230512_145210_jpg.rf.6800be488a1a4beab14cab796974b7e7.jpg
5_atss,fold_4,38,0,0,0,-38,IMG_20230512_150114_jpg.rf.d5fd8310f61f94bfde93cace46c477bb.jpg
5_atss,fold_4,2,0,0,0,-2,IMG_20230512_151102_245_jpg.rf.2d98a1d78cce88aad42bfe628f8ebe8d.jpg
5_atss,fold_4,13,0,0,0,-13,IMG_20230512_151332_jpg.rf.58fb5690cf39dcfb9f524a2ffc7cd6b2.jpg
5_atss,fold_4,4,0,0,0,-4,20230512_145359_jpg.rf.538caafcbceeeab2a7c4cb9e58bb1e6a.jpg
5_atss,fold_4,4,0,0,0,-4,0230512_145436_jpg.rf.68d4283942702699c181b1c4e2b81a95.jpg
5_atss,fold_4,1,0,0,0,-1,0012_jpg.rf.5fee49c3e98f9b2a75823078d85768de.jpg
5_atss,fold_4,7,0,0,0,-7,20230512_150040-0-_jpg.rf.c74af3340e71a4f4d5a1fc4d5da8ffe5.jpg
5_atss,fold_4,8,0,0,0,-8,IMG_20230512_150239_jpg.rf.0eb9dc459dd6d692fc26252cf2107fd0.jpg
5_atss,fold_4,1,0,0,0,-1,0230512_145052_jpg.rf.f17d7b98aa9a0360c0acc806b326b6a7.jpg
5_atss,fold_4,13,0,0,0,-13,IMG_20230512_152453_jpg.rf.1723f10503a3e6db7fbceca5913e5ee1.jpg
5_atss,fold_4,15,0,0,0,-15,0044_jpg.rf.a0660e380e16b315347f5e8999d870df.jpg
5_atss,fold_4,1,0,0,0,-1,20230512_145416_jpg.rf.85e0cfe06b91ae56be79ec72f5f2166f.jpg
5_atss,fold_4,8,0,0,0,-8,20230512_145343_jpg.rf.e8b4ce21c1272def811c108b7b1604e1.jpg
5_atss,fold_4,45,0,0,0,-45,0512_150205_jpg.rf.698866d107ebfcc4f94fd99f31b35b02.jpg
5_atss,fold_4,2,0,0,0,-2,IMG_20230512_151308_jpg.rf.9eafa4b376d2b0b24c2d76c7cefacf05.jpg
5_atss,fold_4,53,0,0,0,-53,0512_150120_jpg.rf.1a423f81d04e2ea199fda4f8950d5ec2.jpg
5_atss,fold_4,1,0,0,0,-1,20230512_145323_jpg.rf.42fec2bfece6489ae531e4112d227ded.jpg
5_atss,fold_4,2,0,0,0,-2,IMG_20230512_151304_jpg.rf.bdf70f382af5e54ed70fa1fa32041649.jpg
5_atss,fold_4,1,0,0,0,-1,20230512_153306_jpg.rf.d458260a195df2ca8597a9690a8bc292.jpg
5_atss,fold_4,10,0,0,0,-10,20230512_151858_jpg.rf.3e2b4dbf1ece4e9a00109cbeb8dc13dd.jpg
5_atss,fold_4,6,0,0,0,-6,IMG_20230512_151212_jpg.rf.f922d49a1e43e214462b88c675a0f36c.jpg
5_atss,fold_4,24,0,0,0,-24,20230512_153019_jpg.rf.6b11b011a1b75c2eb51c302864a6ea12.jpg
5_atss,fold_4,16,0,0,0,-16,20230512_150111_jpg.rf.3f08c8521cd7c859a80b7ba2d1856e75.jpg
5_atss,fold_4,1,0,0,0,-1,20230512_151650_jpg.rf.18be50d732782b5b8fb5f6c6db59cc14.jpg
5_atss,fold_4,4,0,0,0,-4,20230512_144940_jpg.rf.47a23c7f63536b38b08e8f2722741d17.jpg
5_atss,fold_4,11,0,0,0,-11,0054_jpg.rf.5df028d18381f316e9ed0d97adbbfbc0.jpg
5_atss,fold_4,5,0,0,0,-5,IMG_4217_JPG.rf.b26704f0c46f7b6c0d25d7f2aa4eac49.jpg
5_atss,fold_4,4,0,0,0,-4,20230512_145352-0-_jpg.rf.bd97ac0cb6ee49b575c0ecff7f91e2a1.jpg
5_atss,fold_4,1,0,0,0,-1,IMG_3856_JPG.rf.4cd3bfac67d223cd7bd1b1efd3b24a09.jpg
5_atss,fold_4,20,0,0,0,-20,IMG_20230512_152344_jpg.rf.fd23ba06eae998d14ce833db2c7d2195.jpg
5_atss,fold_4,17,0,0,0,-17,IMG_20230512_150217_jpg.rf.59ee9b06cb5a58b718b0ff7c76a2573f.jpg
5_atss,fold_4,1,0,0,0,-1,20230512_151654-0-_jpg.rf.21ff99bb21484d784b641bc49d9310ea.jpg
5_atss,fold_4,13,0,0,0,-13,IMG_20230512_151617_084_jpg.rf.864b3ce525fdd2abc7cc1f20bd6005c7.jpg
5_atss,fold_4,5,0,0,0,-5,230512_150030_jpg.rf.35a4005da91e89204ecd28ce53e7d8ee.jpg
5_atss,fold_4,6,0,0,0,-6,20230512_150037_jpg.rf.a47f7ce797194722a66a03263aee18ea.jpg
5_atss,fold_4,5,0,0,0,-5,IMG_20230512_150051_jpg.rf.66c8214813ef8f830b3612827d4de766.jpg
5_atss,fold_4,14,0,0,0,-14,20230512_152949_jpg.rf.67f9765f971d32daf7623088e0781422.jpg
5_atss,fold_4,2,0,0,0,-2,20230512_150046_jpg.rf.a3f3b22b2918be1f870eb4ccdaab79d1.jpg
5_atss,fold_4,7,0,0,0,-7,IMG_20230512_150112_1_jpg.rf.bf75baa207583c375190da53145a7679.jpg
5_atss,fold_4,15,0,0,0,-15,IMG_20230512_153023_jpg.rf.317d3bbb9dbd87e5a653c2851476e12f.jpg
5_atss,fold_4,5,0,0,0,-5,IMG_3847_JPG.rf.7ed87b14fc0af6892da29e4861a20db2.jpg
5_atss,fold_4,3,0,0,0,-3,0003_jpg.rf.808f042f9b4d2044e82ecf546085a2b3.jpg
5_atss,fold_4,16,0,0,0,-16,20230512_151042_jpg.rf.668f39eb72d209648acafdc48e653b94.jpg
5_atss,fold_4,7,0,0,0,-7,20230512_151549_jpg.rf.f43c366ab902f205b42b2d3ece3e5840.jpg
5_atss,fold_4,6,0,0,0,-6,20230512_145344_jpg.rf.3bb4caede9892124f0b05d554bde4f37.jpg
5_atss,fold_4,1,0,0,0,-1,20230512_145106_jpg.rf.f8f6fb5e7680b51b521aeb38bd04b4d4.jpg
5_atss,fold_4,4,0,0,0,-4,IMG_4056_JPG.rf.26cf10e8b88a0d85256d77231719fa6f.jpg
5_atss,fold_4,25,0,0,0,-25,0512_150105_jpg.rf.bf34c202007f5f0e97f15dd34c8af9ec.jpg
5_atss,fold_4,1,0,0,0,-1,20230512_145259_jpg.rf.4e068952a2cfa65232622575f2c5e59f.jpg
5_atss,fold_4,8,0,0,0,-8,IMG_20230512_150233_jpg.rf.fda528f9aab7dbc67a541c09b3ad100a.jpg
5_atss,fold_4,23,0,0,0,-23,IMG_20230512_150117_559_jpg.rf.acc98bc013000372fc9482efda238776.jpg
5_atss,fold_4,20,0,0,0,-20,IMG_20230512_150227_jpg.rf.c50986ec06debff70d855a963ab1652a.jpg
5_atss,fold_4,1,0,0,0,-1,20230512_145254_jpg.rf.9747b881733bcadb9a2575a7adfaf75f.jpg
5_atss,fold_4,7,0,0,0,-7,20230512_151550_jpg.rf.c44e1e4b7281907db5e481f675bb38ec.jpg
5_atss,fold_4,9,0,0,0,-9,20230512_152300_jpg.rf.ca2bad1620eeb8a9708c24c8c2a6140e.jpg
5_atss,fold_4,1,0,0,0,-1,20230512_151454_jpg.rf.2edeb7ad32e74ab446183c1ed2a6a8db.jpg
5_atss,fold_4,2,0,0,0,-2,20230512_151458_jpg.rf.e6aebc1a203d13c8d455292cbf8efbd5.jpg
5_atss,fold_4,2,0,0,0,-2,20230512_151804_jpg.rf.85f9cab4d985c7a3ab655e9e58f37592.jpg
5_atss,fold_4,4,0,0,0,-4,20230512_150056-0-_jpg.rf.726ba341e3872665ea20101a9121709b.jpg
5_atss,fold_4,1,0,0,0,-1,20230512_151710-0-_jpg.rf.d1c6ce2dc1214885b420fa5cf5b548eb.jpg
5_atss,fold_4,7,0,0,0,-7,0035_jpg.rf.88b59c904d75a54342b73641b3751f03.jpg
5_atss,fold_4,3,0,0,0,-3,20230512_150207_jpg.rf.2636d37c60105f9dc29244105d586763.jpg
5_atss,fold_4,11,0,0,0,-11,20230512_153529_jpg.rf.9da097c550c92828a111a560d7417f19.jpg
5_atss,fold_4,2,0,0,0,-2,20230512_145142_jpg.rf.4c1baf7188f9de7e345b9d556ae04487.jpg
5_atss,fold_4,1,0,0,0,-1,0021_jpg.rf.f361beb31a38d69ae7d5b1ba99586d9f.jpg
5_atss,fold_4,1,0,0,0,-1,IMG_20230512_145308_jpg.rf.60b7e140102953684517e9840c3f84fd.jpg
5_atss,fold_4,1,0,0,0,-1,20230512_145115_jpg.rf.559191d80ad4506d081542afe21569dc.jpg
5_atss,fold_4,8,0,0,0,-8,20230512_151848-0-_jpg.rf.4c259cab53877565769f8e42eb6a0530.jpg
5_atss,fold_4,2,0,0,0,-2,IMG_20230512_153102_jpg.rf.358691eda0f0c7c79eb866b582696397.jpg
5_atss,fold_4,3,0,0,0,-3,IMG_20230512_150935_625_jpg.rf.cff6166bfeadb181c727209a263dcaff.jpg
5_atss,fold_4,3,0,0,0,-3,IMG_3985_JPG.rf.5c7d7114a15a375a31c89b82a6710707.jpg
5_atss,fold_4,2,0,0,0,-2,20230512_151632_jpg.rf.fb7428039c06580293185bb9fd642dff.jpg
5_atss,fold_4,2,0,0,0,-2,IMG_20230512_151628_jpg.rf.0963b2196e508f701f2dc60946b1db1f.jpg
5_atss,fold_4,1,0,0,0,-1,0230512_145319_jpg.rf.7d5ab2070daeed5a15f73e243edac4bd.jpg
5_atss,fold_4,5,0,0,0,-5,IMG_3914_JPG.rf.ca20ceecff09da300344c1920873e12b.jpg
5_atss,fold_4,3,0,0,0,-3,IMG_4036_JPG.rf.c2b46ca616106cdb334a1b0aac2c914c.jpg
5_atss,fold_4,2,0,0,0,-2,0230512_145122_jpg.rf.d772ceaa3f11800d1db3d3fc009b64fa.jpg
5_atss,fold_4,22,0,0,0,-22,20230512_153049_jpg.rf.523c3f6b00af1f2e03d5832e7dd51cae.jpg
5_atss,fold_4,3,0,0,0,-3,IMG_20230512_151832_jpg.rf.b82753ef867011bf9f3989f4130320b7.jpg
5_atss,fold_4,1,0,0,0,-1,20230512_151710_jpg.rf.e2a5628c7930faedb74febbd18a15ccd.jpg
5_atss,fold_4,5,0,0,0,-5,IMG_4185_JPG.rf.6ef6b7a942afe064f7a7a9e4939729df.jpg
5_atss,fold_4,0,0,0,0,0,20230512_151901_jpg.rf.b378a9d5c3045cf87dd1529a7b516a3a.jpg
5_atss,fold_4,0,0,0,0,0,0512_150124_jpg.rf.7253b200930360a6b66d16035d62353c.jpg
5_atss,fold_4,3,0,0,0,-3,IMG_4195_JPG.rf.0d03c7bef40b40141ba8fa902afc3944.jpg
5_atss,fold_4,4,0,0,0,-4,20230512_151029_jpg.rf.aa4b3114b5545da90c2fa92150f01f70.jpg
5_atss,fold_4,20,0,0,0,-20,20230512_153247_jpg.rf.78c6c0964c07caf937b2079e23dcd922.jpg
5_atss,fold_4,7,0,0,0,-7,IMG_20230512_153040_jpg.rf.3179cdcfc75730df90bea9e4cbaf0f49.jpg
5_atss,fold_4,10,0,0,0,-10,IMG_20230512_145141_jpg.rf.c065d756b2e91f8933ac0a39ecf7c61c.jpg
5_atss,fold_4,3,0,0,0,-3,IMG_20230512_145333_jpg.rf.4bf3129c20f06bdb19d22b037e743535.jpg
5_atss,fold_4,3,0,0,0,-3,20230512_151621_jpg.rf.1cbfdf5023fe1c36f7e1875304467d87.jpg
5_atss,fold_4,4,0,0,0,-4,IMG_20230512_145030_jpg.rf.a2c5e550d29709fcbbe253d3a17faa45.jpg
5_atss,fold_4,5,0,0,0,-5,20230512_152223_jpg.rf.f6e3e9cd94a0f7908edd48a70c791781.jpg
5_atss,fold_4,17,0,0,0,-17,IMG_20230512_152350_jpg.rf.4fb06c58b682b06360ed9fa33472ca3f.jpg
5_atss,fold_4,16,0,0,0,-16,20230512_150149_jpg.rf.5f8b1bb241d961acb2fc7ceb62fbcbe5.jpg
5_atss,fold_4,7,0,0,0,-7,20230512_152306_jpg.rf.20aa1ef8f2026e47d56210676e93fca7.jpg
5_atss,fold_4,21,0,0,0,-21,20230512_144930_jpg.rf.f3caeeb846d5d4f624e9885bcb85d864.jpg
5_atss,fold_4,14,0,0,0,-14,IMG_20230512_153017_077_jpg.rf.70df56b8159d336a40a3fab054edb7c4.jpg
5_atss,fold_4,6,0,0,0,-6,IMG_20230512_144916_143_jpg.rf.00ee144f83892f61d5178b7edacdc535.jpg
5_atss,fold_4,1,0,0,0,-1,0018_jpg.rf.ca81692f06f9a1e7e06b1042d8cbe236.jpg
5_atss,fold_4,7,0,0,0,-7,20230512_152242_jpg.rf.4dee3224c614312f3bd59fc772965ff5.jpg
5_atss,fold_4,9,0,0,0,-9,IMG_20230512_150043_1_jpg.rf.5e7eb6e74c9c826c0209bc26685279a3.jpg
5_atss,fold_4,1,0,0,0,-1,0230512_145013_jpg.rf.14bb403c31ebd5a9f4be760858d91e7c.jpg
5_atss,fold_4,1,0,0,0,-1,IMG_4044_JPG.rf.e22068c91df69c24b01d3bb4f484ccf9.jpg
5_atss,fold_4,9,0,0,0,-9,IMG_20230512_150125_jpg.rf.bdb9638a94f4957f29777b278afdfb54.jpg
5_atss,fold_4,17,0,0,0,-17,20230512_152946_jpg.rf.00fa418fbf2242a22bd020d8133a24ee.jpg
5_atss,fold_4,19,0,0,0,-19,IMG_20230512_150131_jpg.rf.325767bc75099b22d288f353f1a8fbe2.jpg
5_atss,fold_4,16,0,0,0,-16,20230512_151041_jpg.rf.0b792381ac6bb324435dd5a7b43616cf.jpg
5_atss,fold_4,2,0,0,0,-2,20230512_151443_jpg.rf.7d2dfd53f11811d0c3a7fe9e184ef15f.jpg
5_atss,fold_4,13,0,0,0,-13,20230512_153243_jpg.rf.a8672f75e3195db775772b68bce054bf.jpg
5_atss,fold_4,7,0,0,0,-7,IMG_3912_JPG.rf.6558238f753c37ffb70dd8d3bcee5e9f.jpg
5_atss,fold_4,13,0,0,0,-13,IMG_20230512_151318_682_jpg.rf.cdeb9703323a496f0e9620a04f4ec09d.jpg
5_atss,fold_4,1,0,0,0,-1,0038_jpg.rf.d0b487b5b7af9ce9d50c875d519b9707.jpg
5_atss,fold_4,13,0,0,0,-13,20230512_150015_jpg.rf.5089b7d402f3ce99da9541171299577e.jpg
5_atss,fold_4,13,0,0,0,-13,20230512_153332_jpg.rf.f6c943fc1dfba3d62a21eb08ecf60b8c.jpg
5_atss,fold_4,7,0,0,0,-7,20230512_152247_jpg.rf.df7d569b56aaba2e6bf5fc59ec8f414c.jpg
5_atss,fold_5,23,2,2,0,-21,IMG_20230512_150248_jpg.rf.11fd0431dfaace4800d3f2d4912bd780.jpg
5_atss,fold_5,9,0,0,0,-9,20230512_150203_jpg.rf.d7cdb618f9cc06830ca3fad4137b7cac.jpg
5_atss,fold_5,13,0,0,0,-13,IMG_20230512_145048_jpg.rf.2f0c31d1a5ff8b461878196ebf8c11df.jpg
5_atss,fold_5,3,1,1,0,-2,20230512_145350-0-_jpg.rf.ccf3d3aca429fe2887c17c60d55a358a.jpg
5_atss,fold_5,14,0,0,0,-14,IMG_20230512_153052_jpg.rf.8577be081284ea5d1672c21d4fd9f288.jpg
5_atss,fold_5,2,1,1,0,-1,20230512_151628_jpg.rf.fdfad9f330381519b41b6c69eeae4609.jpg
5_atss,fold_5,4,0,0,0,-4,20230512_150906_jpg.rf.b4718b9b84d49303d6b0fb5e035fe49b.jpg
5_atss,fold_5,2,1,1,0,-1,IMG_20230512_151744_jpg.rf.1d579e4bc8e6391207029a3d59c821a9.jpg
5_atss,fold_5,2,0,0,0,-2,0013_jpg.rf.55b646371565f20bce0f6ce403646502.jpg
5_atss,fold_5,16,0,0,0,-16,20230512_145021_jpg.rf.57a18381e0e233f1d4d97199a9263ed4.jpg
5_atss,fold_5,4,2,2,0,-2,20230512_152325_jpg.rf.b754896fe384db191f35564d52272327.jpg
5_atss,fold_5,3,0,0,0,-3,IMG_20230512_151247_jpg.rf.33589b240751a2f02c7a7c51bafafe59.jpg
5_atss,fold_5,3,1,1,0,-2,20230512_151624_jpg.rf.339fa34d1377a1b59daa0460f8896c47.jpg
5_atss,fold_5,7,0,0,0,-7,IMG_20230512_145013_jpg.rf.23ebd19f18a23ba18f9bde6b91f93cbd.jpg
5_atss,fold_5,5,0,0,0,-5,20230512_153327_jpg.rf.07e6f7dfffed230d78bc971f5cdb9b9f.jpg
5_atss,fold_5,1,1,1,0,0,20230512_151652_jpg.rf.42dfca221b4b4fbaf828e370670fd031.jpg
5_atss,fold_5,13,0,0,0,-13,20230512_151021-copia-1-_jpg.rf.abdeaa1b054ea3b58658807cca9089ae.jpg
5_atss,fold_5,2,0,0,0,-2,IMG_20230512_151820_jpg.rf.2fe30b8ed1d8e20bac353cf3379cdcce.jpg
5_atss,fold_5,9,0,0,0,-9,IMG_20230512_151055_jpg.rf.4509eabdb200535ad64add0b786d59a4.jpg
5_atss,fold_5,3,0,0,0,-3,20230512_150026_jpg.rf.33fe35571137ce16bd8c3bd383b8db8f.jpg
5_atss,fold_5,4,0,0,0,-4,0005_jpg.rf.024cc60176c5f8a007eca0cbdacb4691.jpg
5_atss,fold_5,17,1,1,0,-16,20230512_151040_jpg.rf.87640fb95b74f117e81bcca0c41f76af.jpg
5_atss,fold_5,11,0,0,0,-11,20230512_152314_jpg.rf.0becd9c30d5157c4b2a582e3fa4b759a.jpg
5_atss,fold_5,11,3,3,0,-8,20230512_151853_jpg.rf.b5af18c1578fd0fbb73f9427792d45c0.jpg
5_atss,fold_5,1,0,0,0,-1,20230512_150249_jpg.rf.78e9f249c2e4a31b39a078b7266ac51a.jpg
5_atss,fold_5,22,0,0,0,-22,20230512_150104_jpg.rf.291e8ff0d311863c8ac10188b0cb1b28.jpg
5_atss,fold_5,3,1,1,0,-2,20230512_145232_jpg.rf.f26463ccf279cd604dca1dded979fa14.jpg
5_atss,fold_5,10,0,0,0,-10,20230512_153454_jpg.rf.a2384c87b34aeaa97bbbbd20e8b1d56b.jpg
5_atss,fold_5,1,0,0,0,-1,20230512_151017_jpg.rf.c588fa9199c6dffdb1179f7f483c865f.jpg
5_atss,fold_5,17,0,0,0,-17,20230512_150146_jpg.rf.e84fc4cf33f8326d64d02b7ed8cafce4.jpg
5_atss,fold_5,6,0,0,0,-6,IMG_3850_JPG.rf.7f7105ed07be37f94ee73db7da91b99e.jpg
5_atss,fold_5,1,0,0,0,-1,20230512_145114_jpg.rf.38c9c923c79af5172bfb7315ee2859bb.jpg
5_atss,fold_5,1,0,0,0,-1,20230512_152332_jpg.rf.4836b4b24c985755468de47d12fd4fa5.jpg
5_atss,fold_5,6,0,0,0,-6,20230512_151136_jpg.rf.a8aef98dbb4c86bffec8ae4287c1dc6e.jpg
5_atss,fold_5,5,0,0,0,-5,IMG_20230512_152359_jpg.rf.a5ab36a1dd0fd3e5088b4ed61c7990eb.jpg
5_atss,fold_5,17,0,0,0,-17,IMG_4208_JPG.rf.8f59289e526ec56a405f244ebaa1a95a.jpg
5_atss,fold_5,1,0,0,0,-1,20230512_151208_jpg.rf.0f6b66ca4ada91b2974b5945e2b92069.jpg
5_atss,fold_5,3,2,2,0,-1,20230512_151839_jpg.rf.7e5100e585fd816285691f17e14cfcdb.jpg
5_atss,fold_5,4,0,0,0,-4,IMG_3919_JPG.rf.9a5b0afd3da0db473f842046c5113690.jpg
5_atss,fold_5,8,0,0,0,-8,20230512_145241_jpg.rf.455691f27dd7da4e6c25ba615f3f2620.jpg
5_atss,fold_5,2,2,2,0,0,0230512_145355_jpg.rf.c17e94a0f80c4c06f2a620a85826ebcc.jpg
5_atss,fold_5,1,0,0,0,-1,20230512_151504_jpg.rf.c79fb008568aeb31342688eb80ad9a49.jpg
5_atss,fold_5,2,0,0,0,-2,0029_jpg.rf.e9d3f2a53d6d73564cd418ea60fbbd61.jpg
5_atss,fold_5,2,0,0,0,-2,20230512_151133_jpg.rf.a96da38b573a4da364c3f36aaf0c460d.jpg
5_atss,fold_5,2,0,0,0,-2,IMG_20230512_151814_jpg.rf.d8d7b03e58abeca643b8f9e71acfd81a.jpg
5_atss,fold_5,1,0,0,0,-1,20230512_151010_jpg.rf.a46c76d923129f16810ff21ca0937475.jpg
5_atss,fold_5,2,1,1,0,-1,0032_jpg.rf.ac745db746452e37d39279a2c8ecd454.jpg
5_atss,fold_5,8,0,0,0,-8,20230512_151510_jpg.rf.b27f217e8ec95c059fa149f7f8f03d2b.jpg
5_atss,fold_5,3,0,0,0,-3,IMG_20230512_151228_jpg.rf.1e509a8a9a3464432051f5ec53cc611c.jpg
5_atss,fold_5,15,2,2,0,-13,0045_jpg.rf.b8baabd840c67f80f92a3844015afe9b.jpg
5_atss,fold_5,13,1,1,0,-12,20230512_151047_jpg.rf.3fb94f0bd6175b2f1306a1aac0027216.jpg
5_atss,fold_5,12,2,2,0,-10,IMG_20230512_150922_jpg.rf.e1a7736e96dfcd7e2b06e2f5c94a3cc1.jpg
5_atss,fold_5,1,0,0,0,-1,0010_jpg.rf.d1d93d099773f36e90b527f8611d128c.jpg
5_atss,fold_5,68,0,0,0,-68,IMG_20230512_153133_jpg.rf.b54f10d107857a0eb7fbb7943b030152.jpg
5_atss,fold_5,1,0,0,0,-1,IMG_20230512_151445_jpg.rf.853f3efcb5076d2d7bac2e663f2804bd.jpg
5_atss,fold_5,1,0,0,0,-1,IMG_20230512_151214_161_jpg.rf.057ee941cfb105e5fd41f7e4342f657a.jpg
5_atss,fold_5,1,0,0,0,-1,230512_150310_jpg.rf.25af60211cc7ea70d0a37dae89d778ae.jpg
5_atss,fold_5,11,1,1,0,-10,IMG_20230512_151958_jpg.rf.c0c5a182cd6f5f4319120803cadd4e15.jpg
5_atss,fold_5,7,0,0,0,-7,230512_150020_jpg.rf.3321ea3a69f605601bbe1180e33c4372.jpg
5_atss,fold_5,2,1,1,0,-1,20230512_151705_jpg.rf.5d4aace27e10d6b9f9dcd14c2eb80876.jpg
5_atss,fold_5,10,0,0,0,-10,IMG_20230512_151057_jpg.rf.34b51a9edb1d08b21feec0712493ad44.jpg
5_atss,fold_5,4,1,1,0,-3,20230512_151746_jpg.rf.28bbdba7c34f11ae2fa3b6c62e25edcc.jpg
5_atss,fold_5,12,0,0,0,-12,20230512_145147_jpg.rf.8cbc9f87bfc771396f02c8e27231d7ee.jpg
5_atss,fold_5,5,0,0,0,-5,IMG_20230512_152233_631_jpg.rf.5a6ed894f5cd8513bac1f0dfbdeb7bf3.jpg
5_atss,fold_5,1,1,1,0,0,20230512_145424_jpg.rf.fdacfd117c87835a809a784e9019c683.jpg
5_atss,fold_5,1,1,1,0,0,20230512_145347_jpg.rf.d1edf1d3992c10216d75faac6523aed9.jpg
5_atss,fold_5,7,0,0,0,-7,IMG_20230512_145116_jpg.rf.89714791069678114dd234188f4e153e.jpg
5_atss,fold_5,5,0,0,0,-5,20230512_152308_jpg.rf.f4e8f4ca110dded8e5b00937a84760be.jpg
5_atss,fold_5,11,0,0,0,-11,IMG_4212_JPG.rf.93840a5a997c2230b8ec5404df51506e.jpg
5_atss,fold_5,22,0,0,0,-22,20230512_150120_jpg.rf.e2c884c6c431ae355dbe5eae448fe9fe.jpg
5_atss,fold_5,1,0,0,0,-1,0035_jpg.rf.8f80b9113851faa3ce22f7a4237e063b.jpg
5_atss,fold_5,1,0,0,0,-1,IMG_4020_JPG.rf.bc2697c76c5828734e1ac848245c5a5b.jpg
5_atss,fold_5,6,0,0,0,-6,IMG_20230512_151224_jpg.rf.f07ca2ca5270e16cfa2d0b808d60cc7f.jpg
5_atss,fold_5,14,0,0,0,-14,20230512_152357_jpg.rf.6852fe96763037ed9985128c109b3ce2.jpg
5_atss,fold_5,21,0,0,0,-21,IMG_20230512_150344_jpg.rf.21eb7b1441ddc9b2740cc4367709590f.jpg
5_atss,fold_5,2,0,0,0,-2,20230512_145054_jpg.rf.3d4529e01dd37f4f80ba26154a898555.jpg
5_atss,fold_5,7,2,2,0,-5,20230512_152258_jpg.rf.7636714c888f4e6cbf70120b64064d40.jpg
5_atss,fold_5,2,1,1,0,-1,20230512_151841_jpg.rf.9dd3a6bca715d1085cb1da5cae6efd0f.jpg
5_atss,fold_5,19,0,0,0,-19,20230512_150051_jpg.rf.c03c04498642818f22eb4115246bdb27.jpg
5_atss,fold_5,2,1,1,0,-1,20230512_151635_jpg.rf.ee2ff8efc5aaa53fea09028b60c05e75.jpg
5_atss,fold_5,24,0,0,0,-24,IMG_20230512_150107_368_jpg.rf.841def69669689958248c77fd74c6ef5.jpg
5_atss,fold_5,1,1,1,0,0,20230512_151647_jpg.rf.367411ded71931545e2f1f2799cebf0b.jpg
5_atss,fold_5,2,0,0,0,-2,20230512_151223_jpg.rf.6a7ba0efceb9c41d056eee7ad9219353.jpg
5_atss,fold_5,4,0,0,0,-4,20230512_145213_jpg.rf.166b2f375e79324c95dc48c23bef06fa.jpg
5_atss,fold_5,2,0,0,0,-2,IMG_3844_JPG.rf.8a9213642776490b8b621595f6183af2.jpg
5_atss,fold_5,14,0,0,0,-14,20230512_145202_jpg.rf.fc0b0601e248df8d80e9bb9ba998d0e7.jpg
5_atss,fold_5,26,0,0,0,-26,0512_150040_jpg.rf.f8c148cb1d657923d62ef9d7c2a4e8c4.jpg
5_atss,fold_5,9,0,0,0,-9,20230512_153259_jpg.rf.893deba08433f5f85baa0becc85071b1.jpg
5_atss,fold_5,1,1,1,0,0,IMG_20230512_150840_jpg.rf.3e9980cbe445c9f1025d481e7a7a5710.jpg
5_atss,fold_5,17,0,0,0,-17,20230512_151049_jpg.rf.7faee580bbaad04f4aee5a6edf72e5b5.jpg
5_atss,fold_5,43,0,0,0,-43,0512_150100_jpg.rf.9eaed3be83ecba8e3e4efbdc882c1fa5.jpg
5_atss,fold_5,2,0,0,0,-2,230512_150026_jpg.rf.633ed1e3a24d8c7ecacc82788de5c3b8.jpg
5_atss,fold_5,3,0,0,0,-3,IMG_20230512_153013_jpg.rf.93712b9e1c24432fd87372997521847c.jpg
5_atss,fold_5,2,0,0,0,-2,0017_jpg.rf.c3653cc70e103964ca9e6a3e85f3f694.jpg
5_atss,fold_5,5,0,0,0,-5,20230512_151508_jpg.rf.00e90b7105d608decd85f3e850e1f875.jpg
5_atss,fold_5,8,1,1,0,-7,IMG_20230512_150939_jpg.rf.d5260c01e2cabb005d119333eda4e87d.jpg
5_atss,fold_5,2,0,0,0,-2,IMG_4021_JPG.rf.7556e49a1eda27532dfb6cc32c974482.jpg
5_atss,fold_5,5,0,0,0,-5,20230512_152302_jpg.rf.016780b8da4c66843b955300975f2747.jpg
5_atss,fold_5,34,0,0,0,-34,IMG_20230512_150128_453_jpg.rf.081da15c5e562b5ce7f42ab95339a34a.jpg
5_atss,fold_5,1,0,0,0,-1,0027_jpg.rf.041bc0af55a373703357342785fa3667.jpg
5_atss,fold_5,1,0,0,0,-1,20230512_150050_jpg.rf.c95631863834d93e37ddc2fda8829ab4.jpg
5_atss,fold_5,10,0,0,0,-10,IMG_20230512_153016_jpg.rf.c257848a0cea9445774e7172a68a0d16.jpg
5_atss,fold_5,21,0,0,0,-21,20230512_152409_jpg.rf.5d8e7c06336544573f46c12fe04ef26b.jpg
5_atss,fold_5,4,0,0,0,-4,IMG_20230512_151230_jpg.rf.77eaf1e461982f94562c61c5de9e3444.jpg
5_atss,fold_5,3,0,0,0,-3,IMG_4192_JPG.rf.915fc04cdd59b40454fa22fea6dcf2f7.jpg
5_atss,fold_5,1,0,0,0,-1,20230512_145226_jpg.rf.d01dc6c5e4859db13d337281014a74b1.jpg
5_atss,fold_5,1,0,0,0,-1,20230512_151100_jpg.rf.8c5db2f9786fe5fedf170c30766e11a8.jpg
5_atss,fold_5,11,1,1,0,-10,20230512_151912_jpg.rf.2dfbdab89b348f4eda01f5edbb8bf596.jpg
5_atss,fold_5,8,1,1,0,-7,20230512_145439_jpg.rf.21c5c0c901e6a327a75c7f0dc4eafc1c.jpg
5_atss,fold_5,1,0,0,0,-1,IMG_20230512_151206_373_jpg.rf.25070077bf672ae36c15ea6e22fdc049.jpg
5_atss,fold_5,1,0,0,0,-1,20230512_145257_jpg.rf.f1c0c8bd862cb12f380ae5d7949e68a2.jpg
5_atss,fold_5,5,0,0,0,-5,IMG_20230512_153021_jpg.rf.c74db55af384c855422ee71d8c0c24a2.jpg
5_atss,fold_5,20,0,0,0,-20,IMG_20230512_152355_jpg.rf.1ee2ad035e7125aadb708f8b70abd231.jpg
5_atss,fold_5,3,0,0,0,-3,20230512_152249_jpg.rf.9209f7c7b47e7778a14dc41949d8882b.jpg
5_atss,fold_5,1,0,0,0,-1,20230512_151230_jpg.rf.ab81eae29bf9052e3dd989b36b3a00cd.jpg
5_atss,fold_5,3,0,0,0,-3,IMG_3915_JPG.rf.83d4afabcacf1fe7976e4f01a8b55687.jpg
5_atss,fold_5,2,1,0,1,-1,IMG_3913_JPG.rf.23307ea91d746d228b58a6db32ff0bca.jpg
5_atss,fold_5,10,2,1,1,-8,IMG_20230512_145140_jpg.rf.a089bf5c311c725d73e925fe2d7d4c66.jpg
5_atss,fold_5,10,2,2,0,-8,20230512_151859_jpg.rf.820ed98fb886601f4f15717490003a3e.jpg
5_atss,fold_5,3,0,0,0,-3,20230512_152225_jpg.rf.889528313caa94497bf581fc9b6ec204.jpg
5_atss,fold_5,7,4,4,0,-3,20230512_145340_jpg.rf.962ef85b90f87307d46df866e8b6be07.jpg
5_atss,fold_5,1,0,0,0,-1,IMG_4397_JPG.rf.ff87fb693a34984f9e818a3a3a1a79b3.jpg
5_atss,fold_5,11,2,2,0,-9,20230512_151903_jpg.rf.e84304253d71e06ad8473e1be6aa7582.jpg
5_atss,fold_5,16,0,0,0,-16,IMG_20230512_150056_jpg.rf.65358cd23942ee92bc5024b41d26500a.jpg
5_atss,fold_5,29,0,0,0,-29,0512_150057_jpg.rf.c228357b2bf9bb499210e8c8c7afa45b.jpg
5_atss,fold_5,2,0,0,0,-2,20230512_153435_jpg.rf.52f71510b3fa5d1e5d0f6e2468cab216.jpg
5_atss,fold_5,16,0,0,0,-16,IMG_20230512_145123_jpg.rf.1bbba4202dcb5637d1840db017c11671.jpg
5_atss,fold_5,1,0,0,0,-1,20230512_153421_jpg.rf.4cb37bb0380a93d519214becab03862c.jpg
5_atss,fold_5,16,0,0,0,-16,20230512_144939_jpg.rf.32f704ff01b8b91ab11ac16462053c96.jpg
5_atss,fold_5,1,0,0,0,-1,20230512_151453_jpg.rf.fc89aea08c4953e972d355bc593bd6ae.jpg
5_atss,fold_5,1,0,0,0,-1,IMG_4019_JPG.rf.13ea285b754475b580f840ba9fc99608.jpg
5_atss,fold_5,5,1,1,0,-4,20230512_152320_jpg.rf.373cf359be94c413709d04995faada1e.jpg
5_atss,fold_5,1,0,0,0,-1,IMG_20230512_145029_jpg.rf.7bf65ac7d5d4f934ebfd179e7ad97968.jpg
5_atss,fold_5,2,1,1,0,-1,0049_jpg.rf.d9e63c2316d02b96968a7dd44061b337.jpg
5_atss,fold_5,1,0,0,0,-1,230512_150124_jpg.rf.a1dce64e321706af2f260a6b933ae5d1.jpg
5_atss,fold_5,1,0,0,0,-1,20230512_145108_jpg.rf.cfa16a281bcee146efbf5aac473021a3.jpg
5_atss,fold_5,3,0,0,0,-3,20230512_145127_jpg.rf.2e6c583887c26feb5d54542c0b963ea1.jpg
5_atss,fold_5,7,0,0,0,-7,IMG_20230512_151451_jpg.rf.2218d423d5bccf8392a803b3052b5d3b.jpg
5_atss,fold_5,5,1,1,0,-4,0230512_145345_jpg.rf.349c9a4b5a46e8d3477462f4e4215cba.jpg
5_atss,fold_5,11,3,3,0,-8,20230512_151908_jpg.rf.b315ad5e28b7bf0551708d4ea9d3dd39.jpg
5_atss,fold_5,12,0,0,0,-12,20230512_152237_jpg.rf.808fe6741a783c4fa83bfabf79676eac.jpg
5_atss,fold_5,1,0,0,0,-1,20230512_151806-0-_jpg.rf.ee8c0cb2ceb0752fb58a7e8380a489b8.jpg
5_atss,fold_5,5,0,0,0,-5,20230512_152311_jpg.rf.5e824954dc303eba4a13e80481374d92.jpg
5_atss,fold_5,5,0,0,0,-5,IMG_20230512_151619_jpg.rf.602d997ec01411a318e031faecec475a.jpg
5_atss,fold_5,8,2,2,0,-6,20230512_150205_jpg.rf.af4ff5234c4e2039ba4aa43dfef61137.jpg
5_atss,fold_5,1,1,1,0,0,20230512_151641_jpg.rf.9d3677c71aedef7846514f40d39cc285.jpg
5_atss,fold_5,1,0,0,0,-1,IMG_4396_JPG.rf.a6ca21b5c9e64200051d628058fac8d3.jpg
5_atss,fold_5,4,2,2,0,-2,IMG_20230512_151255_jpg.rf.7a344a314dbceac482eaa7344270d575.jpg
5_atss,fold_5,3,0,0,0,-3,20230512_145413_jpg.rf.d92c86a64c63fad8780cddf8f9af65d7.jpg
5_atss,fold_5,15,1,1,0,-14,IMG_20230512_153000_904_jpg.rf.0910e6a7b929687a7f2cb7d8110febe6.jpg
5_atss,fold_5,3,0,0,0,-3,IMG_3864_JPG.rf.0b9655ea20ce691d9f9006c6ab150d3c.jpg
5_atss,fold_5,10,0,0,0,-10,230512_145026_jpg.rf.f23932c58f897cb3d0594cc7af5c44f4.jpg
5_atss,fold_5,6,0,0,0,-6,230512_150021_jpg.rf.9f8dde8cf7d3e52b983f2e1dee1f56d6.jpg
5_atss,fold_5,21,0,0,0,-21,20230512_152319_jpg.rf.3d825a3794a8b316d78f9af2806a7c6c.jpg
5_atss,fold_5,1,0,0,0,-1,20230512_152353_jpg.rf.ed8431bc0af772a21f7e6f7b52b33d4e.jpg
5_atss,fold_5,10,1,1,0,-9,20230512_151345_jpg.rf.4dd52a96ef715b94641151e55cadac59.jpg
5_atss,fold_5,6,3,3,0,-3,20230512_145401_jpg.rf.44167fa74f8667ec2ab9d47632567ba8.jpg
5_atss,fold_6,1,0,0,0,-1,IMG_3918_JPG.rf.73a732415980a079e2ee9f088f0b902b.jpg
5_atss,fold_6,3,0,0,0,-3,20230512_150304_jpg.rf.42997b281c38f2d2e1caa252c8202466.jpg
5_atss,fold_6,1,0,0,0,-1,20230512_145018_jpg.rf.6120633e9f3b01a0322386f7107b3216.jpg
5_atss,fold_6,2,1,1,0,-1,IMG_20230512_151746_jpg.rf.e11cc2bdd754b8c380d4b2f51b494333.jpg
5_atss,fold_6,1,0,0,0,-1,IMG_3859_JPG.rf.217ab58b1022e7dbdcc07a4a48bdf055.jpg
5_atss,fold_6,3,0,0,0,-3,20230512_151142_jpg.rf.959c44ca45dfd6e8f7458240928724a4.jpg
5_atss,fold_6,7,6,5,1,-1,IMG_20230512_153034_jpg.rf.d2546314233e70df166dd444373fe566.jpg
5_atss,fold_6,39,0,0,0,-39,20230512_150259_jpg.rf.640d17e1a5cec14371d2ef32c74c215b.jpg
5_atss,fold_6,1,1,1,0,0,20230512_151613-0-_jpg.rf.d6f5456bcfe941a2766b34ca25d6e64c.jpg
5_atss,fold_6,1,0,0,0,-1,20230512_151247_jpg.rf.559bbd96f04ed0b61011356b33038efb.jpg
5_atss,fold_6,12,9,9,0,-3,20230512_151901-0-_jpg.rf.23717847adee37125505701d84f8b2c4.jpg
5_atss,fold_6,2,1,1,0,-1,0230512_145403_jpg.rf.86e849309856a70f7343d14e0be80d1f.jpg
5_atss,fold_6,18,5,5,0,-13,20230512_150212-0-_jpg.rf.42aaa169dabc6e224af1ad2603fa77d9.jpg
5_atss,fold_6,1,1,1,0,0,IMG_20230512_150958_jpg.rf.806f513ed04cbf893c8a805d028e17a5.jpg
5_atss,fold_6,6,2,1,1,-4,IMG_20230512_150849_517_jpg.rf.8292597aeb2edd9ad9a8634d1e6ce325.jpg
5_atss,fold_6,5,2,2,0,-3,20230512_153406_jpg.rf.5fd9ed7f498c063bbe363af58bf64afe.jpg
5_atss,fold_6,1,1,1,0,0,20230512_145139_jpg.rf.1ccaa55656a3b72abb079fcaca9ebd91.jpg
5_atss,fold_6,9,1,1,0,-8,20230512_145207_jpg.rf.d6520c0b52ca9d11cbdb08e7fcad7279.jpg
5_atss,fold_6,1,1,1,0,0,20230512_151709_jpg.rf.67e1deefca206f50f10d35552ae2213f.jpg
5_atss,fold_6,9,5,5,0,-4,20230512_152229_jpg.rf.f718118201e6c3b0a3b3d89958725c05.jpg
5_atss,fold_6,18,4,4,0,-14,20230512_151030_jpg.rf.99cd8001fdf2562bbd43c3e28ec3bc18.jpg
5_atss,fold_6,1,1,1,0,0,0016_jpg.rf.2a262f7303067736073549486906cc43.jpg
5_atss,fold_6,1,1,1,0,0,20230512_151651_jpg.rf.d9eebb8d47a3a2ecc2b5ab5fce867c62.jpg
5_atss,fold_6,3,4,3,1,1,IMG_20230512_151216_jpg.rf.212dba7457c89d85163142d3417d011a.jpg
5_atss,fold_6,2,1,1,0,-1,20230512_151754_jpg.rf.54ba86e6a384ea604ca2e9b48b6baaf5.jpg
5_atss,fold_6,7,2,0,2,-5,MG_20230512_145052_jpg.rf.e48facc3a59ffc87c5c20e1e858d782f.jpg
5_atss,fold_6,1,1,1,0,0,20230512_145105_jpg.rf.773b834198bf17c51531470842565757.jpg
5_atss,fold_6,2,0,0,0,-2,20230512_150310_jpg.rf.1c8474c411cc1309fdcb6f4f05ad76e7.jpg
5_atss,fold_6,11,4,4,0,-7,IMG_20230512_151242_jpg.rf.46afd180ee87359123f370468c16ecd9.jpg
5_atss,fold_6,7,4,3,1,-3,IMG_20230512_150822_610_jpg.rf.202648ab81c8a246ef6e9d92f76fc793.jpg
5_atss,fold_6,13,6,5,1,-7,0230512_150158_jpg.rf.87404c9e49a82e56c7dade7c3898effc.jpg
5_atss,fold_6,3,0,0,0,-3,20230512_145214_jpg.rf.7dff106d138e1a8492bda9d8a939f1df.jpg
5_atss,fold_6,12,5,4,1,-7,20230512_150028_jpg.rf.af876dc827626d5f87a6fe1e271ef879.jpg
5_atss,fold_6,10,2,2,0,-8,20230512_150924_jpg.rf.e5426caf129241e7f71edfd6460ffb7b.jpg
5_atss,fold_6,36,3,3,0,-33,IMG_20230512_150302_jpg.rf.9b111acf170d8c1671212ec46ca5f96b.jpg
5_atss,fold_6,2,1,0,1,-1,IMG_3855_JPG.rf.3c07d7a3a717987d18e4881f741f0109.jpg
5_atss,fold_6,42,7,4,3,-35,0002_jpg.rf.e28c19f2eeb804b4f3db5cb8a9b96722.jpg
5_atss,fold_6,2,2,2,0,0,20230512_151519_jpg.rf.a798ec75f634d9c0b2099d74e6391b2f.jpg
5_atss,fold_6,1,1,1,0,0,20230512_145231_jpg.rf.5067ec9a11eb10e94f1992fa7b9fdca9.jpg
5_atss,fold_6,6,2,2,0,-4,20230512_151813_jpg.rf.8e04e5f09260558a80ad8ed222a6842d.jpg
5_atss,fold_6,17,9,9,0,-8,0039_jpg.rf.24da2dcb61a34ae88e4e3ae85334ec49.jpg
5_atss,fold_6,2,0,0,0,-2,IMG_4016_JPG.rf.57796edbcc20ef6bb7930ae2c9b790e7.jpg
5_atss,fold_6,9,2,2,0,-7,0230512_150107_jpg.rf.255ebb7bf873cd1fb62870dd946c636b.jpg
5_atss,fold_6,1,1,1,0,0,IMG_4045_JPG.rf.5fd568888c253fc15e61ef0e6a600736.jpg
5_atss,fold_6,2,1,1,0,-1,20230512_151706_jpg.rf.a1ec45640c8ceaf421bdd396abbff09a.jpg
5_atss,fold_6,5,1,1,0,-4,IMG_20230512_150931_075_jpg.rf.e33516383d2c37617b8a3623da6f46df.jpg
5_atss,fold_6,2,1,1,0,-1,20230512_150045-0-_jpg.rf.e0a79a709ca27bbd1ddee5f8a4336ea8.jpg
5_atss,fold_6,5,4,4,0,-1,20230512_152227_jpg.rf.0537631b05bb432698dc401e82e41cdd.jpg
5_atss,fold_6,6,4,4,0,-2,20230512_151547_jpg.rf.11083d91d633eac77747e3332d593385.jpg
5_atss,fold_6,12,3,3,0,-9,20230512_151043_jpg.rf.3411f895e2985588186e8495e99b2a5d.jpg
5_atss,fold_6,2,1,1,0,-1,20230512_150754_jpg.rf.25cdffe09e3da5825e5287e9707d28b7.jpg
5_atss,fold_6,2,1,1,0,-1,20230512_150054_jpg.rf.d397e2f4f89585ae423d36316b68e0d3.jpg
5_atss,fold_6,1,1,1,0,0,20230512_151658_jpg.rf.64accf87df1b759e733862bd5826d73c.jpg
5_atss,fold_6,9,4,4,0,-5,20230512_150251_jpg.rf.5e1c1bb0e6397c87b2959920705bf3e4.jpg
5_atss,fold_6,1,1,0,1,0,20230512_145027_jpg.rf.ec568ee157ffdc70fa125022bd4e2226.jpg
5_atss,fold_6,24,11,8,3,-13,IMG_3929_JPG.rf.a2180d03c20d1cfeece3cc8d116bef58.jpg
5_atss,fold_6,6,3,3,0,-3,IMG_20230512_145356_jpg.rf.aade91e03425891ebb1e7913c596a6bb.jpg
5_atss,fold_6,4,0,0,0,-4,20230512_151320_jpg.rf.000a402e9a61ca254ddb3eb836b8d52e.jpg
5_atss,fold_6,1,1,0,1,0,20230512_150053_jpg.rf.088308ae98c13a53c0cd09a0c5d7873d.jpg
5_atss,fold_6,2,1,1,0,-1,IMG_4030_JPG.rf.d581bcd4c0908b4512a05d8d538db640.jpg
5_atss,fold_6,2,0,0,0,-2,20230512_145101_jpg.rf.2e2ab39bfad17ac6cf7a40fbca0233b7.jpg
5_atss,fold_6,11,5,5,0,-6,20230512_151319_jpg.rf.95cf4d71c19232b1c36b69b6329abdb6.jpg
5_atss,fold_6,1,1,1,0,0,20230512_145222_jpg.rf.dc5b10230a198c45f4f849d8bea6cf45.jpg
5_atss,fold_6,13,9,9,0,-4,0003_jpg.rf.a4014333632a8045d62b2480bccb288b.jpg
5_atss,fold_6,21,4,2,2,-17,IMG_20230512_150346_jpg.rf.5eb42adbd89cd335587264e87d4a07ea.jpg
5_atss,fold_6,2,2,1,1,0,20230512_151742_jpg.rf.734b217dddc054e2dbb00d9964713986.jpg
5_atss,fold_6,1,0,0,0,-1,20230512_145328_jpg.rf.dcfa7faebf8b77528401b336abf6eaad.jpg
5_atss,fold_6,5,4,4,0,-1,20230512_145335_jpg.rf.896d2a48efad0e17923f2fec260761b0.jpg
5_atss,fold_6,4,1,1,0,-3,IMG_4386_JPG.rf.642872f82064187dff74f15b1ff0a923.jpg
5_atss,fold_6,2,1,0,1,-1,20230512_150049_jpg.rf.e1512981920c32d09de9c291359753fd.jpg
5_atss,fold_6,2,1,0,1,-1,IMG_3848_JPG.rf.6bccac66dae879c76b4ff16dd5be0243.jpg
5_atss,fold_6,4,1,0,1,-3,0230512_145343_jpg.rf.fcd20fb05b55e0279971dbad416be7a2.jpg
5_atss,fold_6,5,2,2,0,-3,IMG_4092_JPG.rf.3e9ac49e2c6b51adac2c75ecdf6ebc5b.jpg
5_atss,fold_6,5,3,2,1,-2,20230512_150110_jpg.rf.36e77e8ab39d8ce0cccdd59c9e84ceca.jpg
5_atss,fold_6,2,2,2,0,0,IMG_20230512_150928_jpg.rf.713e71e29e1ae02d5cdba88b3134bae9.jpg
5_atss,fold_6,3,0,0,0,-3,230512_150127_jpg.rf.85daac8693c9a5866ff2f7839d81d2e8.jpg
5_atss,fold_6,2,2,2,0,0,20230512_145048_jpg.rf.6202c446935381c48cf520aa5c6640f6.jpg
5_atss,fold_6,16,1,0,1,-15,IMG_3930_JPG.rf.7a6e996e69e203ed4aa5de3126a2d2ee.jpg
5_atss,fold_6,10,9,8,1,-1,20230512_152223_jpg.rf.9ee2de301ef5a2a10d57b30f309a7d84.jpg
5_atss,fold_6,7,5,5,0,-2,IMG_4057_JPG.rf.62dc219aee41c1e1eeb47a2bd511e5f0.jpg
5_atss,fold_6,29,1,1,0,-28,0512_150154_jpg.rf.6ab493c468717275a5b2b74420a88180.jpg
5_atss,fold_6,13,6,6,0,-7,IMG_20230512_153036_jpg.rf.92b3c0599c74bfff25f17f2e97011b27.jpg
5_atss,fold_6,4,0,0,0,-4,0230512_145357_jpg.rf.bb3b0c47d3344c5f0714c51d50f9eab8.jpg
5_atss,fold_6,6,3,3,0,-3,20230512_145337_jpg.rf.eb0881ecd757c868e839b7663c8ec930.jpg
5_atss,fold_6,1,0,0,0,-1,230512_150306_jpg.rf.57428899933c6b401506a61768585669.jpg
5_atss,fold_6,3,2,2,0,-1,20230512_151543_jpg.rf.10d24602404882d9cc93169ca45912de.jpg
5_atss,fold_6,101,8,8,0,-93,0108_jpg.rf.e585b32f135131ce6476b6962a9dbad4.jpg
5_atss,fold_6,18,10,10,0,-8,20230512_152242_jpg.rf.db9cf140b85724a386050e2debe57fa2.jpg
5_atss,fold_6,8,4,4,0,-4,20230512_145153_jpg.rf.31de3120042ffe1cc96af5b129c48c8d.jpg
5_atss,fold_6,2,1,1,0,-1,20230512_151240_jpg.rf.d86e0b8b1457d5a8b4c4c2db8c1e9b84.jpg
5_atss,fold_6,2,0,0,0,-2,20230512_145338_jpg.rf.210a3a3cfad0b0ee89036fcc677c1076.jpg
5_atss,fold_6,4,1,1,0,-3,IMG_4094_JPG.rf.fc1f6e86b3b032266a05b3508e461113.jpg
5_atss,fold_6,2,1,1,0,-1,IMG_20230512_151944_jpg.rf.d5aeefc60fa0f36a43c0496ef0aef803.jpg
5_atss,fold_6,3,2,2,0,-1,20230512_145339_jpg.rf.bf7369afe55b64f770770e2bc84385eb.jpg
5_atss,fold_6,18,6,6,0,-12,IMG_20230512_152305_jpg.rf.12f543505870e65321b9087ee0584124.jpg
5_atss,fold_6,2,1,1,0,-1,IMG_4025_JPG.rf.8d3de7ea571de848fc149e176c6897c3.jpg
5_atss,fold_6,1,0,0,0,-1,20230512_151505-0-_jpg.rf.55f9872a1224dfaeaf8fca6da2616e98.jpg
5_atss,fold_6,20,2,2,0,-18,IMG_20230512_150212_422_jpg.rf.e76cd69c3a527a0ab898b69fef489876.jpg
5_atss,fold_6,6,2,2,0,-4,20230512_150139_jpg.rf.84eb5a1f5ed3efe7d09bc7dd51a476e8.jpg
5_atss,fold_6,2,0,0,0,-2,20230512_145013_jpg.rf.5b923d696845fee91efca209fb16b8b7.jpg
5_atss,fold_6,2,2,2,0,0,20230512_153004_jpg.rf.362642eaeb26a8549f4da1202eebd478.jpg
5_atss,fold_6,15,0,0,0,-15,20230512_153313_jpg.rf.77943aee7a7bf04a3db49e3f4dc00814.jpg
5_atss,fold_6,1,1,1,0,0,20230512_153355_jpg.rf.8223bc454d4e607609c33d5982f02df2.jpg
5_atss,fold_6,11,2,2,0,-9,20230512_151544_jpg.rf.3baf349b8c061da5ae2bbe4333bd3506.jpg
5_atss,fold_6,4,2,2,0,-2,IMG_20230512_151443_jpg.rf.72eb3bb7a6af81a16f5db60357cc4e37.jpg
5_atss,fold_6,18,7,7,0,-11,IMG_20230512_152317_jpg.rf.7f9c7624fac8ec2441ebdd0d2ba16ec5.jpg
5_atss,fold_6,3,2,2,0,-1,IMG_20230512_145132_jpg.rf.d215e294ca9ff5ec89558b9b78083b48.jpg
5_atss,fold_6,2,2,2,0,0,0230512_145400_jpg.rf.2839dc03d44af92c89a92bc7b644ab85.jpg
5_atss,fold_6,1,0,0,0,-1,20230512_150224_jpg.rf.f64a4cfe331fa0a225b85de2782b4b40.jpg
5_atss,fold_6,1,1,1,0,0,IMG_20230512_151810_jpg.rf.82616c1ceb56e348dbbddc1a08161690.jpg
5_atss,fold_6,1,1,1,0,0,20230512_145333_jpg.rf.afbd586b0c1d9f54c3d3ea178568eb9d.jpg
5_atss,fold_6,5,3,3,0,-2,230512_150144_jpg.rf.17c847f6562b5ceb1d19a0239be452dc.jpg
5_atss,fold_6,5,3,2,1,-2,20230512_153523_jpg.rf.94e20d7417dcd4856650e05b3a708e35.jpg
5_atss,fold_6,17,10,10,0,-7,IMG_20230512_152414_jpg.rf.2a84950ae556ac2909c0e739dbdb963e.jpg
5_atss,fold_6,7,7,7,0,0,IMG_4101_JPG.rf.8c4f8e4e10187eb9df93264151a1ed8d.jpg
5_atss,fold_6,4,0,0,0,-4,230512_145050_jpg.rf.c9c628742a57d86b1f31849454a8559b.jpg
5_atss,fold_6,2,2,2,0,0,20230512_151702_jpg.rf.0456f0fe756386f89c4b23d655ea901b.jpg
5_atss,fold_6,13,6,4,2,-7,20230512_150113_jpg.rf.3a5a13ac96bac5c0e6e2c49bc83c904b.jpg
5_atss,fold_6,11,3,3,0,-8,20230512_151044_jpg.rf.bd2efab172db3bb0ca6ce2ff37f6a8ca.jpg
5_atss,fold_6,3,2,2,0,-1,20230512_145339-0-_jpg.rf.fea54fcbceb00e71f078268b9b40d178.jpg
5_atss,fold_6,1,0,0,0,-1,20230512_150234_jpg.rf.f07768807cd91c66efa0a831a47227f2.jpg
5_atss,fold_6,1,1,1,0,0,20230512_152328_jpg.rf.2ee5fc7202b8e73c23dedf7899bfd23d.jpg
5_atss,fold_6,1,0,0,0,-1,20230512_150736_jpg.rf.86dffaa733e76af31361da63d1f9c5be.jpg
5_atss,fold_6,1,1,1,0,0,IMG_20230512_151152_632_jpg.rf.e78de54f18056ed239e1e53f8b27b606.jpg
5_atss,fold_6,1,0,0,0,-1,IMG_20230512_145000_jpg.rf.08a86ebaadb5647031d884039f76ad3d.jpg
5_atss,fold_6,5,3,3,0,-2,MG_20230512_145246_jpg.rf.c35a60cd9e1280159604c5915a9e199e.jpg
5_atss,fold_6,1,0,0,0,-1,20230512_151222_jpg.rf.77904cc81033fc2ad3a414b07b9c1b2e.jpg
5_atss,fold_6,14,5,4,1,-9,IMG_20230512_145147_jpg.rf.8cac9a120dccf5b1ce92992c1c714c4d.jpg
5_atss,fold_6,18,5,5,0,-13,0201_jpg.rf.517ca1ec56a693f7c628bd07b5acdfc2.jpg
5_atss,fold_6,1,1,1,0,0,20230512_151615_jpg.rf.3d0f727d5e2b61ba73995558758dffb3.jpg
5_atss,fold_6,6,4,4,0,-2,IMG_4097_JPG.rf.4f85a4c675f81cdca11f141abb8d7c2d.jpg
5_atss,fold_6,2,2,2,0,0,20230512_151705-0-_jpg.rf.3ca3d09e046dc693a1fb88dca9ebaa3b.jpg
5_atss,fold_6,2,0,0,0,-2,20230512_153408_jpg.rf.b5d7a9cb1b0260613799e2d57092c4ec.jpg
5_atss,fold_6,1,0,0,0,-1,IMG_20230512_151127_629_jpg.rf.f41df076266191a6a8a7eca7b189e061.jpg
5_atss,fold_6,1,1,1,0,0,0028_jpg.rf.2103488effe87e7c2da4cf07f6ed7f75.jpg
5_atss,fold_6,4,2,2,0,-2,IMG_4054_JPG.rf.c3d803491fea4d419a745a606ab372e6.jpg
5_atss,fold_6,6,3,3,0,-3,0061_jpg.rf.9c87cf09deaf73a61f5ac233c2bdb702.jpg
5_atss,fold_6,1,1,1,0,0,20230512_145032_jpg.rf.a2eb942256aef666c2ddc91b6c22b7a5.jpg
5_atss,fold_6,1,0,0,0,-1,20230512_145138_jpg.rf.04549600bf4eee12b13c6119d3c35a78.jpg
5_atss,fold_6,3,2,2,0,-1,20230512_150019_jpg.rf.3831013b1b3289f609c139cb5b3ee2d0.jpg
5_atss,fold_6,5,2,2,0,-3,IMG_20230512_151248_jpg.rf.fd83e7f5d0f84675cb06da482f588b3b.jpg
5_atss,fold_6,1,0,0,0,-1,20230512_150810_jpg.rf.ca47a1fafa212b60e926b93e5eb8674b.jpg
5_atss,fold_6,5,3,3,0,-2,20230512_145436_jpg.rf.f86063716cf890f2f2412ed2bc009f84.jpg
5_atss,fold_6,12,3,2,1,-9,20230512_150103_jpg.rf.7c63165e8e1129a671cb603fa47109d8.jpg
5_atss,fold_6,1,0,0,0,-1,0019_jpg.rf.f929e8c0a480b1ec40d48ffa32427490.jpg
5_atss,fold_6,15,2,2,0,-13,20230512_151327_jpg.rf.d5fc64b9888dff7235c7da7317d07fc0.jpg
5_atss,fold_6,15,3,3,0,-12,20230512_145239_jpg.rf.36d4ca0350293c4011bd19f94bc7867d.jpg
5_atss,fold_6,9,2,2,0,-7,IMG_20230512_151048_jpg.rf.c92aa7d50112ca96c1f3bdd418f74d1c.jpg
5_atss,fold_6,1,0,0,0,-1,IMG_3917_JPG.rf.7696994544924bd6d81ad9d1ace3f843.jpg
5_atss,fold_6,5,2,2,0,-3,20230512_150057_jpg.rf.8739eeb8744698e06d085991ee1483d5.jpg
5_atss,fold_6,7,3,3,0,-4,IMG_20230512_151223_jpg.rf.af08f6dc665fcecd42728873d339f65f.jpg
5_atss,fold_6,9,7,6,1,-2,IMG_20230512_145259_jpg.rf.655fa0eaa10935cb21a8b2452c556c92.jpg
5_atss,fold_6,2,0,0,0,-2,IMG_20230512_145024_jpg.rf.48184e0191f6dc0deaabedad53f15496.jpg
5_atss,fold_6,13,9,9,0,-4,IMG_20230512_152228_454_jpg.rf.41bea2902570b7445e0f1ec3abc4a012.jpg
5_atss,fold_6,3,1,1,0,-2,230512_150042_jpg.rf.333656aaee32bab812e48513c9f469d1.jpg
5_atss,fold_6,2,1,1,0,-1,20230512_145431_jpg.rf.026561e5d2d5a23868267be144014c1a.jpg
5_atss,fold_6,2,1,1,0,-1,IMG_4029_JPG.rf.5a655364af1d770d5e464fd022215d30.jpg
5_atss,fold_7,12,0,0,0,-12,IMG_20230512_152242_316_jpg.rf.640eb728992e501ad35261a525ddcd6f.jpg
5_atss,fold_7,21,0,0,0,-21,20230512_153312_jpg.rf.9bc8be12c2f1c3b853b5dd7ce2de2445.jpg
5_atss,fold_7,1,0,0,0,-1,IMG_4043_JPG.rf.3fd3ae2706b1bd88e07090f3f20fe829.jpg
5_atss,fold_7,1,0,0,0,-1,20230512_145250_jpg.rf.effdab3112b728049f9a595e68cc1fbe.jpg
5_atss,fold_7,2,0,0,0,-2,IMG_3845_JPG.rf.99db8c1cc5267eb444c95ebe84cd88ba.jpg
5_atss,fold_7,2,0,0,0,-2,20230512_151759-0-_jpg.rf.9397d17b6e9b50b8b3327c1f6e7e4e13.jpg
5_atss,fold_7,23,0,0,0,-23,20230512_153047_jpg.rf.c2e7222d0e6d439a279014b9de708707.jpg
5_atss,fold_7,1,0,0,0,-1,IMG_20230512_144936_jpg.rf.02a75ef0c1666837558e6b5e99086463.jpg
5_atss,fold_7,4,0,0,0,-4,IMG_20230512_145250_052_jpg.rf.22501a15b7ee521908502f0562f1943b.jpg
5_atss,fold_7,1,0,0,0,-1,IMG_20230512_151943_jpg.rf.245470432c5353d43170f1aa8d72aa47.jpg
5_atss,fold_7,15,0,0,0,-15,20230512_152312_jpg.rf.27e0a448e297ab33c52fb903a0a61757.jpg
5_atss,fold_7,22,0,0,0,-22,IMG_20230512_150103_jpg.rf.0a6f19ce6332956f8b29791a9f2bfd27.jpg
5_atss,fold_7,18,0,0,0,-18,20230512_150003_jpg.rf.4bee1a84712696acd3c6434f86ac8310.jpg
5_atss,fold_7,3,0,0,0,-3,20230512_150158_jpg.rf.38b8f697e558e1ec0f9c87c946a7c86d.jpg
5_atss,fold_7,3,0,0,0,-3,20230512_145319_jpg.rf.cd5fadb6c5fddffa67d73b8b37272f64.jpg
5_atss,fold_7,30,0,0,0,-30,20230512_150004_jpg.rf.495dbb753fb5fd527e14101c52213803.jpg
5_atss,fold_7,1,0,0,0,-1,20230512_151613_jpg.rf.e0b45cee6190ca8866233157c4462548.jpg
5_atss,fold_7,0,0,0,0,0,IMG_20230512_150254_jpg.rf.a5c0f01d411bde413dbb553e6557c16f.jpg
5_atss,fold_7,2,0,0,0,-2,IMG_20230512_145306_094_jpg.rf.09cc5cc7fd6ffa704dffb84466385562.jpg
5_atss,fold_7,16,0,0,0,-16,20230512_152241_jpg.rf.9b0739a668aaaecd1a1d3e7bf8b2688f.jpg
5_atss,fold_7,1,0,0,0,-1,20230512_145417_jpg.rf.db3be61a74c7e02c4d1054b72f46745b.jpg
5_atss,fold_7,7,0,0,0,-7,20230512_151546_jpg.rf.650e7a29638d0dabdf27fcfefcab07cb.jpg
5_atss,fold_7,3,0,0,0,-3,20230512_152322_jpg.rf.53fd89be056ce49374a18ace4aa4f447.jpg
5_atss,fold_7,2,0,0,0,-2,20230512_150824_jpg.rf.9590430380cde837c5b86f877c2bf080.jpg
5_atss,fold_7,1,0,0,0,-1,20230512_151604_jpg.rf.39e93e2b60bed55a4fb26d60d17f81ce.jpg
5_atss,fold_7,6,0,0,0,-6,20230512_152250_jpg.rf.0c23d9c9105722daa1a62bbed8129065.jpg
5_atss,fold_7,10,0,0,0,-10,20230512_153314_jpg.rf.fdc2e0650616a2e23fae79ddbc6b98bb.jpg
5_atss,fold_7,1,0,0,0,-1,20230512_151540_jpg.rf.6fc0f7a0e69e619bbef3fea84a825105.jpg
5_atss,fold_7,9,0,0,0,-9,IMG_20230512_150115_jpg.rf.93d6ec31991ffdb896e9bf82280f1f99.jpg
5_atss,fold_7,19,0,0,0,-19,20230512_150010_jpg.rf.620f860344c0524a1ea0d2095e555387.jpg
5_atss,fold_7,1,0,0,0,-1,0230512_145318_jpg.rf.98f8a12ed2e48f7e62edcc542f5a7a3b.jpg
5_atss,fold_7,9,0,0,0,-9,20230512_151513_jpg.rf.9ba62843997a0b42cb30d66d35cfe761.jpg
5_atss,fold_7,2,0,0,0,-2,20230512_145051_jpg.rf.603261488d01ac12c49ce95447252a07.jpg
5_atss,fold_7,3,0,0,0,-3,20230512_151745_jpg.rf.26e57cd112d09282bbedc612b9e3bddc.jpg
5_atss,fold_7,29,0,0,0,-29,IMG_20230512_150104_jpg.rf.d5cb8950b8524a6e8b69b37121f816be.jpg
5_atss,fold_7,11,0,0,0,-11,IMG_20230512_151854_jpg.rf.96120163430ff0d69f2a3b4c65cf13be.jpg
5_atss,fold_7,1,0,0,0,-1,20230512_151443_jpg.rf.02c0d1f9196b0a7db17357b113fa32ed.jpg
5_atss,fold_7,4,0,0,0,-4,0059_jpg.rf.9ac56781472ffe9dda122b176baf1512.jpg
5_atss,fold_7,8,0,0,0,-8,IMG_20230512_145441_jpg.rf.6b7c2d8bfc0ced9198b112d0d6ade7e2.jpg
5_atss,fold_7,11,0,0,0,-11,20230512_145235_jpg.rf.7588a0153c1b25a775a82b15cb976f2d.jpg
5_atss,fold_7,1,0,0,0,-1,IMG_20230512_151147_269_jpg.rf.6170f9ba05705d7d45cbb1c21073f67c.jpg
5_atss,fold_7,3,0,0,0,-3,20230512_150145_jpg.rf.8935abf1c95d41b2b953913a4d6f31f7.jpg
5_atss,fold_7,14,0,0,0,-14,IMG_20230512_152216_096_jpg.rf.adf03897848531ce89d004439a8fa974.jpg
5_atss,fold_7,13,0,0,0,-13,IMG_20230512_150128_jpg.rf.4b6044488f522150e791a223d8868723.jpg
5_atss,fold_7,15,0,0,0,-15,20230512_151529_jpg.rf.13e844f081c4efeefda4af063187f6d3.jpg
5_atss,fold_7,1,0,0,0,-1,20230512_151036_jpg.rf.f3b838a0faab4c3495dd44281c87539d.jpg
5_atss,fold_7,1,0,0,0,-1,IMG_20230512_150926_jpg.rf.592b75864e594302b259312be28a0792.jpg
5_atss,fold_7,6,0,0,0,-6,IMG_20230512_150317_jpg.rf.ac25b1898213749cb0686c2bc3130301.jpg
5_atss,fold_7,4,0,0,0,-4,0004_jpg.rf.cad1f4f7c2a5a911d6d1cdfa5f75d055.jpg
5_atss,fold_7,6,0,0,0,-6,20230512_150135_jpg.rf.d4fd2dcfb498280a8309f6f9fbf3b816.jpg
5_atss,fold_7,11,0,0,0,-11,IMG_20230512_151556_798_jpg.rf.64e451fae797a84c7394203ef45fb0a5.jpg
5_atss,fold_7,13,0,0,0,-13,IMG_20230512_152158_858_jpg.rf.1a8b5fd8c9168917604cd153b5720b1d.jpg
5_atss,fold_7,37,0,0,0,-37,0512_150144_jpg.rf.eb6f48f566e7b2e533d3c169bb9783b0.jpg
5_atss,fold_7,1,0,0,0,-1,20230512_151643_jpg.rf.cd8dd51a7f1332798879f4e5d7e928f6.jpg
5_atss,fold_7,3,0,0,0,-3,20230512_150301_jpg.rf.9f5a1e2491eb0f23ad2976622defdd66.jpg
5_atss,fold_7,1,0,0,0,-1,20230512_145434_jpg.rf.c6e724cc40d69fabc8ce6dc7f102385b.jpg
5_atss,fold_7,3,0,0,0,-3,0230512_145050_jpg.rf.2803b267b643801d5d6b63fa2d927f37.jpg
5_atss,fold_7,1,0,0,0,-1,IMG_20230512_144948_jpg.rf.982c926a32fe1a245ffd566259fcb9bb.jpg
5_atss,fold_7,6,0,0,0,-6,20230512_152308_jpg.rf.bfaaf2477f56005e5db4ac2d8a0dd0a7.jpg
5_atss,fold_7,1,0,0,0,-1,20230512_144954_jpg.rf.b91c4aef38ae9c4f6e5c0bcc155cdbb9.jpg
5_atss,fold_7,2,0,0,0,-2,20230512_145012_jpg.rf.7e7325fc33c5f9d9c92a4f4f8c48bd73.jpg
5_atss,fold_7,3,0,0,0,-3,20230512_151626_jpg.rf.ce9aac74e8994e1b51e9f517df6a0830.jpg
5_atss,fold_7,6,0,0,0,-6,IMG_20230512_145241_jpg.rf.298cf145f167e685da520bffba4d53a8.jpg
5_atss,fold_7,4,0,0,0,-4,20230512_151307_jpg.rf.21fca3895ba4bf60b18eb9cd32d76ed9.jpg
5_atss,fold_7,8,0,0,0,-8,20230512_150035_jpg.rf.590e7ece3e6e94d92163049b218f2085.jpg
5_atss,fold_7,11,0,0,0,-11,20230512_144943_jpg.rf.6e882f14ce6985046782f1fb925495d2.jpg
5_atss,fold_7,1,0,0,0,-1,20230512_151231_jpg.rf.4dc10049f8ecfe04ad41c2d1b1428792.jpg
5_atss,fold_7,46,0,0,0,-46,20230512_153213_jpg.rf.9ee2b7f723899fca4419bd4e0c4eec72.jpg
5_atss,fold_7,16,0,0,0,-16,IMG_20230512_153426_jpg.rf.13530953faa743fa6763be6d0ab583af.jpg
5_atss,fold_7,2,0,0,0,-2,20230512_151459_jpg.rf.b5fc6223eb6e9549a2bed14367997348.jpg
5_atss,fold_7,5,0,0,0,-5,IMG_20230512_145052_jpg.rf.1f1d0e8ea8a62acdeb924c64ae560628.jpg
5_atss,fold_7,1,0,0,0,-1,20230512_152330_jpg.rf.d9a6f6c4784e57ad912b6182a3fd0211.jpg
5_atss,fold_7,1,0,0,0,-1,0017_jpg.rf.324871efad4024d500a23b82191808a8.jpg
5_atss,fold_7,1,0,0,0,-1,IMG_20230512_150908_jpg.rf.753a3cfb7ff38bc8300418f88dbf331c.jpg
5_atss,fold_7,2,0,0,0,-2,20230512_151703_jpg.rf.2faae265964e4a8dd7c48f882318b9e2.jpg
5_atss,fold_7,5,0,0,0,-5,20230512_151812_jpg.rf.4e67fe81dff51295403e0c06c0621c2f.jpg
5_atss,fold_7,1,0,0,0,-1,20230512_153218_jpg.rf.64a3b9a40868420e3930fa153e76d395.jpg
5_atss,fold_7,13,0,0,0,-13,20230512_153010_jpg.rf.b8501fc8a709517e34e7cb69002aa015.jpg
5_atss,fold_7,17,0,0,0,-17,0038_jpg.rf.3f55cd3c03a14d11b3849a2a910a3773.jpg
5_atss,fold_7,1,0,0,0,-1,20230512_145247_jpg.rf.9d204b8a475593430db82a060e2456d1.jpg
5_atss,fold_7,9,0,0,0,-9,20230512_151909_jpg.rf.aead0419a0a121c39fda16a03595ab78.jpg
5_atss,fold_7,13,0,0,0,-13,20230512_153312-0-_jpg.rf.8f1668ec1eddb4c37aa8c4c6b04cdd81.jpg
5_atss,fold_7,2,0,0,0,-2,0002_jpg.rf.11a670be82fdde02b205d9929f761ed7.jpg
5_atss,fold_7,17,0,0,0,-17,20230512_150002_jpg.rf.264d90b8bb0bb75c8bbe433b3c221545.jpg
5_atss,fold_7,12,0,0,0,-12,20230512_150200_jpg.rf.2582038eca240736fe94eb2ed6cae31e.jpg
5_atss,fold_7,7,0,0,0,-7,20230512_150042_jpg.rf.613029bfbedc91e536387ccf8df16dd0.jpg
5_atss,fold_7,2,0,0,0,-2,20230512_152249_jpg.rf.04c1bebce986183bedd854bb677da384.jpg
5_atss,fold_7,2,0,0,0,-2,20230512_151701_jpg.rf.819108571877bfd9f9063c78d807263f.jpg
5_atss,fold_7,13,0,0,0,-13,IMG_20230512_145142_jpg.rf.fb2156626619cc38cf3127f70d63b5f0.jpg
5_atss,fold_7,10,0,0,0,-10,20230512_145209_jpg.rf.2f0dfe951cb0a7165c942a2117e73f0d.jpg
5_atss,fold_7,2,0,0,0,-2,20230512_145136_jpg.rf.852bd73d66d536a7a4ffbed448466961.jpg
5_atss,fold_7,5,0,0,0,-5,IMG_20230512_151217_jpg.rf.04d3195207b1eb7346b1ba52c101a706.jpg
5_atss,fold_7,8,0,0,0,-8,20230512_153130_jpg.rf.9b7bb97006640f6490a71f226200a2ca.jpg
5_atss,fold_7,2,0,0,0,-2,20230512_151638_jpg.rf.a0292d546f8d78bd93a8e0b8e16cdcad.jpg
5_atss,fold_7,17,0,0,0,-17,20230512_150154_jpg.rf.89a63f38c3d9a5091806e13ec9a0b9d0.jpg
5_atss,fold_7,8,0,0,0,-8,20230512_151851-0-_jpg.rf.fb46950ff8ddbfa6d4406784eb5e22b5.jpg
5_atss,fold_7,33,0,0,0,-33,IMG_20230512_150352_jpg.rf.c1ca8bf250991c89b762984231b93a22.jpg
5_atss,fold_7,9,0,0,0,-9,230512_150136_jpg.rf.1e2f1e90c67eb7b8f01703f120072671.jpg
5_atss,fold_7,2,0,0,0,-2,0230512_145303_jpg.rf.48b2ec4c0dbde15f8f5f8b3bd2b59378.jpg
5_atss,fold_7,1,0,0,0,-1,20230512_151014_jpg.rf.1daaabfd079316b6b36cd3f076521079.jpg
5_atss,fold_7,7,0,0,0,-7,20230512_150115_jpg.rf.1e159ea5bb7c2543a1928c133ef9b549.jpg
5_atss,fold_7,1,0,0,0,-1,20230512_151753_jpg.rf.a14249ba89cecfaa73e632b588efdfd7.jpg
5_atss,fold_7,2,0,0,0,-2,20230512_151637_jpg.rf.a44f9c09520025824affd7d45589da18.jpg
5_atss,fold_7,9,0,0,0,-9,20230512_152217_jpg.rf.a958863ea2bb344fee3c8c7b29889838.jpg
5_atss,fold_7,2,0,0,0,-2,MG_20230512_145032_jpg.rf.043a11012a2a8dcb1cee1fc40482b97d.jpg
5_atss,fold_7,6,0,0,0,-6,IMG_3831_JPG.rf.5b9e206f11628659b685b91001a564e0.jpg
5_atss,fold_7,10,0,0,0,-10,IMG_20230512_150826_018_jpg.rf.6cdf008f2fd91c8d5a59ecb707eb0a93.jpg
5_atss,fold_7,8,0,0,0,-8,IMG_4096_JPG.rf.8be1b70c0cb24617e853855e4e345ebe.jpg
5_atss,fold_7,7,0,0,0,-7,0047_jpg.rf.f81c0ac4631d37256a41aa0d36e49744.jpg
5_atss,fold_7,8,0,0,0,-8,IMG_20230512_151221_jpg.rf.1eaad9c5a6a8acb495445f202d82d696.jpg
5_atss,fold_7,2,0,0,0,-2,230512_150056_jpg.rf.63fc419be91fa960c9fdd540582bc424.jpg
5_atss,fold_7,1,0,0,0,-1,20230512_145435_jpg.rf.0381cab4fa18f72340c2377d16cc9660.jpg
5_atss,fold_7,21,0,0,0,-21,IMG_20230512_153447_jpg.rf.f9b2e4987e37b091be6072cae946d663.jpg
5_atss,fold_7,14,0,0,0,-14,20230512_150101_jpg.rf.cc96a2d607d78ec899d39fd65e3ffcef.jpg
5_atss,fold_7,5,0,0,0,-5,0230512_145402_jpg.rf.b34ea25b1c9ac3f7cc8061e80027c857.jpg
5_atss,fold_7,11,0,0,0,-11,IMG_20230512_145018_jpg.rf.d1613b46f617939d055c5b8c109e9fa3.jpg
5_atss,fold_7,3,0,0,0,-3,IMG_20230512_145338_jpg.rf.079f726ce175cc710ca12b4c3caa612c.jpg
5_atss,fold_7,6,0,0,0,-6,20230512_145402_jpg.rf.2adab9c4657dc31e00e7139d61d9500a.jpg
5_atss,fold_7,11,0,0,0,-11,0046_jpg.rf.e1528b2cf27767ce9998ebd79d287f47.jpg
5_atss,fold_7,1,0,0,0,-1,0023_jpg.rf.816619f3269b0637f700332186be4dc7.jpg
5_atss,fold_7,5,0,0,0,-5,IMG_3994_JPG.rf.3f53434cd9176d3f8187cface46b0ee0.jpg
5_atss,fold_7,6,0,0,0,-6,20230512_150209_jpg.rf.386fa5331924ef6713a22c58b720e320.jpg
5_atss,fold_7,5,0,0,0,-5,230512_150029_jpg.rf.12bae245124889830af4fc74e9e52dc8.jpg
5_atss,fold_7,4,0,0,0,-4,20230512_152303_jpg.rf.51286f7b0969a38d9408ce913d70bf49.jpg
5_atss,fold_7,5,0,0,0,-5,20230512_145222_jpg.rf.fd35bc6270e794e1ad0a42037bded3b6.jpg
5_atss,fold_7,9,0,0,0,-9,20230512_151906_jpg.rf.898831e6903935bdc29051a4dc1aec5d.jpg
5_atss,fold_7,40,0,0,0,-40,IMG_20230512_153257_jpg.rf.d9dc811045c5a29bd9426b22f724b734.jpg
5_atss,fold_7,3,0,0,0,-3,20230512_151140_jpg.rf.7db6428b7e2bbbef7dd568e63b356863.jpg
5_atss,fold_7,1,0,0,0,-1,IMG_20230512_153421_jpg.rf.6158f971c571c6c40a9f73c5154fea7e.jpg
5_atss,fold_7,3,0,0,0,-3,IMG_3991_JPG.rf.956960577cc9ffaab083d7a4f4c5bd11.jpg
5_atss,fold_7,10,0,0,0,-10,20230512_150040_jpg.rf.aa50ac3e2a5a2042940711140afd2b9a.jpg
5_atss,fold_7,1,0,0,0,-1,20230512_151227_jpg.rf.27d11f08dc002dbce0c7ab80e18ba38a.jpg
5_atss,fold_7,4,0,0,0,-4,IMG_20230512_151208_jpg.rf.be5e6b4532e99f11dd349cc77c5094ca.jpg
5_atss,fold_7,1,0,0,0,-1,IMG_20230512_150835_jpg.rf.5163b3bd6692963a73a0e71f347963cd.jpg
5_atss,fold_7,1,0,0,0,-1,20230512_153356_jpg.rf.4d48f88351e5397a697a75c05a09f970.jpg
5_atss,fold_7,2,0,0,0,-2,20230512_151054_jpg.rf.7c0b5c7091bc1f6a8f74bc553c645583.jpg
5_atss,fold_7,8,0,0,0,-8,20230512_151856_jpg.rf.e796d63958aed52d331329de4229f784.jpg
5_atss,fold_7,42,0,0,0,-42,20230512_150217_jpg.rf.43a34e583d3360fb03c78ebcf6334f2b.jpg
5_atss,fold_7,1,0,0,0,-1,20230512_151616_jpg.rf.319cd6543513a0db4c94621f3c78c207.jpg
5_atss,fold_7,1,0,0,0,-1,20230512_145235_jpg.rf.609ee666fef18c181192a729599f029f.jpg
5_atss,fold_7,17,0,0,0,-17,IMG_20230512_150105_jpg.rf.570debb8303e1ced483c9d4a2731ffec.jpg
5_atss,fold_7,15,0,0,0,-15,IMG_20230512_153006_493_jpg.rf.8cb0e9085e5e5a8d382f8e2647075293.jpg
5_atss,fold_7,1,0,0,0,-1,20230512_151335_jpg.rf.28b2031d23e55f8020b7aa20b9efc752.jpg
5_atss,fold_7,1,0,0,0,-1,IMG_20230512_145233_jpg.rf.d273d9a04013a4fdb680069c5f2e4780.jpg
5_atss,fold_7,1,0,0,0,-1,IMG_3841_JPG.rf.adc4a928f5d56c89691b1d5525a2cb06.jpg
5_atss,fold_7,23,0,0,0,-23,20230512_150127_jpg.rf.f6e969d7228c49f8b298a15c5ea0d88d.jpg
5_atss,fold_7,8,0,0,0,-8,20230512_150319_jpg.rf.71d19e64b856b04c9ab111407595de18.jpg
5_atss,fold_7,8,0,0,0,-8,20230512_151037_jpg.rf.85e4a64b3db494811f84775d729cc9e7.jpg
5_atss,fold_7,1,0,0,0,-1,IMG_4393_JPG.rf.47566015c2485f15e5114808d8a0d4ed.jpg
5_atss,fold_7,2,0,0,0,-2,IMG_20230512_151816_jpg.rf.8fba275d23a787980bb56f34532a5efd.jpg
5_atss,fold_7,6,0,0,0,-6,20230512_151851_jpg.rf.96579435ffaa9d451e63a406f34fab4e.jpg
5_atss,fold_7,3,0,0,0,-3,IMG_4388_JPG.rf.1ddaadb8d3afe73ea7e33c9a29acec1e.jpg
5_atss,fold_7,19,0,0,0,-19,IMG_20230512_150059_992_jpg.rf.b49a36b89c3ed0b8925e2ad7f1b905b9.jpg
5_atss,fold_7,13,0,0,0,-13,230512_150153_jpg.rf.fb4c5b04651624464aee8747090f6cee.jpg
5_atss,fold_7,9,0,0,0,-9,20230512_150329_jpg.rf.fd5367a6796a2fc3f0181a6e4c4b9513.jpg
5_atss,fold_7,1,0,0,0,-1,230512_150122_jpg.rf.d2ef84171022dfe6b7f85166ab202b72.jpg
5_atss,fold_7,6,0,0,0,-6,IMG_20230512_151041_jpg.rf.eda52b9119a16dac9d1d2632ea4d34bd.jpg
5_atss,fold_8,26,0,0,0,-26,20230512_153257_jpg.rf.b0ed75a4fd63f8fa4923e04bdb1c38e2.jpg
5_atss,fold_8,7,0,0,0,-7,20230512_152257_jpg.rf.25eef75e9cfc61b58dc03da8328d53ad.jpg
5_atss,fold_8,9,0,0,0,-9,230512_150137_jpg.rf.a07a63205732aea6ea773793a5a4e25c.jpg
5_atss,fold_8,2,0,0,0,-2,IMG_20230512_145254_jpg.rf.dfd1ca61f82842fe96ba39de8974f5d4.jpg
5_atss,fold_8,13,0,0,0,-13,20230512_150244_jpg.rf.1ef934795ff31c5b43b6da861b2ac051.jpg
5_atss,fold_8,4,0,0,0,-4,IMG_20230512_145320_405_jpg.rf.143f083c59c1dedbd9f3f7f157927edf.jpg
5_atss,fold_8,1,0,0,0,-1,IMG_4050_JPG.rf.242fde50c6291117b6172ee1dc45f081.jpg
5_atss,fold_8,1,0,0,0,-1,20230512_145043_jpg.rf.943869aa154c2400192f3cbbf372a136.jpg
5_atss,fold_8,1,0,0,0,-1,20230512_145034_jpg.rf.1bf97c164c29fec5dca87d03670ab344.jpg
5_atss,fold_8,2,0,0,0,-2,IMG_4034_JPG.rf.92867b137f89f18d7bfc2034cbb1597f.jpg
5_atss,fold_8,11,0,0,0,-11,20230512_150131_jpg.rf.b7b4ef28a3d5833ddf815ebcf9a8b336.jpg
5_atss,fold_8,1,0,0,0,-1,20230512_145223_jpg.rf.e86673dc1e563853935de252c1c2a11e.jpg
5_atss,fold_8,2,0,0,0,-2,20230512_145313_jpg.rf.a52df235ea36832731aa90971489567a.jpg
5_atss,fold_8,1,0,0,0,-1,20230512_151654_jpg.rf.1ff5a5051a16402ce45fe6ca565c9239.jpg
5_atss,fold_8,2,0,0,0,-2,20230512_145135_jpg.rf.4d3af6f64064db39df70b1e3672a3f63.jpg
5_atss,fold_8,1,0,0,0,-1,IMG_20230512_153408_091_jpg.rf.d4b7f029dd191b0e3fc52b4b39bf8116.jpg
5_atss,fold_8,2,0,0,0,-2,20230512_151619_jpg.rf.c7fb218f315f99ea72e78a520cc5dc68.jpg
5_atss,fold_8,65,0,0,0,-65,IMG_20230512_153155_jpg.rf.348475844dfbdea71bac7dbce8198f44.jpg
5_atss,fold_8,26,0,0,0,-26,IMG_3928_JPG.rf.b59dd1a245d0a61096acf104642a588f.jpg
5_atss,fold_8,1,0,0,0,-1,0230512_145026_jpg.rf.e1ea5177e0224a86904eddffb8258ab9.jpg
5_atss,fold_8,3,0,0,0,-3,IMG_3865_JPG.rf.85489cc903cddfc5bd27ee6328f5235e.jpg
5_atss,fold_8,17,0,0,0,-17,IMG_20230512_145019_771_jpg.rf.d4b15f5b7869ffc05f7387247c4f82ae.jpg
5_atss,fold_8,3,0,0,0,-3,IMG_3909_JPG.rf.be7478f841f6abc72fcc654df3e13ada.jpg
5_atss,fold_8,7,0,0,0,-7,20230512_151849_jpg.rf.52b8fefba379829baeca592f085340cd.jpg
5_atss,fold_8,8,0,0,0,-8,IMG_20230512_151934_jpg.rf.543796bd925563f125516769b066b214.jpg
5_atss,fold_8,2,0,0,0,-2,0008_jpg.rf.058dbc5491e7240170841cbeb7cfebca.jpg
5_atss,fold_8,2,0,0,0,-2,20230512_151804-0-_jpg.rf.da37c80768423b2be325cf7dcf3b8efd.jpg
5_atss,fold_8,4,0,0,0,-4,20230512_151138_jpg.rf.bd5d8d04a758d594acc2af15dc942b5f.jpg
5_atss,fold_8,13,0,0,0,-13,20230512_152309_jpg.rf.e6272cf81ee3a89c98dea29c7ca87fde.jpg
5_atss,fold_8,8,0,0,0,-8,20230512_150137_jpg.rf.c6db7854f50b446566afe69c0e3bae6f.jpg
5_atss,fold_8,1,0,0,0,-1,IMG_3858_JPG.rf.10b8772deec081b08895efdc83efbfcc.jpg
5_atss,fold_8,1,0,0,0,-1,20230512_151447_jpg.rf.8a684005457ea3cadf9943d40014e87f.jpg
5_atss,fold_8,9,0,0,0,-9,IMG_20230512_144959_jpg.rf.8d9a872947615acdbff5cf0776139cb9.jpg
5_atss,fold_8,17,0,0,0,-17,20230512_153021_jpg.rf.6b38fba9b80543e229dc93ffb5e19695.jpg
5_atss,fold_8,11,0,0,0,-11,20230512_151051_jpg.rf.dcb4ee42b399c0d6007719e173f728b6.jpg
5_atss,fold_8,10,0,0,0,-10,20230512_151854_jpg.rf.0809016c2e20da637cbac7d27e6fb6c0.jpg
5_atss,fold_8,2,0,0,0,-2,20230512_145219_jpg.rf.f22be001a717798eb8a2168d0d3421ab.jpg
5_atss,fold_8,5,0,0,0,-5,230512_150140_jpg.rf.7c74dbb84999f31492125730db986f40.jpg
5_atss,fold_8,10,0,0,0,-10,20230512_151021_jpg.rf.de7c03d7cc7906d7c81bff3b479fd9e5.jpg
5_atss,fold_8,11,0,0,0,-11,20230512_145237_jpg.rf.d8f058e0b402e3d1e808be861e667173.jpg
5_atss,fold_8,152,0,0,0,-152,0100_jpg.rf.05cd5bba5e3a338b9bab8b49b2c62230.jpg
5_atss,fold_8,2,0,0,0,-2,20230512_151516_jpg.rf.4075925f758530db09c215e48201f510.jpg
5_atss,fold_8,4,0,0,0,-4,IMG_20230512_151322_jpg.rf.f87bdadf921aef8dde8daecc2efda877.jpg
5_atss,fold_8,1,0,0,0,-1,20230512_151310_jpg.rf.49e186e145599c0c576f88f77a48645f.jpg
5_atss,fold_8,2,0,0,0,-2,20230512_151840_jpg.rf.225d382469feb3893ab8adf440f0dcdd.jpg
5_atss,fold_8,15,0,0,0,-15,IMG_20230512_150202_jpg.rf.605274560fcfde991ad3e82107d6fd8c.jpg
5_atss,fold_8,28,0,0,0,-28,0512_150115_jpg.rf.572fa1a857240740ab2fd9c0bd962a84.jpg
5_atss,fold_8,11,0,0,0,-11,IMG_20230512_150135_011_jpg.rf.7d2abfcfbd33399d0709cdb1f6848e09.jpg
5_atss,fold_8,1,0,0,0,-1,20230512_145421_jpg.rf.3704320bbaa6e937ed0261aa404772f1.jpg
5_atss,fold_8,14,0,0,0,-14,0042_jpg.rf.7ffcac34c8b8720199d793d39ebf099c.jpg
5_atss,fold_8,34,0,0,0,-34,0512_150108_jpg.rf.2a2b0446e2345745280376767e5d1b27.jpg
5_atss,fold_8,3,0,0,0,-3,IMG_20230512_152407_jpg.rf.987c14f960c413f0e6ece4c99d516916.jpg
5_atss,fold_8,7,0,0,0,-7,20230512_150116_jpg.rf.4cdde848ca21f7424c94dada8a3603c8.jpg
5_atss,fold_8,1,0,0,0,-1,20230512_151642_jpg.rf.8d7807db8a2c50e7601e595cb8e4d441.jpg
5_atss,fold_8,1,0,0,0,-1,IMG_20230512_161346_jpg.rf.f2d66ae86a3dee44e0234f6002702110.jpg
5_atss,fold_8,3,0,0,0,-3,20230512_151340_jpg.rf.1e7341de1b15f16ffc701c3b53542fe7.jpg
5_atss,fold_8,5,0,0,0,-5,20230512_145411_jpg.rf.962646db69e6629f3a045dc737b54f0c.jpg
5_atss,fold_8,12,0,0,0,-12,20230512_145240_jpg.rf.a5091d10c5393608b704fe2d2a846263.jpg
5_atss,fold_8,12,0,0,0,-12,IMG_20230512_152002_jpg.rf.0e50ad947bcac786ec04e7adf1df3e90.jpg
5_atss,fold_8,8,0,0,0,-8,IMG_4207_JPG.rf.330747e746ba1f08f12c25a697df8506.jpg
5_atss,fold_8,24,0,0,0,-24,IMG_20230512_150022_jpg.rf.951e0e5b24bd9b0e9ad93c5f8e19127d.jpg
5_atss,fold_8,1,0,0,0,-1,20230512_151445_jpg.rf.7d699391bb3084d81ea03299229ab140.jpg
5_atss,fold_8,3,0,0,0,-3,IMG_20230512_145332_184_jpg.rf.332c2aa459e521d0576953fca1e0a03f.jpg
5_atss,fold_8,3,0,0,0,-3,20230512_145052_jpg.rf.e4d9741a91ef6c0f9f053feb1ffe1df5.jpg
5_atss,fold_8,12,0,0,0,-12,0032_jpg.rf.bbf27b122201c3fdb2fa22a360b64846.jpg
5_atss,fold_8,4,0,0,0,-4,20230512_151300_jpg.rf.f994d9472b1ee1ddd3ac8ab3a3cc2a12.jpg
5_atss,fold_8,7,0,0,0,-7,20230512_150036_jpg.rf.409641b85ef17642977736d9dc873ae4.jpg
5_atss,fold_8,1,0,0,0,-1,IMG_20230512_144910_997_jpg.rf.93aca80524806445b3dfb1818fa4806a.jpg
5_atss,fold_8,7,0,0,0,-7,IMG_20230512_152357_jpg.rf.77160d5f48db0fa53a72198288557af6.jpg
5_atss,fold_8,7,0,0,0,-7,20230512_145341_jpg.rf.85ffc7a18e0ad722dbf476743313df02.jpg
5_atss,fold_8,16,0,0,0,-16,IMG_20230512_151902_jpg.rf.86d659e2d2eb4651a989633ff7c3cb87.jpg
5_atss,fold_8,17,0,0,0,-17,230512_150202_jpg.rf.ea33cf5fe5f6662c3682e389e8685dfb.jpg
5_atss,fold_8,12,0,0,0,-12,0048_jpg.rf.ec48089b3f18d5818c04f71cecd05f38.jpg
5_atss,fold_8,2,0,0,0,-2,IMG_4091_JPG.rf.a9405bd034e33eacf6b2883c9ed04e2e.jpg
5_atss,fold_8,13,0,0,0,-13,IMG_20230512_150158_jpg.rf.c8fd099b0d72b4e29fc1807382e042b1.jpg
5_atss,fold_8,2,0,0,0,-2,20230512_144932_jpg.rf.a725c2a7e9c0d34d34a6abd7d299f6df.jpg
5_atss,fold_8,16,0,0,0,-16,20230512_151039_jpg.rf.bb11ca2d78a6f005bcb2f521dfcf0dce.jpg
5_atss,fold_8,5,0,0,0,-5,20230512_152301_jpg.rf.3701d53ed7c06271583a063371e238d1.jpg
5_atss,fold_8,7,0,0,0,-7,IMG_20230512_145108_jpg.rf.5b77832e2c70819f5a5de9e318768425.jpg
5_atss,fold_8,3,0,0,0,-3,IMG_3849_JPG.rf.7ce1df74f4ca793d89d2042ccc5766ef.jpg
5_atss,fold_8,10,0,0,0,-10,20230512_145206_jpg.rf.4cf9a1bcd726515460c68ec0b753f06a.jpg
5_atss,fold_8,21,0,0,0,-21,IMG_20230512_150057_jpg.rf.1d901fec112c2705325b5b23647b5cfe.jpg
5_atss,fold_8,5,0,0,0,-5,20230512_151846_jpg.rf.aaa6e44ba0c35df5988efcf5a4f2510c.jpg
5_atss,fold_8,22,0,0,0,-22,IMG_20230512_153211_jpg.rf.8b8c95e482643af377a9a4d7a0182777.jpg
5_atss,fold_8,3,0,0,0,-3,0230512_145440_jpg.rf.26be693a65087ccb13d4129f4c93b786.jpg
5_atss,fold_8,9,0,0,0,-9,IMG_3931_JPG.rf.fcba871e1d94de33741779717c57137f.jpg
5_atss,fold_8,1,0,0,0,-1,20230512_145025_jpg.rf.15940c55814fd494ff830db5a9061d30.jpg
5_atss,fold_8,1,0,0,0,-1,IMG_20230512_145352_jpg.rf.1c96dea3488a61099952ab7250fce4b2.jpg
5_atss,fold_8,3,0,0,0,-3,20230512_145231_jpg.rf.77f03cc3c54cff48c03e24558d36189b.jpg
5_atss,fold_8,16,0,0,0,-16,IMG_20230512_151508_jpg.rf.c78520025916588a7657b75ae388cb8f.jpg
5_atss,fold_8,12,0,0,0,-12,IMG_20230512_145022_866_jpg.rf.245d67f93e45a020eb21fdd8f4124767.jpg
5_atss,fold_8,4,0,0,0,-4,20230512_145329_jpg.rf.0c0d42d6e893d6efcd4b3119ce990d0e.jpg
5_atss,fold_8,2,0,0,0,-2,20230512_145433_jpg.rf.5924d4f1a47105e53efa0a08085450a7.jpg
5_atss,fold_8,3,0,0,0,-3,IMG_20230512_152405_jpg.rf.ebe5f63b7b940c8d9a74c8fb5839d39b.jpg
5_atss,fold_8,6,0,0,0,-6,20230512_150204_jpg.rf.87f7c1141bc54dad9c82b36c8beb1bb9.jpg
5_atss,fold_8,1,0,0,0,-1,230512_150118_jpg.rf.ecc50b57dabc83b04e792a7ddde388f8.jpg
5_atss,fold_8,2,0,0,0,-2,20230512_150052_jpg.rf.9bdf107fc37c37b05aa46914e8882f17.jpg
5_atss,fold_8,5,0,0,0,-5,20230512_151135_jpg.rf.3b3e99725d0ae8b34747d0ed51687a4a.jpg
5_atss,fold_8,2,0,0,0,-2,230512_145056_jpg.rf.cb3d61bce2d4e0686bc0310ab76413a2.jpg
5_atss,fold_8,25,0,0,0,-25,IMG_20230512_150208_jpg.rf.14a0d0d16b6d32327bcec6959b738634.jpg
5_atss,fold_8,30,0,0,0,-30,IMG_20230512_150210_524_jpg.rf.476d8805b0160b5143ad37609399dc72.jpg
5_atss,fold_8,1,0,0,0,-1,20230512_151455_jpg.rf.ea02e305291eae5ae85ae54d0ebfe26d.jpg
5_atss,fold_8,19,0,0,0,-19,IMG_20230512_150024_jpg.rf.5425ded2475701fa14408062843212ec.jpg
5_atss,fold_8,10,0,0,0,-10,20230512_153132_jpg.rf.cac6aa1f1a0f028046df980276b5e4e6.jpg
5_atss,fold_8,1,0,0,0,-1,MG_20230512_145316_jpg.rf.4d66c8eb78cdd81e04686ee0f7aa4fdf.jpg
5_atss,fold_8,12,0,0,0,-12,20230512_152311_jpg.rf.7f2da0009f2fa07600b981c50d8d6ebf.jpg
5_atss,fold_8,1,0,0,0,-1,20230512_145036_jpg.rf.1ecc4ae3f81e22aac59d8b3b9c1034cd.jpg
5_atss,fold_8,1,0,0,0,-1,IMG_4390_JPG.rf.2018de24c221ce01e2c3239735a272af.jpg
5_atss,fold_8,14,0,0,0,-14,IMG_20230512_145158_jpg.rf.6d28bd6cb232ef60feeaaa2d893d7326.jpg
5_atss,fold_8,4,0,0,0,-4,IMG_20230512_150225_jpg.rf.5e6e4781174588e28c95f110bb49edf2.jpg
5_atss,fold_8,17,0,0,0,-17,20230512_151035_jpg.rf.7593703cffcf4a6285b53ddb6e104d39.jpg
5_atss,fold_8,5,0,0,0,-5,_20230512_150252_jpg.rf.c7786b04a48eca5fec5127b90d27efc6.jpg
5_atss,fold_8,10,0,0,0,-10,IMG_20230512_161908_jpg.rf.c3138f9567f619fcdc8eb8c700bfcff8.jpg
5_atss,fold_8,8,0,0,0,-8,20230512_150001_jpg.rf.74ea9697c92aedc234993b5551f7f1b4.jpg
5_atss,fold_8,5,0,0,0,-5,IMG_20230512_151249_373_jpg.rf.f2dd29bba78783f6fbe29e66675bd321.jpg
5_atss,fold_8,3,0,0,0,-3,IMG_20230512_151542_635_jpg.rf.1e2c1e872c81db1f473f8c586f3ce9d9.jpg
5_atss,fold_8,3,0,0,0,-3,20230512_151619-0-_jpg.rf.5d6f8d7a8176754cc78ef08a707b7ea8.jpg
5_atss,fold_8,8,0,0,0,-8,IMG_20230512_145253_jpg.rf.7d0a492e681439db3a20eb64e356d8ff.jpg
5_atss,fold_8,2,0,0,0,-2,20230512_151636_jpg.rf.0e80ecb006eb88d60de9b99c0fac2245.jpg
5_atss,fold_8,11,0,0,0,-11,IMG_3926_JPG.rf.769c3267365e5531dec34c648a73f597.jpg
5_atss,fold_8,13,0,0,0,-13,IMG_20230512_145120_jpg.rf.3ecb5837a329b79ac20997cfe24d3124.jpg
5_atss,fold_8,3,0,0,0,-3,230512_150054_jpg.rf.ec6dcd9709fc100d27b3f2f4937b7712.jpg
5_atss,fold_8,7,0,0,0,-7,IMG_20230512_150945_jpg.rf.26027cad843e4a3c904d281bd5e443ab.jpg
5_atss,fold_8,2,0,0,0,-2,20230512_151755_jpg.rf.f2aa85c403e0f77cda500046a0fd667f.jpg
5_atss,fold_8,7,0,0,0,-7,20230512_152237_jpg.rf.dceb042d25e3e44ad022b7c4330f1dcf.jpg
5_atss,fold_8,19,0,0,0,-19,20230512_153013_jpg.rf.ebf5724207d5fe9aba867759ed6ae350.jpg
5_atss,fold_8,3,0,0,0,-3,230512_150143_jpg.rf.b686af9ba8be8219e2e0a152ff0123f1.jpg
5_atss,fold_8,1,0,0,0,-1,IMG_20230512_151231_jpg.rf.f19d35ba554c9c3e62efe863fb1dd098.jpg
5_atss,fold_8,1,0,0,0,-1,20230512_151451-0-_jpg.rf.352f3ab1f1271f1dc2c7503413d5072b.jpg
5_atss,fold_8,13,0,0,0,-13,IMG_20230512_151640_056_jpg.rf.69bbb5903a2369e6d01c4fd2bef65e1f.jpg
5_atss,fold_8,5,0,0,0,-5,230512_150033_jpg.rf.ceea84e0a6184331d2af5a24cba9a7d0.jpg
5_atss,fold_8,11,0,0,0,-11,0053_jpg.rf.09112cd43c7e1f0da4351e79ab49af2f.jpg
5_atss,fold_8,12,0,0,0,-12,IMG_20230512_151339_jpg.rf.13ce8b9b66953b0f57413fa693a3dc35.jpg
5_atss,fold_8,2,0,0,0,-2,IMG_20230512_151240_565_jpg.rf.fdf2f78ec041a34d2611406b29953d18.jpg
5_atss,fold_8,23,0,0,0,-23,IMG_20230512_150201_jpg.rf.81da174bcf14fd53b844cf7cae9f7a28.jpg
5_atss,fold_8,27,0,0,0,-27,20230512_153207_jpg.rf.81b28e88b96ae01a62cb2b2cdc468e08.jpg
5_atss,fold_8,3,0,0,0,-3,20230512_151625_jpg.rf.6d8f8d5fffad59d6ccff118606bdd771.jpg
5_atss,fold_8,8,0,0,0,-8,IMG_20230512_145440_jpg.rf.4fae61f59dfa2249c388f714b68ca784.jpg
5_atss,fold_8,2,0,0,0,-2,IMG_4191_JPG.rf.f40d8980877c6222a068ed1ef1102afa.jpg
5_atss,fold_8,1,0,0,0,-1,20230512_153345_jpg.rf.7d2374802dfa67e187bded47020403c1.jpg
5_atss,fold_8,1,0,0,0,-1,20230512_150733_jpg.rf.dfdc2eb0d94519616a7ec9cf127c8f8a.jpg
5_atss,fold_8,1,0,0,0,-1,IMG_4028_JPG.rf.c7571b8910b4228b0179b0ffc703ee1e.jpg
5_atss,fold_8,9,0,0,0,-9,0230512_150115_jpg.rf.50a5de1d8e046395fd6c82509eb7d363.jpg
5_atss,fold_8,2,0,0,0,-2,20230512_145355_jpg.rf.67799c9783b1beeb42aebdae40eac27d.jpg
5_atss,fold_8,9,0,0,0,-9,IMG_3989_JPG.rf.51b8252c5f0a8196d379e91fcc91ad06.jpg
5_atss,fold_8,1,0,0,0,-1,20230512_145111_jpg.rf.ab829e89e439dc4aa65d413090f00b2d.jpg
5_atss,fold_8,5,0,0,0,-5,20230512_152259_jpg.rf.fef7e558f14c303ecfa184eb656375ce.jpg
5_atss,fold_8,1,0,0,0,-1,IMG_20230512_151033_jpg.rf.4872ff92d415a45e16c1f52f8b7ae6db.jpg
5_atss,fold_8,32,0,0,0,-32,IMG_20230512_153350_jpg.rf.cc68f1c6759992fe198286f32b0171ec.jpg
5_atss,fold_8,2,0,0,0,-2,20230512_151506_jpg.rf.2d22a2b23e3853093943da42a80fc17b.jpg
5_atss,fold_8,1,0,0,0,-1,IMG_4015_JPG.rf.8f40d2d78e19693b5d38d76ffd50d286.jpg
5_atss,fold_8,10,0,0,0,-10,20230512_152217_jpg.rf.a3962f3838250709a368b8f241c7bcad.jpg
5_atss,fold_8,3,0,0,0,-3,230512_150048_jpg.rf.2a601f5dc5ab605aa2563bcbc35c41e1.jpg
5_atss,fold_8,14,0,0,0,-14,IMG_20230512_152954_jpg.rf.6f297f29021342f064430fb1e8d22587.jpg
5_atss,fold_8,2,0,0,0,-2,IMG_4053_JPG.rf.307ece37dd62cbaea82bfd7b14f0ee36.jpg
5_atss,fold_8,17,0,0,0,-17,20230512_152942_jpg.rf.cc3d43f0d1f322fa8da500d78ce3a8be.jpg
5_atss,fold_8,3,0,0,0,-3,IMG_20230512_151637_jpg.rf.e79b46fd14d5a0af0846c34d1a920413.jpg
5_atss,fold_9,7,3,3,0,-4,20230512_152158_jpg.rf.02f9c3c00108d9da3f80f2943458d80a.jpg
5_atss,fold_9,4,3,3,0,-1,IMG_20230512_145312_784_jpg.rf.58023d0721ac49469db4e79c05fb5cba.jpg
5_atss,fold_9,25,12,11,1,-13,20230512_150144_jpg.rf.ecf1f47bccdedeca682aab00e68f4fbf.jpg
5_atss,fold_9,4,3,3,0,-1,20230512_145408-0-_jpg.rf.7d30c64c68760c899eab7f27576adaec.jpg
5_atss,fold_9,17,3,3,0,-14,IMG_20230512_153014_136_jpg.rf.ac9f2fc67a44db81aef730e99a1dba0a.jpg
5_atss,fold_9,20,0,0,0,-20,20230512_153043_jpg.rf.5cddf43df464d99390a41596bf2ccdf2.jpg
5_atss,fold_9,8,1,1,0,-7,20230512_153242_jpg.rf.5d53d7e395b76d25f2510396dec3f47a.jpg
5_atss,fold_9,7,5,5,0,-2,20230512_151538_jpg.rf.d5df90d6db920f66f1d45e4cfa70a411.jpg
5_atss,fold_9,5,4,4,0,-1,0050_jpg.rf.47c1ed097ad14e52c46f19b2b3e3f5a2.jpg
5_atss,fold_9,3,4,1,3,1,20230512_150109_jpg.rf.4d2c542089703d638847cefe3c0e0669.jpg
5_atss,fold_9,12,7,7,0,-5,IMG_20230512_151658_955_jpg.rf.6f77aded32a46d8083d7d4e54c112bb9.jpg
5_atss,fold_9,5,3,3,0,-2,IMG_20230512_145258_492_jpg.rf.3ae44ee592a82ee046166d1017a1f348.jpg
5_atss,fold_9,3,3,3,0,0,IMG_20230512_152403_jpg.rf.708a0e8a856b9c4ca92a84e1450a3e60.jpg
5_atss,fold_9,7,4,4,0,-3,20230512_151548_jpg.rf.de9bfd82e4ede57511bc911fc34f5695.jpg
5_atss,fold_9,1,0,0,0,-1,IMG_20230512_151202_728_jpg.rf.1d8a1071a58b84a0628884454a63ef8a.jpg
5_atss,fold_9,11,6,5,1,-5,20230512_152251_jpg.rf.f4cd881ef463deae8c6458635e8849ac.jpg
5_atss,fold_9,4,1,0,1,-3,IMG_3835_JPG.rf.e405f9fb7ccfe92ed96a553465aa1ec9.jpg
5_atss,fold_9,18,1,1,0,-17,20230512_144934_jpg.rf.03898f9c31f25d3ec984bc32b412d5af.jpg
5_atss,fold_9,4,0,0,0,-4,IMG_3867_JPG.rf.ec5d38e5d6681088aaa0d2786eb3bb2b.jpg
5_atss,fold_9,13,5,5,0,-8,IMG_20230512_152345_469_jpg.rf.3dde8c68a98233421212da59bcbe366e.jpg
5_atss,fold_9,19,9,9,0,-10,IMG_20230512_152322_jpg.rf.190afc8c001b1a757ff0cc847eea784d.jpg
5_atss,fold_9,15,2,2,0,-13,0230512_145001_jpg.rf.da230b3dcac925c28f8c0273b5776c9a.jpg
5_atss,fold_9,8,8,8,0,0,20230512_151900_jpg.rf.1250b5103b69822786ae601e0a5c5f68.jpg
5_atss,fold_9,3,0,0,0,-3,IMG_20230512_145043_jpg.rf.3d90edfd5a365d1ec3876fca50ab884d.jpg
5_atss,fold_9,2,1,1,0,-1,IMG_20230512_145345_250_jpg.rf.15fc60af583ce168515577f073866f5f.jpg
5_atss,fold_9,14,8,8,0,-6,20230512_152217_jpg.rf.2fdd5053b538b85b1941d0bb5e4261ca.jpg
5_atss,fold_9,5,0,0,0,-5,230512_150109_jpg.rf.fe44d8827f0b8ae246022ca47b5c4c2c.jpg
5_atss,fold_9,9,5,5,0,-4,20230512_152318_jpg.rf.15ef28475daedc6fc4e098af4a1459e5.jpg
5_atss,fold_9,11,7,7,0,-4,IMG_20230512_151554_209_jpg.rf.f15eb1b2793910f53035e241375725c8.jpg
5_atss,fold_9,1,0,0,0,-1,20230512_151039_jpg.rf.12dc8e8ab83bd9d6e1e941c7a0c05874.jpg
5_atss,fold_9,1,1,1,0,0,IMG_3908_JPG.rf.04ee0448a5e502f1d8c821cea701a7e1.jpg
5_atss,fold_9,2,0,0,0,-2,20230512_150227_jpg.rf.4d20daf17aea8771758821741496ecfd.jpg
5_atss,fold_9,1,1,1,0,0,20230512_153412_jpg.rf.86821476b6a03cfd46882b168695fa0b.jpg
5_atss,fold_9,11,0,0,0,-11,20230512_153437_jpg.rf.be3d60256eef37a332523d849f2754c6.jpg
5_atss,fold_9,1,0,0,0,-1,20230512_150221_jpg.rf.16f1f40fdbd20de3345eed95661a9875.jpg
5_atss,fold_9,6,3,3,0,-3,20230512_145324_jpg.rf.20601749525cadde15c78b46cd0fd934.jpg
5_atss,fold_9,11,2,2,0,-9,IMG_20230512_151501_jpg.rf.050803adc8687422b6d0ca0c55649365.jpg
5_atss,fold_9,8,3,3,0,-5,0041_jpg.rf.dc9ba1dc663668cabb27474922349a17.jpg
5_atss,fold_9,8,6,6,0,-2,20230512_145208_jpg.rf.b8ad2aec57651698bef6edfad1ced014.jpg
5_atss,fold_9,1,1,1,0,0,20230512_151617_jpg.rf.f876cceb3568353e640a6506b3aa8b6a.jpg
5_atss,fold_9,16,8,8,0,-8,0043_jpg.rf.af436235ce1f5e4c84b661d4b30ac97f.jpg
5_atss,fold_9,6,5,5,0,-1,IMG_4102_JPG.rf.988b30b26acf51017cd5b3ff16762a2b.jpg
5_atss,fold_9,5,3,3,0,-2,IMG_20230512_145425_638_jpg.rf.661f8dc69f407743144410705f4450c9.jpg
5_atss,fold_9,14,1,1,0,-13,20230512_151015_jpg.rf.3c8da9af03482ee1020db88de8cd53f5.jpg
5_atss,fold_9,6,5,5,0,-1,20230512_151814_jpg.rf.63e5823ef6a38da9206064b1975681af.jpg
5_atss,fold_9,6,1,1,0,-5,20230512_151556_jpg.rf.e585c8603435630ba81c916c0f5e3ad0.jpg
5_atss,fold_9,7,3,3,0,-4,20230512_150112_jpg.rf.91cd81f1887a38818d08e2f659a19d98.jpg
5_atss,fold_9,6,0,0,0,-6,20230512_144948_jpg.rf.f0802f30adda8942f990e793b5836607.jpg
5_atss,fold_9,1,1,1,0,0,20230512_145029_jpg.rf.d7839e9fea72e8e69ba8fd36d0e4fb46.jpg
5_atss,fold_9,18,8,8,0,-10,IMG_3904_JPG.rf.bd3a38163bc8779f0e934e0ae4ddadcf.jpg
5_atss,fold_9,1,0,0,0,-1,IMG_20230512_153207_221_jpg.rf.1f2a32c755bbb2f6a4de873cb32a38fd.jpg
5_atss,fold_9,6,0,0,0,-6,IMG_20230512_150226_jpg.rf.0f75578652c746be4186e389de366a0e.jpg
5_atss,fold_9,2,0,0,0,-2,IMG_3906_JPG.rf.489fadb71a83983d81ed44a70d0060f4.jpg
5_atss,fold_9,7,1,1,0,-6,20230512_150041_jpg.rf.77c6bf2c7e0b5d7af7cc6bad355e9df1.jpg
5_atss,fold_9,1,1,1,0,0,0230512_145030_jpg.rf.6c6efdb679aaba04919e4f2fbe75cc41.jpg
5_atss,fold_9,5,0,0,0,-5,230512_150321_jpg.rf.623a3367577becef7953f663a60a519b.jpg
5_atss,fold_9,5,1,0,1,-4,MG_20230512_145134_jpg.rf.23612ad15c705c682dff7447cb294722.jpg
5_atss,fold_9,27,0,0,0,-27,20230512_153521_jpg.rf.91f440ee7bd1d39009cef4ad201c6fc3.jpg
5_atss,fold_9,0,2,0,2,2,IMG_4213_JPG.rf.778fa8d9b6925e2bc9f653dd198513f2.jpg
5_atss,fold_9,6,4,4,0,-2,20230512_152211_jpg.rf.f8ab5359b2be0312cf7788fc199a7cfb.jpg
5_atss,fold_9,3,1,1,0,-2,20230512_151750_jpg.rf.d25aa4eadcd0f88bad307f1be9834da7.jpg
5_atss,fold_9,14,8,7,1,-6,IMG_20230512_145200_jpg.rf.071fa9592bc47982ce5ace6be3fc1cac.jpg
5_atss,fold_9,11,4,4,0,-7,20230512_150021_jpg.rf.e7014c35e8c40fcb7fa7884ea70952ae.jpg
5_atss,fold_9,15,0,0,0,-15,IMG_20230512_150047_070_jpg.rf.473b1fece6373583075f5a81e7cd25b1.jpg
5_atss,fold_9,12,12,12,0,0,IMG_20230512_152350_jpg.rf.e5327c93655bbe8c35427b0ce8c7c897.jpg
5_atss,fold_9,7,4,4,0,-3,20230512_153033_jpg.rf.02462baf8941d1800bd6cd7071ac2700.jpg
5_atss,fold_9,5,2,2,0,-3,20230512_145350_jpg.rf.1ea30b4048e0f19948f3a1c49f936262.jpg
5_atss,fold_9,20,0,0,0,-20,20230512_153245_jpg.rf.9c9fb8ddd3ba260eca53499188a58fd5.jpg
5_atss,fold_9,2,0,0,0,-2,20230512_151451_jpg.rf.0a8434d6a9efa22ee048c8273b62b68d.jpg
5_atss,fold_9,5,0,0,0,-5,20230512_151436_jpg.rf.554d34d9ea0ee09cf2c15f0b2df8ebb2.jpg
5_atss,fold_9,6,3,3,0,-3,IMG_3910_JPG.rf.33d9bdf28a4dfeab746c5a00ebede622.jpg
5_atss,fold_9,1,1,1,0,0,20230512_145422_jpg.rf.855806965c417ddd5e1b836f01dc61f4.jpg
5_atss,fold_9,18,9,9,0,-9,IMG_4182_JPG.rf.9c42af3692f7bbaef5a89c980112be66.jpg
5_atss,fold_9,2,1,1,0,-1,20230512_151553_jpg.rf.eb27fb285f9f9e115b16ae58308b4a33.jpg
5_atss,fold_9,1,1,1,0,0,IMG_20230512_151942_jpg.rf.44e3a3ca4b79e01e3532e938c985d467.jpg
5_atss,fold_9,1,0,0,0,-1,20230512_145026_jpg.rf.dbca47de186a8c26308fd5d82af2ccef.jpg
5_atss,fold_9,8,1,1,0,-7,IMG_20230512_151456_jpg.rf.85840748681315fe5ab4e0d0318d07ef.jpg
5_atss,fold_9,5,1,1,0,-4,20230512_145129_jpg.rf.5f78acb483122a7da1a71444f23c5e85.jpg
5_atss,fold_9,3,1,1,0,-2,IMG_4049_JPG.rf.69a02eacb4e8dea786daf7ac53eff115.jpg
5_atss,fold_9,3,0,0,0,-3,20230512_151128_jpg.rf.a8a2c544627fbc40d82ac1408de83acf.jpg
5_atss,fold_9,1,1,1,0,0,0022_jpg.rf.392b7e000cd5e1b178fd42a324c62fa9.jpg
5_atss,fold_9,17,4,4,0,-13,IMG_4214_JPG.rf.342cb36b8889ed055af6630becc0a92b.jpg
5_atss,fold_9,4,1,1,0,-3,IMG_3992_JPG.rf.7e1e103b7399a2f459d53d6a310a7ee0.jpg
5_atss,fold_9,23,11,11,0,-12,IMG_20230512_152955_591_jpg.rf.0aef108570178c062fc410980092f3ee.jpg
5_atss,fold_9,32,2,2,0,-30,IMG_20230512_150325_jpg.rf.9a0b14f916539972a32ed40c795a77e2.jpg
5_atss,fold_9,2,1,1,0,-1,20230512_150043_jpg.rf.c937683d3c7cefe87855391dceb56509.jpg
5_atss,fold_9,3,2,2,0,-1,IMG_4038_JPG.rf.53f27c280fb9536f67b0f3bce749cded.jpg
5_atss,fold_9,1,0,0,0,-1,IMG_4218_JPG.rf.776b234254cad41083ae7a7013512ded.jpg
5_atss,fold_9,3,3,2,1,0,20230512_152323_jpg.rf.f87e4ec47644402832bf9ed280233bd6.jpg
5_atss,fold_9,5,3,2,1,-2,20230512_151434_jpg.rf.6e770d46c3e9773c996335b4220cab85.jpg
5_atss,fold_9,10,2,1,1,-8,0230512_145012_jpg.rf.0f087c91d690727635837b56dc1725f3.jpg
5_atss,fold_9,1,0,0,0,-1,20230512_151257_jpg.rf.0a6cd5b01b2f5eb142626849e1aa59dd.jpg
5_atss,fold_9,5,4,4,0,-1,IMG_20230512_151930_jpg.rf.b1cb9853e8645a3ba38d93ab637f6627.jpg
5_atss,fold_9,14,5,5,0,-9,20230512_151038-0-_jpg.rf.b58c6345da65332e25d3fdda064694ee.jpg
5_atss,fold_9,1,1,1,0,0,20230512_145221_jpg.rf.29bff38b4873d27c522654186744b290.jpg
5_atss,fold_9,15,10,10,0,-5,IMG_20230512_152316_jpg.rf.7f4d2253d0ea3147244a7a36b4392e3c.jpg
5_atss,fold_9,1,1,1,0,0,20230512_145046_jpg.rf.43cb9d49dc86e3ae870df966e6b2b7b1.jpg
5_atss,fold_9,6,2,2,0,-4,IMG_20230512_151246_jpg.rf.0cb0203d04b163b091b29c2f755a7f65.jpg
5_atss,fold_9,8,3,3,0,-5,20230512_150900_jpg.rf.7c05ba2842680f1a240b6f0a28f08dad.jpg
5_atss,fold_9,1,1,1,0,0,20230512_151614_jpg.rf.ceb493d7d9f840a198a0413f2b423ce2.jpg
5_atss,fold_9,1,1,1,0,0,IMG_20230512_151807_jpg.rf.c8207f2bdebe5ee316d9b9a0529d1efe.jpg
5_atss,fold_9,3,3,3,0,0,20230512_153403_jpg.rf.90c6c42ac826af51ce764bcff3b6923f.jpg
5_atss,fold_9,4,0,0,0,-4,IMG_20230512_145038_jpg.rf.3da21846aa05a88c16affc46ab268cfc.jpg
5_atss,fold_9,12,4,4,0,-8,IMG_20230512_151433_jpg.rf.d9b4366826ebd2bd7917e1cb46c50ed4.jpg
5_atss,fold_9,4,4,4,0,0,20230512_145336_jpg.rf.28de2a53875dce1e728e5a0c0cb97aad.jpg
5_atss,fold_9,2,1,1,0,-1,20230512_145253_jpg.rf.c6fbf385d5f1b3ae20b0ef540f9e84b5.jpg
5_atss,fold_9,19,6,6,0,-13,20230512_153250_jpg.rf.b3c0a5af0f8dd45ec4fe90ed8e62c274.jpg
5_atss,fold_9,2,1,1,0,-1,20230512_151637-0-_jpg.rf.57d42a7eaecae72323f8868de4088574.jpg
5_atss,fold_9,5,1,1,0,-4,IMG_3982_JPG.rf.084073c997ce2761c02b36ef237261da.jpg
5_atss,fold_9,2,0,0,0,-2,20230512_145050_jpg.rf.ae125a7aa3a0b2c6f41bc879a36698ce.jpg
5_atss,fold_9,10,9,9,0,-1,20230512_151905-0-_jpg.rf.270832f78fc4546ac9758205aad2a837.jpg
5_atss,fold_9,2,1,1,0,-1,20230512_150048_jpg.rf.bdbae272f798a54cd79cfc08bd2da41e.jpg
5_atss,fold_9,13,2,2,0,-11,20230512_145159_jpg.rf.a9f2125d1fdfa80946c0b272e36cb621.jpg
5_atss,fold_9,2,2,2,0,0,20230512_151541_jpg.rf.1a96f83831f9956a1c5cd8cb7987ee61.jpg
5_atss,fold_9,1,0,0,0,-1,20230512_151118_jpg.rf.2bf6dd63d6a65371da02c372efde8ba3.jpg
5_atss,fold_9,2,0,0,0,-2,IMG_3862_JPG.rf.a37466cc240bba5feaeef8019ddd0e55.jpg
5_atss,fold_9,4,0,0,0,-4,IMG_3843_JPG.rf.3b04ef87c1af95cd756b57595eb39e72.jpg
5_atss,fold_9,16,4,4,0,-12,IMG_20230512_145144_jpg.rf.4c14218fadac19f6b4d5270f23587de8.jpg
5_atss,fold_9,2,2,2,0,0,20230512_151759_jpg.rf.04ce83457ca436da1fc767b75f695b6b.jpg
5_atss,fold_9,1,1,1,0,0,IMG_20230512_145257_jpg.rf.453736b6f9bd9250f595d3afd851de1f.jpg
5_atss,fold_9,2,1,1,0,-1,230512_150129_jpg.rf.10e62e193f0a96333642eeae2d068d57.jpg
5_atss,fold_9,1,2,1,1,1,IMG_3932_JPG.rf.42e9d2a10f9734e5a4bc91d0d9eb642c.jpg
5_atss,fold_9,63,4,4,0,-59,0512_150200_jpg.rf.8539b7a73e953ce0ea7f67784fcb2b58.jpg
5_atss,fold_9,6,3,3,0,-3,IMG_20230512_145254_217_jpg.rf.4e2eb97449efdb3bab4662c35a288482.jpg
5_atss,fold_9,4,1,1,0,-3,20230512_150253_jpg.rf.a852fcb9c971bcf0f4b4b6c07b3a1e7e.jpg
5_atss,fold_9,15,7,7,0,-8,IMG_20230512_151900_jpg.rf.fad29398cd9611cef06c98d97c2dc00c.jpg
5_atss,fold_9,1,0,0,0,-1,IMG_3840_JPG.rf.263bceb78886d3833883706e095d5293.jpg
5_atss,fold_9,5,3,3,0,-2,IMG_20230512_150955_jpg.rf.2011788cab5844089b8e6b7902ac846b.jpg
5_atss,fold_9,2,1,1,0,-1,20230512_151440_jpg.rf.386c9f0ed80e964393660a1d9c01d9ed.jpg
5_atss,fold_9,4,4,4,0,0,20230512_152247_jpg.rf.bdbffc243ed1383af5410f7bac53699a.jpg
5_atss,fold_9,19,7,7,0,-12,20230512_152211_jpg.rf.c54aefeead1c1b68600e1ae65c10b527.jpg
5_atss,fold_9,4,3,3,0,-1,20230512_152232_jpg.rf.01102a74dddfc813f9188dc90bff647f.jpg
5_atss,fold_9,3,0,0,0,-3,IMG_20230512_151701_jpg.rf.0d3314dfd579b4e13828bb386bfee49b.jpg
5_atss,fold_9,10,8,8,0,-2,IMG_20230512_152339_jpg.rf.4d50232667e59a45a8f02b1dc00c36ea.jpg
5_atss,fold_9,5,3,3,0,-2,IMG_20230512_153347_022_jpg.rf.eca10caf5bcd60d00f0f197496dabd1c.jpg
5_atss,fold_9,12,10,9,1,-2,IMG_20230512_152353_jpg.rf.74eba0461c089d0aea3691aee4afbac9.jpg
5_atss,fold_9,2,1,1,0,-1,20230512_150825_jpg.rf.04725a59554eac4f344acef56d3fb6fe.jpg
5_atss,fold_9,5,3,3,0,-2,20230512_151056_jpg.rf.3214ae92a59425896458690934fb5d39.jpg
5_atss,fold_9,1,0,0,0,-1,230512_150046_jpg.rf.a453bfc60f25c0a831415acaf760061b.jpg
5_atss,fold_9,6,3,3,0,-3,IMG_20230512_145419_jpg.rf.605cea1a83f727c0d545999a0d6e6e84.jpg
5_atss,fold_9,24,7,7,0,-17,0512_150049_jpg.rf.4c2d31120db48096f79c8d147d016509.jpg
5_atss,fold_9,1,0,0,0,-1,0052_jpg.rf.11b9f0f1317ccd80a627cd52e3e7c819.jpg
5_atss,fold_9,4,0,0,0,-4,230512_150113_jpg.rf.491cf8e16672678e5500d8eb3e1bc404.jpg
5_atss,fold_9,11,3,3,0,-8,20230512_145204_jpg.rf.c52942b0bcdcd04cafca718031f2ab26.jpg
5_atss,fold_9,2,1,1,0,-1,IMG_20230512_150931_jpg.rf.2ce16e755fe6e9b894d7d449fafbd463.jpg
5_atss,fold_9,1,1,1,0,0,20230512_145348_jpg.rf.a9486de8293f423be4b7c903a6adf9d6.jpg
5_atss,fold_9,1,1,1,0,0,20230512_151644_jpg.rf.3bb96898f1cf4f86f3720f45fe4a4ce1.jpg
5_atss,fold_9,3,2,2,0,-1,IMG_4093_JPG.rf.ebedb6000fb84b714cc74fef511c31aa.jpg
5_atss,fold_9,4,0,0,0,-4,20230512_145002_jpg.rf.97109db1b99cc660d69da24c9747f303.jpg
5_atss,fold_9,2,1,1,0,-1,20230512_151640_jpg.rf.f22b10e3e5f15d07706b85eb0b969f91.jpg
5_atss,fold_9,2,2,2,0,0,20230512_151631_jpg.rf.4e69595c48be79bb26b1487f3e19266e.jpg
5_atss,fold_9,6,2,2,0,-4,20230512_153330_jpg.rf.462ae2c6301c8971d155ebb9a3378c36.jpg
5_atss,fold_9,8,5,4,1,-3,IMG_4189_JPG.rf.ef51bea3fc4ec3eb14a9abaa4902f277.jpg
5_atss,fold_9,21,5,5,0,-16,20230512_150126_jpg.rf.fa9718948fbb766a50fee0608d280d14.jpg
5_atss,fold_9,37,22,22,0,-15,IMG_20230512_153238_678_jpg.rf.9b33a9187212479d779bf15d553e8efc.jpg
5_atss,fold_9,2,1,0,1,-1,IMG_4219_JPG.rf.81654d924a576c094f3f57b813e83fa9.jpg
5_atss,fold_9,6,5,4,1,-1,IMG_20230512_153107_jpg.rf.1ec84b2b739232a85f9ad467ee8a214f.jpg
5_atss,fold_10,14,2,2,0,-12,IMG_20230512_150109_804_jpg.rf.e638755720658c18627b68883d0270d6.jpg
5_atss,fold_10,13,7,7,0,-6,IMG_4205_JPG.rf.e6945a0f8c8342f636251e46e904f729.jpg
5_atss,fold_10,1,0,0,0,-1,IMG_20230512_145046_815_jpg.rf.bccba2de087b0c29681bdd4ff7c199f1.jpg
5_atss,fold_10,12,7,7,0,-5,20230512_153030_jpg.rf.447a01796d662b57a717346a6885bdc7.jpg
5_atss,fold_10,29,7,7,0,-22,20230512_153308_jpg.rf.1f2393c128a7608a2a6b40892e5c576d.jpg
5_atss,fold_10,21,0,0,0,-21,20230512_150151_jpg.rf.73a61752872f6ef725371184031d1666.jpg
5_atss,fold_10,1,1,1,0,0,20230512_151711_jpg.rf.10c1db788e52a7dfc81744f4936a3ef0.jpg
5_atss,fold_10,5,4,4,0,-1,20230512_152341_jpg.rf.67a7bff5a653064d0fbb2dfa8b1f90ce.jpg
5_atss,fold_10,1,1,1,0,0,20230512_150750_jpg.rf.e86dd1819063fd640c2ba43c41a741f8.jpg
5_atss,fold_10,10,3,3,0,-7,IMG_20230512_145121_jpg.rf.690688dd9055bfc063e326aa4fef07f4.jpg
5_atss,fold_10,3,2,2,0,-1,20230512_152340_jpg.rf.cfcfb6148dee3cdf12d6d85f1d247895.jpg
5_atss,fold_10,5,2,2,0,-3,20230512_152235_jpg.rf.08f40afdb24635f6dcfbb88615a2f9f7.jpg
5_atss,fold_10,9,3,3,0,-6,20230512_152302_jpg.rf.6925e24fe61ef38107dc845cce1a2d60.jpg
5_atss,fold_10,1,1,1,0,0,IMG_20230512_151207_jpg.rf.ae49ac5f1949da487c30a4f4ba31817b.jpg
5_atss,fold_10,16,0,0,0,-16,20230512_150011_jpg.rf.1da3e5f3e295949ab4854def4bdbd922.jpg
5_atss,fold_10,3,0,0,0,-3,IMG_20230512_145025_jpg.rf.c0282883e0ec5ffed07135f0bda0ecfa.jpg
5_atss,fold_10,4,4,4,0,0,20230512_151843_jpg.rf.b93560c5fdb00199587ea962c11d4103.jpg
5_atss,fold_10,4,0,0,0,-4,20230512_145326_jpg.rf.e57a46b969b04ee9d16c309181d71fe7.jpg
5_atss,fold_10,1,0,0,0,-1,20230512_153428_jpg.rf.ebef48003f439c4f546df0dab6aff50b.jpg
5_atss,fold_10,23,0,0,0,-23,IMG_20230512_150120_jpg.rf.4b23fdc5feb46ad8a31de385747c52bc.jpg
5_atss,fold_10,4,1,1,0,-3,IMG_3990_JPG.rf.7d3c75f1558f8f5fc9ac7eb6789e10dc.jpg
5_atss,fold_10,8,2,2,0,-6,20230512_150819_jpg.rf.d1513f98969bc1b7ac4e870d3cdb41e6.jpg
5_atss,fold_10,12,0,0,0,-12,20230512_151038_jpg.rf.6caba5860602aa931872edf19ec2b6c5.jpg
5_atss,fold_10,1,0,0,0,-1,IMG_20230512_145146_354_jpg.rf.6de83b52b9e3abba9866d24be95f4c4d.jpg
5_atss,fold_10,7,4,4,0,-3,IMG_4190_JPG.rf.7081f39db6690560b3a2bdd4cbc00d86.jpg
5_atss,fold_10,3,2,2,0,-1,IMG_20230512_145252_021_jpg.rf.1779d92134a07ec7f57f4438113bb031.jpg
5_atss,fold_10,12,3,3,0,-9,230512_150135_jpg.rf.cc24c1ff5e0e940d16df6a7b71d2eabd.jpg
5_atss,fold_10,5,1,1,0,-4,IMG_20230512_151042_jpg.rf.15dee8949138ef80373228e81079c023.jpg
5_atss,fold_10,6,4,3,1,-2,IMG_20230512_151950_jpg.rf.c8c0371384e1a2262fdd3d8a53e11fa3.jpg
5_atss,fold_10,1,1,1,0,0,IMG_20230512_151703_jpg.rf.28a7fdeaae4d54d7cf2de4be9ed4df40.jpg
5_atss,fold_10,11,0,0,0,-11,20230512_150147_jpg.rf.55aa66e580136cb844b6c51dff5d3fed.jpg
5_atss,fold_10,37,4,4,0,-33,20230512_150235_jpg.rf.4361e97cfeccf708272ffe4ece69dbfd.jpg
5_atss,fold_10,2,0,0,0,-2,IMG_20230512_144940_500_jpg.rf.75e33e87c9ad9b74dd1e4b3091ba269f.jpg
5_atss,fold_10,5,2,2,0,-3,20230512_145410_jpg.rf.56000063a0c914b346f9cd7261abac1e.jpg
5_atss,fold_10,1,1,1,0,0,IMG_4033_JPG.rf.d1e341639e4e7d193425664e20325a4c.jpg
5_atss,fold_10,14,1,0,1,-13,IMG_20230512_150125_134_jpg.rf.88679af4628e0ef4675fe385a333d31c.jpg
5_atss,fold_10,13,9,9,0,-4,20230512_151904_jpg.rf.7f72f44e41b8a58e5db1391fa2b35a42.jpg
5_atss,fold_10,2,1,1,0,-1,20230512_151841-0-_jpg.rf.601490af90bd9514d0d590298e1f0255.jpg
5_atss,fold_10,5,3,3,0,-2,20230512_145357_jpg.rf.90422bd2b26f6dd0bd566293b4b30bb5.jpg
5_atss,fold_10,9,3,3,0,-6,IMG_20230512_151951_jpg.rf.31e79520ea845227f969872a61796113.jpg
5_atss,fold_10,1,1,1,0,0,20230512_151646_jpg.rf.6320d2328bf6de098fff781bcffac0cb.jpg
5_atss,fold_10,20,0,0,0,-20,IMG_3903_JPG.rf.7c248f88ef915e14444c5c43dc048c82.jpg
5_atss,fold_10,3,1,1,0,-2,IMG_20230512_151830_jpg.rf.c0f3338eb7af1f0e178971c38c7dec04.jpg
5_atss,fold_10,9,1,1,0,-8,IMG_20230512_144958_jpg.rf.0a6117e6c2ebbfabe543484d7a8056db.jpg
5_atss,fold_10,4,0,0,0,-4,IMG_4095_JPG.rf.58645f8fad94bdb38886e47695cfd8cd.jpg
5_atss,fold_10,4,1,1,0,-3,20230512_152345_jpg.rf.2717f971fd14976a3492abb509e947cb.jpg
5_atss,fold_10,2,1,1,0,-1,IMG_3920_JPG.rf.24878eeb02230840f60014978ff530d7.jpg
5_atss,fold_10,9,1,1,0,-8,IMG_20230512_150046_jpg.rf.6e840be1f4fa3a56d132b04b6e288480.jpg
5_atss,fold_10,9,4,3,1,-5,IMG_20230512_145258_jpg.rf.a062df356e44019699d3c53596d3540e.jpg
5_atss,fold_10,1,1,1,0,0,IMG_20230512_161348_jpg.rf.aea1bf3794b2d077c45245810c001a1c.jpg
5_atss,fold_10,8,0,0,0,-8,230512_150139_jpg.rf.2d8a8d2ed426f1cb21935b033da8b2f6.jpg
5_atss,fold_10,14,9,9,0,-5,IMG_20230512_151610_001_jpg.rf.88fda6a270dac232937c53d6188fa5a9.jpg
5_atss,fold_10,1,0,0,0,-1,230512_145108_jpg.rf.cf20720f57cffcf1f9fa31cecfe67fbf.jpg
5_atss,fold_10,1,0,0,0,-1,IMG_3857_JPG.rf.c98e2825881d870a7242c7271763f36b.jpg
5_atss,fold_10,4,0,0,0,-4,20230512_151024_jpg.rf.a0cfadc35d426648ee3656824927c11e.jpg
5_atss,fold_10,1,1,1,0,0,0036_jpg.rf.6d90090548975dc2e489ef2ff1546863.jpg
5_atss,fold_10,2,0,0,0,-2,20230512_152306_jpg.rf.a7141e38fe1a72a82a763e55d71fd0b5.jpg
5_atss,fold_10,15,1,1,0,-14,20230512_150018_jpg.rf.3bc690cd3af7d48b107dc3a68930fc2f.jpg
5_atss,fold_10,7,4,3,1,-3,IMG_20230512_151112_jpg.rf.6600a13c525e7d830908b03b8a0d3526.jpg
5_atss,fold_10,14,6,6,0,-8,0057_jpg.rf.850f7a1e0cc045be1a9326878338232a.jpg
5_atss,fold_10,7,7,7,0,0,0051_jpg.rf.e81d23e22a72795f3bbc83a62bd65cae.jpg
5_atss,fold_10,4,3,3,0,-1,0006_jpg.rf.ea818ccdacee9dd00131e372a19cf0d0.jpg
5_atss,fold_10,22,0,0,0,-22,20230512_150013_jpg.rf.88f9a3a7e9a79d06352d99a9a40fcfb5.jpg
5_atss,fold_10,1,0,0,0,-1,IMG_20230512_151605_jpg.rf.cd36cb9aab7833e1d827ed72719f9742.jpg
5_atss,fold_10,7,1,1,0,-6,20230512_150940_jpg.rf.a642f28b441714d9d9e22de0ad22f124.jpg
5_atss,fold_10,24,3,3,0,-21,0512_150306_jpg.rf.b16cedf3571182816f46e3a952d5c39a.jpg
5_atss,fold_10,3,2,2,0,-1,20230512_152308_jpg.rf.f4dc38f04cbc5fd664dec02e3ed16103.jpg
5_atss,fold_10,2,1,1,0,-1,IMG_20230512_151812_jpg.rf.86425b9d53f765e1b77d6eba211405fe.jpg
5_atss,fold_10,12,7,7,0,-5,20230512_152316_jpg.rf.dd8d1d54a326eb9ed9a63bc5520eadad.jpg
5_atss,fold_10,2,2,2,0,0,20230512_152213_jpg.rf.1125dc3c4a87888cb65b2d513aa9df85.jpg
5_atss,fold_10,17,2,0,2,-15,IMG_20230512_150147_169_jpg.rf.df6bd6535b4bdd11e20a358e10a11c09.jpg
5_atss,fold_10,10,7,7,0,-3,IMG_4100_JPG.rf.f55f9f2afb5f41daaa63474d6df30725.jpg
5_atss,fold_10,23,2,2,0,-21,IMG_20230512_153004_jpg.rf.19c27a824e3c2f07149751bcaaa47c7f.jpg
5_atss,fold_10,1,1,1,0,0,20230512_151648_jpg.rf.f5ddd2e522a504da5dc723bdc2dec390.jpg
5_atss,fold_10,2,2,1,1,0,0005_jpg.rf.79044c26eeb52526a25a3f38e1aa840d.jpg
5_atss,fold_10,4,0,0,0,-4,IMG_20230512_145001_113_jpg.rf.5ea2af9825ef6b6ebe2436d89dbe79ca.jpg
5_atss,fold_10,1,1,1,0,0,IMG_4183_JPG.rf.1c0ab4bee811c122c1ef5f9131477050.jpg
5_atss,fold_10,2,1,1,0,-1,20230512_151124_jpg.rf.250cebbf32ee5a6ab788e62fd50ecf2c.jpg
5_atss,fold_10,3,0,0,0,-3,IMG_4022_JPG.rf.e15de99fae6d1e74eb63284f3616a75f.jpg
5_atss,fold_10,7,5,5,0,-2,20230512_152319_jpg.rf.abeccdd8fbdc8f18e24c3acdf6c07d48.jpg
5_atss,fold_10,25,4,4,0,-21,IMG_3911_JPG.rf.1bb0ec60809450d49cc43c3d8a1265de.jpg
5_atss,fold_10,6,1,1,0,-5,20230512_151418_jpg.rf.90e438577c310e46b8a21f2ae0b85242.jpg
5_atss,fold_10,9,2,2,0,-7,20230512_153311_jpg.rf.3ecbca1f6ffb06d59119f6627139da8a.jpg
5_atss,fold_10,5,0,0,0,-5,20230512_150206_jpg.rf.8ae1878e1b65e9920f1a99af4f941d9c.jpg
5_atss,fold_10,3,0,0,0,-3,IMG_4389_JPG.rf.d64ad350bc28019aa4851039e73dfdfa.jpg
5_atss,fold_10,10,1,1,0,-9,0512_150317_jpg.rf.a70fbe5816d46c9fa83979febbeb753f.jpg
5_atss,fold_10,7,2,2,0,-5,20230512_145440_jpg.rf.faac237167337f22dcbfb3879916747e.jpg
5_atss,fold_10,14,3,3,0,-11,20230512_150138_jpg.rf.baad1e97bbf234f37489ac66f024a808.jpg
5_atss,fold_10,12,2,2,0,-10,20230512_150159_jpg.rf.15a7a075343358e808fef60d09b7b8c3.jpg
5_atss,fold_10,2,1,1,0,-1,IMG_20230512_151004_jpg.rf.fa632ed53260b0c0873743bd4155a490.jpg
5_atss,fold_10,6,4,4,0,-2,IMG_20230512_151929_jpg.rf.8916d2cec0ed6feba243725d4795cee6.jpg
5_atss,fold_10,6,1,1,0,-5,20230512_150108_jpg.rf.114d86f5dc5d95e4469bf960bc7c0a4f.jpg
5_atss,fold_10,10,7,7,0,-3,0014_jpg.rf.69fba8cc80a5714926e6841f224baffc.jpg
5_atss,fold_10,1,0,0,0,-1,IMG_20230512_145359_479_jpg.rf.6b65f34991508137d8d33789257462e4.jpg
5_atss,fold_10,5,0,0,0,-5,MG_20230512_145100_jpg.rf.2fac7875b124670b96ab0a3b253f2e29.jpg
5_atss,fold_10,6,2,2,0,-4,20230512_151747_jpg.rf.f2ca78e158d0f2965152169425291a5a.jpg
5_atss,fold_10,9,0,0,0,-9,230512_150154_jpg.rf.6b065a843e8b776c3731c23f8a875399.jpg
5_atss,fold_10,1,0,0,0,-1,20230512_145117_jpg.rf.1ad15540d0fbbd6bac016639ff1c07a3.jpg
5_atss,fold_10,4,4,3,1,0,20230512_145248_jpg.rf.8a3953be78b4c9d70df1b12fd15d4939.jpg
5_atss,fold_10,2,1,1,0,-1,IMG_3836_JPG.rf.434cd50ae74cfc4c9d1e3085a73a905b.jpg
5_atss,fold_10,8,2,2,0,-6,20230512_150949_jpg.rf.81b6e460185cb992a26ccccb5e72b394.jpg
5_atss,fold_10,11,8,8,0,-3,IMG_20230512_152452_jpg.rf.849169ae208c086f88f01686f87e3c82.jpg
5_atss,fold_10,12,6,6,0,-6,IMG_aaaa_jpg.rf.6f8cea923b21b011dca38cdc115eaf80.jpg
5_atss,fold_10,1,0,0,0,-1,IMG_20230512_145313_jpg.rf.3ae2ff3ddf2bb75af26203bf8cca362c.jpg
5_atss,fold_10,14,7,7,0,-7,IMG_20230512_151605_536_jpg.rf.39cf087a8f42f961dca0c0caa4dfa17d.jpg
5_atss,fold_10,8,2,2,0,-6,20230512_145342_jpg.rf.b956dcb9a2579c2e8f754353e1d00c75.jpg
5_atss,fold_10,8,2,2,0,-6,IMG_4193_JPG.rf.ee7ebd7c653b26c381990c2e3f69556f.jpg
5_atss,fold_10,5,1,1,0,-4,IMG_20230512_151457_jpg.rf.49e2e6a56131fab5a439e78b087a3b8a.jpg
5_atss,fold_10,1,1,1,0,0,20230512_145224_jpg.rf.b8204cbb29051890879b714634f912b6.jpg
5_atss,fold_10,11,4,4,0,-7,IMG_20230512_152257_409_jpg.rf.8463210402c73719c09f0b2210f7cfb4.jpg
5_atss,fold_10,16,9,8,1,-7,20230512_152313_jpg.rf.cae2b30990ff4679b62bdf438fbd8044.jpg
5_atss,fold_10,1,0,0,0,-1,0230512_145347_jpg.rf.58a6f73f43efb9705bb2978f49927337.jpg
5_atss,fold_10,9,8,8,0,-1,0034_jpg.rf.d4c6d4e1816e57648e3dbb1782385073.jpg
5_atss,fold_10,2,0,0,0,-2,IMG_20230512_151611_jpg.rf.b44877740f7dd0dc052351bbded2044b.jpg
5_atss,fold_10,17,1,1,0,-16,230512_150149_jpg.rf.b74d07f3292d3144d25facf3dde243dc.jpg
5_atss,fold_10,59,0,0,0,-59,IMG_20230512_153218_jpg.rf.cac514c0d5c15fe1628359a5bfa2dacb.jpg
5_atss,fold_10,6,0,0,0,-6,IMG_20230512_145054_075_jpg.rf.5e98b15c8a4633098064286c64be239e.jpg
5_atss,fold_10,5,0,0,0,-5,IMG_20230512_151259_jpg.rf.7b57c2547bbd877ef1243a2ab325c2fa.jpg
5_atss,fold_10,70,1,1,0,-69,20230512_153220_jpg.rf.660dfd8464712797760cfa3b49fef4e7.jpg
5_atss,fold_10,9,1,1,0,-8,IMG_4186_JPG.rf.c6b51e615ccecf25291d4d3bd703172a.jpg
5_atss,fold_10,4,0,0,0,-4,20230512_144950_jpg.rf.b105c1ba7257a4da1b17c9f42de1770a.jpg
5_atss,fold_10,9,2,2,0,-7,IMG_20230512_145304_jpg.rf.7de02525de42506dbd7eda7365fd0065.jpg
5_atss,fold_10,4,1,1,0,-3,20230512_145209_jpg.rf.c73d398c69a90599525e2c2a8cb51f2c.jpg
5_atss,fold_10,3,3,3,0,0,20230512_151741_jpg.rf.989b1ddb73b99e41bd2bddfcf1c60e1d.jpg
5_atss,fold_10,2,0,0,0,-2,20230512_152209_jpg.rf.c79a1a42b4846b485a9b00d575fb1626.jpg
5_atss,fold_10,17,3,1,2,-14,20230512_152258_jpg.rf.485967412d3788c1a657a3be4d77671e.jpg
5_atss,fold_10,2,2,2,0,0,IMG_20230512_151818_jpg.rf.593796b492f80d2ddd3e0449eec86414.jpg
5_atss,fold_10,1,0,0,0,-1,20230512_145110_jpg.rf.02ac7002fe460313bbf3d2c9d99f8ba7.jpg
5_atss,fold_10,4,2,2,0,-2,IMG_3907_JPG.rf.b1def63b2acf54c44c0c502aca5f4d44.jpg
5_atss,fold_10,1,1,1,0,0,20230512_150722_jpg.rf.811e652f271c46d6a3e10299f1a6b7d9.jpg
5_atss,fold_10,1,0,0,0,-1,20230512_145243_jpg.rf.6f06c25acca67180648bf428a474f0b3.jpg
5_atss,fold_10,2,2,2,0,0,20230512_145053_jpg.rf.dd5c06f85a2f9673d635a3b60256df27.jpg
5_atss,fold_10,1,1,1,0,0,IMG_20230512_151236_jpg.rf.697c89d65f7f53a2cf18544c923eb896.jpg
5_atss,fold_10,1,0,0,0,-1,0230512_145425_jpg.rf.f4fcff283a6f3d5ea4f0275a52a87728.jpg
5_atss,fold_10,24,2,2,0,-22,0001_jpg.rf.0c630bace393ba8970fa7c3c8fd7c235.jpg
5_atss,fold_10,8,6,6,0,-2,20230512_152317_jpg.rf.fddebbf7fe2a035df51e17bb0c14e2b4.jpg
5_atss,fold_10,9,0,0,0,-9,IMG_4209_JPG.rf.093053ef31116bcee7646b801c678d5b.jpg
5_atss,fold_10,23,3,2,1,-20,20230512_150122_jpg.rf.cb6d477ccda3127b4d473101af503eb3.jpg
5_atss,fold_10,4,1,1,0,-3,20230512_152326_jpg.rf.8ca5737543dbfcb717b333d32cc18f8b.jpg
5_atss,fold_10,1,0,0,0,-1,20230512_145056_jpg.rf.2bbf028730f3b9804aa416234c6db613.jpg
5_atss,fold_10,6,3,3,0,-3,0037_jpg.rf.e51421425c8718d498a1cc958bfeeb2b.jpg
5_atss,fold_10,10,7,7,0,-3,IMG_20230512_153400_jpg.rf.5f42ce4759cb794127f4f23098e0ff58.jpg
5_atss,fold_10,8,5,5,0,-3,20230512_151848_jpg.rf.2c6000bd3b3f3ae44c8e672b08aec3b5.jpg
5_atss,fold_10,23,0,0,0,-23,IMG_20230512_153450_jpg.rf.af0e93ea32d0b17c0b616de937189066.jpg
5_atss,fold_10,3,2,2,0,-1,IMG_3921_JPG.rf.e8186af83ff3af27612213a05a7c5177.jpg
5_atss,fold_10,10,4,4,0,-6,IMG_20230512_145056_jpg.rf.340c9781ae519c2a173e9014c5be4072.jpg
5_atss,fold_10,5,0,0,0,-5,20230512_145001_jpg.rf.ac3499ee309bec2035194be16f5da378.jpg
5_atss,fold_10,1,0,0,0,-1,20230512_145104_jpg.rf.a25f0f63e3b58e348bedb4aa97e67394.jpg
5_atss,fold_10,38,0,0,0,-38,0512_150303_jpg.rf.54131a2e7501a146e0d64448ccb7d595.jpg
5_atss,fold_10,1,0,0,0,-1,20230512_145308_jpg.rf.692ac823c338ea1cdf326339c51eb5b1.jpg
5_atss,fold_10,7,3,3,0,-4,0060_jpg.rf.a0b1380ab0b6548c6335a9f12bb9f9f5.jpg
5_atss,fold_10,1,0,0,0,-1,IMG_20230512_150846_jpg.rf.f9a1c340f4f40ffecf79883a50c53a30.jpg
5_atss,fold_10,11,10,10,0,-1,20230512_151902_jpg.rf.0d916693ef179e70195af9fd22402789.jpg
5_atss,fold_10,13,0,0,0,-13,IMG_4211_JPG.rf.76ca0821ebf56f29d1009eb9ff45a384.jpg
5_atss,fold_10,10,3,3,0,-7,IMG_20230512_153020_jpg.rf.e9080cc66a8631a1e9e4e610e61bc6a4.jpg
5_atss,fold_10,14,5,5,0,-9,20230512_153059_jpg.rf.48d36662c46f21f6e2c61dbaa81b1253.jpg
5_atss,fold_10,6,4,4,0,-2,IMG_20230512_145113_jpg.rf.0828a4e83c0458a5f8bc5967b29e1db1.jpg
5_atss,fold_10,1,1,1,0,0,20230512_145418_jpg.rf.8af049af1c5b2eb413647f320a119a74.jpg
